LOC_EXECUTABLE,BRANCH_COUNT,LOC_CODE_AND_COMMENT,LOC_COMMENTS,CYCLOMATIC_COMPLEXITY,DESIGN_COMPLEXITY,ESSENTIAL_COMPLEXITY,HALSTEAD_CONTENT,HALSTEAD_DIFFICULTY,HALSTEAD_EFFORT,HALSTEAD_ERROR_EST,HALSTEAD_LENGTH,HALSTEAD_LEVEL,HALSTEAD_PROG_TIME,NUM_OPERANDS,NUM_OPERATORS,NUM_UNIQUE_OPERANDS,LOC_TOTAL,bug
31,7,1,19,4,2,1,38.55,21.52,17846.19,0.28,141,0.05,991.46,51,90,32,32,1
29,9,4,22,5,3,1,52.03,12.33,7914.68,0.21,111,0.08,439.7,37,74,33,33,1
196,71,14,170,37,26,21,127.7,71.54,653537.1,3.05,1177,0.01,36307.62,454,723,165,210,1
71,19,6,45,10,9,8,46.15,27.11,33930.43,0.42,211,0.04,1885.02,73,138,35,77,1
15,3,0,7,2,2,1,27.05,14.25,5493.37,0.13,74,0.07,305.19,27,47,18,15,1
143,25,11,57,13,12,1,175.18,28.52,142535.33,1.67,695,0.04,7918.63,290,405,122,154,1
33,11,7,30,6,5,1,53.63,18.46,18269.63,0.33,172,0.05,1014.98,68,104,35,40,1
92,7,7,46,4,4,1,234.02,26.64,166113.93,2.08,822,0.04,9228.55,373,449,168,99,1
44,13,6,14,7,7,1,78.96,22.12,38620.28,0.58,269,0.05,2145.57,115,154,65,50,1
133,34,3,91,30,26,1,54.04,77.46,324260.81,1.4,605,0.01,18014.49,220,385,71,136,1
91,39,20,96,20,4,9,72.67,51.47,192513.32,1.25,568,0.02,10695.18,250,318,68,111,1
58,19,6,6,10,1,5,30.99,33.52,34816.7,0.35,187,0.03,1934.26,83,104,26,64,1
28,5,0,11,3,2,1,36.57,15.24,8490.44,0.19,104,0.07,471.69,32,72,21,28,1
149,37,0,62,20,18,1,171.78,29.58,150305.78,1.69,702,0.03,8350.32,220,482,119,149,1
411,141,45,339,73,41,30,293.68,43.41,553518.63,4.25,1500,0.02,30751.03,568,932,314,456,1
121,29,3,29,15,12,3,164.09,23.26,88801.93,1.27,537,0.04,4933.44,221,316,114,124,1
79,23,14,78,12,6,4,89.42,13.73,16858.82,0.41,201,0.07,936.6,84,117,52,93,1
41,7,0,12,4,3,3,56.52,13.19,9840.36,0.25,129,0.08,546.69,50,79,36,41,1
130,37,23,65,20,10,9,83.0,51.6,220979.91,1.43,607,0.02,12276.66,258,349,95,153,1
57,15,6,7,9,7,1,45.05,29.27,38588.27,0.44,213,0.03,2143.79,75,138,41,63,1
49,9,6,4,5,5,1,102.23,12.09,14944.77,0.41,211,0.08,830.27,76,135,44,55,1
28,5,2,11,3,3,1,44.75,18.67,15592.09,0.28,148,0.05,866.23,56,92,30,30,1
71,15,6,39,8,7,1,90.85,21.94,43721.41,0.66,307,0.05,2428.97,108,199,64,77,1
22,3,1,19,2,2,1,37.27,15.43,8872.37,0.19,114,0.06,492.91,54,60,21,23,1
22,9,0,17,5,3,5,35.13,12.55,5531.32,0.15,84,0.08,307.3,31,53,21,22,1
59,13,16,23,7,7,1,104.75,22.14,51324.87,0.77,349,0.05,2851.38,126,223,74,75,1
89,32,4,62,24,19,9,54.69,47.6,123914.45,0.87,402,0.02,6884.14,154,248,55,93,1
32,7,3,24,4,4,1,34.91,18.57,12037.08,0.22,121,0.05,668.73,43,78,22,35,1
74,21,7,28,11,9,11,61.92,36.74,83581.43,0.76,354,0.03,4643.41,124,230,54,81,1
107,35,9,73,18,10,9,51.85,64.92,218524.86,1.12,516,0.02,12140.27,193,323,55,116,1
19,5,2,22,3,1,1,45.57,9.64,4237.49,0.15,85,0.1,235.42,27,58,21,21,1
18,5,3,34,3,3,1,31.39,9.47,2815.15,0.1,60,0.11,156.4,23,37,17,21,1
22,5,3,11,3,3,1,39.66,11.08,4871.43,0.15,81,0.09,270.63,28,53,24,25,1
20,5,2,19,3,3,1,31.51,10.5,3474.19,0.11,64,0.1,193.01,21,43,18,22,1
13,5,2,0,3,3,1,22.4,7.33,1204.38,0.05,38,0.14,66.91,12,26,9,15,1
44,15,2,31,8,7,4,74.36,13.06,12685.78,0.32,159,0.08,704.77,64,95,49,46,1
91,35,4,18,18,16,7,195.05,21.41,89412.4,1.39,591,0.05,4967.36,218,373,112,95,1
47,5,2,13,3,3,1,55.85,28.0,43785.9,0.52,256,0.04,2432.55,112,144,46,49,1
24,7,1,7,4,3,3,30.72,19.13,11241.58,0.2,107,0.05,624.53,40,67,23,25,1
82,21,9,59,11,10,3,70.59,44.71,141084.24,1.05,475,0.02,7838.01,190,285,68,91,1
10,3,1,12,2,1,1,23.14,6.5,977.69,0.05,32,0.15,54.32,13,19,13,11,1
28,11,2,7,6,5,5,33.22,15.91,8407.11,0.18,98,0.06,467.06,35,63,22,30,1
24,9,1,0,5,3,1,32.54,9.5,2936.77,0.1,63,0.11,163.15,19,44,15,25,0
12,3,0,0,2,2,1,14.62,6.43,604.36,0.03,23,0.16,33.58,9,14,7,12,0
106,25,0,14,13,11,1,101.31,27.04,74089.87,0.91,421,0.04,4116.1,192,229,71,106,0
15,5,0,0,3,3,1,8.17,18.0,2648.68,0.05,36,0.06,147.15,15,21,5,15,0
25,9,12,16,5,5,5,38.51,14.25,7820.87,0.18,107,0.07,434.49,38,69,20,37,0
46,29,8,35,15,1,3,61.1,22.3,30377.95,0.45,239,0.04,1687.66,110,129,37,54,0
34,9,11,28,5,1,5,41.24,20.76,17773.08,0.29,155,0.05,987.39,59,96,27,45,0
10,3,2,4,2,1,1,15.9,9.0,1287.55,0.05,35,0.11,71.53,16,19,8,12,0
23,13,10,17,7,1,5,27.4,28.12,21659.58,0.26,157,0.04,1203.31,43,114,13,33,0
23,13,10,17,7,1,5,17.45,27.22,12929.85,0.16,105,0.04,718.32,35,70,9,33,0
31,9,2,15,5,2,1,47.41,27.5,35852.6,0.43,231,0.04,1991.81,70,161,28,33,0
24,9,3,20,5,2,1,43.1,15.2,9958.0,0.22,120,0.07,553.22,40,80,25,27,0
13,3,6,5,2,1,1,29.61,9.15,2480.95,0.09,57,0.11,137.83,17,40,13,19,0
33,3,2,0,2,2,1,64.01,11.65,8684.99,0.25,135,0.09,482.5,66,69,34,35,0
21,7,6,0,4,1,4,21.34,24.44,12748.97,0.17,98,0.04,708.28,40,58,18,27,0
177,60,63,31,41,23,6,101.81,54.82,305928.62,1.86,767,0.02,16996.03,268,499,110,240,0
14,8,4,5,5,3,1,12.36,15.0,2781.99,0.06,41,0.07,154.56,16,25,8,18,0
361,110,37,191,70,46,27,157.03,97.73,1499684.32,5.12,1844,0.01,83315.8,711,1133,251,398,0
76,24,3,48,13,10,7,60.5,32.21,62767.66,0.65,298,0.03,3487.09,102,196,57,79,0
20,5,0,0,3,3,1,34.17,10.29,3620.93,0.12,71,0.1,201.16,25,46,17,20,0
27,9,4,5,5,3,3,24.71,21.86,11802.86,0.18,108,0.05,655.71,34,74,14,31,0
15,5,2,24,3,3,1,36.19,7.18,1867.89,0.09,52,0.14,103.77,21,31,19,17,0
13,7,3,8,4,4,1,26.75,11.03,3253.68,0.1,59,0.09,180.76,25,34,17,16,0
25,5,2,16,3,3,1,48.49,14.11,9649.29,0.23,120,0.07,536.07,49,71,33,27,0
22,7,5,10,4,4,4,28.43,13.42,5120.93,0.13,75,0.07,284.5,34,41,19,27,0
28,11,5,19,6,4,1,30.61,23.1,16332.07,0.24,128,0.04,907.34,55,73,25,33,0
18,3,3,18,2,2,1,25.62,24.42,15282.02,0.21,122,0.04,849.0,58,64,19,21,0
24,9,2,20,5,3,1,27.08,39.72,42716.37,0.36,197,0.03,2373.13,87,110,23,26,0
38,9,2,12,5,5,1,54.44,19.25,20172.82,0.35,176,0.05,1120.71,70,106,40,40,0
31,9,10,9,5,5,5,54.55,14.84,12009.6,0.27,140,0.07,667.2,61,79,37,41,0
32,11,5,44,6,6,1,53.31,12.89,8852.8,0.23,123,0.08,491.82,47,76,31,37,0
62,17,5,32,9,6,4,97.49,20.91,42621.97,0.68,314,0.05,2367.89,115,199,66,67,0
41,11,3,47,6,5,1,61.64,16.96,17733.62,0.35,177,0.06,985.2,63,114,39,44,0
25,7,0,8,4,1,1,31.67,15.0,7125.0,0.16,95,0.07,395.83,30,65,16,25,0
17,5,2,2,3,3,1,36.74,14.57,7799.92,0.18,102,0.07,433.33,36,66,21,19,0
18,7,2,2,4,4,1,54.3,7.89,3382.91,0.14,80,0.13,187.94,34,46,28,20,0
48,13,4,28,7,7,1,124.44,13.9,24028.83,0.58,262,0.07,1334.93,107,155,77,52,0
127,19,4,31,10,10,1,208.02,26.3,143936.36,1.82,753,0.04,7996.46,259,494,128,131,0
21,7,0,23,4,4,1,51.3,7.64,2991.43,0.13,77,0.13,166.19,28,49,22,21,0
65,23,0,34,12,8,3,108.84,15.19,25107.55,0.55,263,0.07,1394.86,109,154,61,65,0
32,3,1,8,2,2,1,68.36,18.78,24116.87,0.43,214,0.05,1339.83,96,118,46,33,0
23,9,1,20,5,5,1,30.19,7.85,1858.26,0.08,51,0.13,103.24,17,34,13,24,0
8,3,1,6,2,1,1,10.63,3.75,149.49,0.01,12,0.27,8.3,5,7,4,9,0
63,19,1,1,11,9,10,40.21,43.24,75169.98,0.58,292,0.02,4176.1,105,187,34,64,0
22,7,1,0,4,4,4,30.25,10.71,3467.15,0.11,66,0.09,192.62,28,38,17,23,0
36,13,1,1,7,6,1,34.37,26.52,24176.72,0.3,168,0.04,1343.15,67,101,24,37,0
23,3,1,2,2,2,1,56.67,6.13,2126.03,0.12,73,0.16,118.11,35,38,20,24,0
20,9,1,1,5,4,5,23.83,11.5,3151.22,0.09,57,0.09,175.07,23,34,14,21,0
17,7,4,0,4,4,4,26.81,10.4,2899.8,0.09,58,0.1,161.1,24,34,15,21,0
73,27,3,1,15,12,8,36.37,50.39,92350.98,0.61,299,0.02,5130.61,113,186,37,76,0
6,3,4,1,2,2,1,16.39,3.5,200.76,0.02,16,0.29,11.15,5,11,5,10,0
17,7,5,1,4,3,1,31.11,12.06,4520.83,0.13,75,0.08,251.16,31,44,18,22,0
64,23,3,1,13,9,9,39.47,43.33,74124.42,0.57,283,0.02,4118.02,104,179,36,67,0
20,7,0,0,4,2,4,13.47,16.0,3447.89,0.07,47,0.06,191.55,16,31,8,20,0
24,11,0,0,6,2,6,19.97,17.33,5999.58,0.12,72,0.06,333.31,26,46,12,24,0
24,11,0,0,6,2,6,19.97,17.33,5999.58,0.12,72,0.06,333.31,26,46,12,24,0
9,5,0,0,3,1,3,14.65,4.8,337.48,0.02,19,0.21,18.75,6,13,5,9,0
9,9,0,0,5,1,5,19.29,6.43,797.14,0.04,31,0.16,44.29,10,21,7,9,0
9,5,0,0,3,1,3,9.14,10.0,913.77,0.03,24,0.1,50.76,8,16,4,9,0
14,3,0,0,2,1,1,36.78,7.07,1838.97,0.09,56,0.14,102.16,18,38,14,14,0
60,9,9,14,5,5,1,97.85,22.12,47876.6,0.72,331,0.05,2659.81,114,217,67,69,0
16,5,10,6,3,3,1,39.8,9.0,3223.83,0.12,73,0.11,179.1,27,46,18,26,0
12,3,0,4,2,2,1,23.34,6.11,871.59,0.05,33,0.16,48.42,10,23,9,12,0
13,3,0,0,2,1,1,18.1,9.63,1676.34,0.06,41,0.1,93.13,14,27,8,13,0
16,3,0,13,2,2,1,21.16,9.1,1752.37,0.06,42,0.11,97.35,13,29,10,16,0
27,7,3,5,4,3,3,28.78,18.12,9456.28,0.17,95,0.06,525.35,29,66,20,30,0
31,9,3,15,5,4,4,35.02,17.25,10420.79,0.2,110,0.06,578.93,33,77,22,34,0
37,9,2,28,5,3,1,30.93,16.0,7919.03,0.16,93,0.06,439.95,32,61,20,39,0
26,7,0,6,4,2,3,38.77,13.2,6756.06,0.17,99,0.08,375.34,33,66,20,26,0
34,11,0,8,6,3,1,59.16,12.6,9398.15,0.25,135,0.08,522.12,43,92,29,34,0
31,13,2,30,7,5,1,26.31,23.5,14529.3,0.21,126,0.04,807.18,47,79,15,33,0
15,3,0,0,2,1,1,37.54,7.6,2168.23,0.1,60,0.13,120.46,19,41,15,15,0
15,7,6,12,4,4,4,18.1,16.36,4845.73,0.1,63,0.06,269.21,24,39,11,21,0
130,57,45,13,29,27,7,91.32,55.88,285170.84,1.7,729,0.02,15842.82,309,420,94,175,0
30,7,3,3,4,4,1,30.45,20.71,13065.14,0.21,122,0.05,725.84,58,64,21,33,0
34,11,4,0,6,6,1,64.31,12.0,9260.02,0.26,146,0.08,514.45,54,92,27,38,0
59,15,27,28,9,6,1,47.3,45.77,99082.56,0.72,336,0.02,5504.59,136,200,52,86,0
16,7,11,30,4,1,1,18.87,19.62,7260.95,0.12,77,0.05,403.39,34,43,13,27,0
65,23,5,95,12,1,1,79.18,42.02,139798.54,1.11,541,0.02,7766.59,230,311,52,70,0
20,5,0,3,3,3,1,38.85,12.28,5856.79,0.16,93,0.08,325.38,26,67,18,20,0
50,29,19,53,15,1,9,50.79,25.26,32401.84,0.43,219,0.04,1800.1,89,130,37,69,0
12,5,0,0,3,1,1,21.83,10.42,2369.07,0.08,51,0.1,131.62,25,26,12,12,0
93,33,13,55,17,6,7,56.02,48.06,129374.54,0.9,407,0.02,7187.47,173,234,63,106,0
69,37,0,18,19,13,19,73.61,37.75,104901.75,0.93,422,0.03,5827.87,151,271,64,69,0
16,5,1,0,3,1,3,13.72,10.56,1531.0,0.05,33,0.09,85.06,13,20,8,17,0
20,5,0,0,3,1,1,10.03,14.67,2158.18,0.05,36,0.07,119.9,16,20,6,20,0
154,28,20,119,17,13,10,133.35,38.57,198396.43,1.71,695,0.03,11022.02,285,410,133,174,0
72,31,1,19,16,7,9,86.16,18.26,28729.02,0.52,255,0.05,1596.06,83,172,50,73,0
125,31,13,50,18,13,1,77.8,40.25,126046.47,1.04,438,0.02,7002.58,168,270,96,138,0
29,9,0,17,5,2,1,27.4,20.78,11829.84,0.19,111,0.05,657.21,44,67,18,29,0
18,5,1,11,3,1,1,35.6,12.89,5919.2,0.15,91,0.08,328.84,35,56,19,19,0
55,21,0,8,11,8,5,48.89,26.83,35190.17,0.44,217,0.04,1955.01,88,129,41,55,0
47,5,0,39,3,1,1,59.87,15.65,14671.27,0.31,150,0.06,815.07,82,68,55,47,0
32,11,2,14,6,2,4,21.82,22.85,11393.4,0.17,95,0.04,632.97,37,58,17,34,0
21,5,0,2,3,3,1,34.56,8.63,2570.73,0.1,62,0.12,142.82,23,39,16,21,0
14,3,0,1,2,1,1,12.74,7.86,786.33,0.03,24,0.13,43.68,10,14,7,14,0
21,5,0,6,3,3,1,40.4,11.25,5113.63,0.15,86,0.09,284.09,36,50,24,21,0
18,3,0,9,2,2,1,32.0,11.63,4329.68,0.12,72,0.09,240.54,26,46,19,18,0
36,6,2,13,4,4,1,48.31,17.63,15014.65,0.28,156,0.06,834.15,56,100,27,38,0
160,58,12,33,32,20,7,151.5,22.73,78244.98,1.15,488,0.04,4346.94,163,325,104,172,0
13,3,0,0,2,1,1,21.15,3.5,259.02,0.02,20,0.29,14.39,6,14,6,13,0
128,49,33,58,25,9,12,104.25,54.33,307757.08,1.89,790,0.02,17097.62,326,464,108,161,0
20,9,0,0,5,1,1,13.75,21.0,6065.91,0.1,63,0.05,336.99,21,42,8,20,0
27,11,2,20,6,2,1,38.41,13.45,6946.75,0.17,92,0.07,385.93,39,53,29,29,0
47,19,6,7,10,7,9,105.02,18.86,37359.42,0.66,318,0.05,2075.52,97,221,54,53,0
16,5,2,18,3,2,1,45.77,7.71,2723.97,0.12,70,0.13,151.33,27,43,21,18,0
41,7,0,21,4,4,1,61.36,23.68,34405.27,0.48,247,0.04,1911.4,117,130,42,41,0
14,3,3,0,2,1,1,16.29,9.29,1404.34,0.05,37,0.11,78.02,13,24,7,17,0
14,3,3,0,2,1,1,16.29,9.29,1404.34,0.05,37,0.11,78.02,13,24,7,17,0
27,5,0,39,3,1,1,61.85,12.04,8964.95,0.25,130,0.08,498.05,61,69,38,27,0
21,3,6,6,2,2,1,22.83,23.0,12075.0,0.18,105,0.04,670.83,46,59,16,27,0
16,5,0,5,3,2,3,24.32,7.64,1418.49,0.06,40,0.13,78.8,12,28,11,16,0
55,17,12,20,9,3,1,52.18,33.32,57931.89,0.58,292,0.03,3218.44,113,179,39,67,0
22,9,10,22,5,2,1,27.26,22.11,13319.21,0.2,114,0.05,739.96,42,72,19,32,0
138,47,1,58,25,24,1,171.89,27.21,127275.78,1.56,625,0.04,7070.88,250,375,147,139,0
23,7,1,23,4,4,1,34.26,11.57,4586.97,0.13,75,0.09,254.83,27,48,21,24,0
60,19,4,15,13,6,1,66.12,13.9,12780.02,0.31,155,0.07,710.0,57,98,41,64,0
32,9,1,0,5,3,1,27.2,13.24,4764.71,0.12,72,0.08,264.71,30,42,17,33,0
28,5,0,11,3,3,1,47.22,11.69,6449.49,0.18,103,0.09,358.3,33,70,24,28,0
19,3,0,3,2,2,1,33.23,9.41,2943.55,0.1,62,0.11,163.53,20,42,17,19,0
19,3,0,3,2,2,1,31.71,8.91,2515.03,0.09,57,0.11,139.72,19,38,16,19,0
38,7,3,35,4,1,3,60.5,14.75,13163.37,0.3,153,0.07,731.3,59,94,38,41,0
41,3,0,7,2,2,1,93.81,15.69,23101.5,0.49,241,0.06,1283.42,96,145,52,41,0
30,3,0,6,2,2,1,58.05,14.68,12512.17,0.28,151,0.07,695.12,57,94,33,30,0
149,29,2,65,15,6,11,118.83,46.92,261640.64,1.86,781,0.02,14535.59,333,448,110,151,0
19,3,0,6,2,2,1,31.58,9.5,2850.0,0.1,60,0.11,158.33,19,41,16,19,0
42,3,0,6,2,2,1,94.81,13.88,18268.21,0.44,210,0.07,1014.9,91,119,59,42,0
14,3,6,13,2,1,1,28.66,11.47,3771.09,0.11,67,0.09,209.5,30,37,17,20,0
22,3,0,12,2,2,1,36.77,11.48,4842.06,0.14,81,0.09,269.0,27,54,20,22,0
27,5,0,9,3,1,1,54.96,8.31,3793.04,0.15,87,0.12,210.72,36,51,26,27,0
31,9,1,4,5,1,1,14.28,19.94,5674.43,0.09,67,0.05,315.25,29,38,8,32,0
127,19,7,39,10,8,8,124.12,29.01,104460.67,1.2,526,0.03,5803.37,220,306,91,134,0
45,7,1,5,4,4,1,99.18,16.49,26973.57,0.55,261,0.06,1498.53,94,167,57,46,0
92,29,27,41,15,15,15,46.37,57.0,150670.96,0.88,466,0.02,8370.61,192,274,32,119,0
18,7,7,11,4,1,4,24.0,15.38,5680.1,0.12,76,0.07,315.56,25,51,13,25,0
36,11,9,22,6,6,1,46.84,21.46,21576.47,0.34,182,0.05,1198.69,61,121,27,45,0
22,5,4,0,3,3,1,24.31,14.06,4807.12,0.11,69,0.07,267.06,30,39,16,26,0
30,7,10,22,4,2,1,45.35,25.34,29117.23,0.38,193,0.04,1617.62,75,118,37,40,0
16,7,6,10,4,2,1,22.84,25.89,15315.78,0.2,109,0.04,850.88,41,68,19,22,0
15,7,7,10,4,2,1,22.84,25.89,15315.78,0.2,109,0.04,850.88,41,68,19,22,0
40,19,35,31,10,8,1,83.37,31.3,81653.73,0.87,399,0.03,4536.32,153,246,66,75,0
44,11,18,28,6,4,1,71.49,34.84,86774.3,0.83,380,0.03,4820.79,135,245,62,62,0
31,9,5,0,5,5,1,44.36,16.56,12163.87,0.24,141,0.06,675.77,69,72,25,36,0
22,11,11,21,6,3,1,25.24,19.95,10047.02,0.17,94,0.05,558.17,38,56,20,33,0
20,7,2,13,4,4,1,46.13,14.44,9617.77,0.22,122,0.07,534.32,38,84,25,22,0
25,3,2,4,2,2,1,48.82,16.55,13373.72,0.27,148,0.06,742.98,64,84,29,27,0
10,3,5,4,2,1,1,21.05,9.8,2021.97,0.07,45,0.1,112.33,14,31,10,15,0
10,3,5,4,2,1,1,21.05,9.8,2021.97,0.07,45,0.1,112.33,14,31,10,15,0
14,5,4,8,3,2,1,30.91,8.62,2294.05,0.09,56,0.12,127.45,16,40,13,18,0
27,11,4,16,6,5,3,53.81,14.9,11951.03,0.27,140,0.07,663.95,42,98,31,31,0
20,7,3,12,4,4,1,47.35,11.12,5850.56,0.18,97,0.09,325.03,34,63,26,23,0
28,13,4,18,7,5,5,55.58,14.56,11789.43,0.27,142,0.07,654.97,43,99,31,32,0
45,23,21,29,12,8,5,68.78,26.32,47644.35,0.6,288,0.04,2646.91,94,194,50,66,0
11,3,2,2,2,1,1,10.9,12.0,1569.59,0.04,32,0.08,87.2,10,22,5,13,0
11,3,2,2,2,1,1,17.29,12.0,2489.43,0.07,48,0.08,138.3,16,32,8,13,0
27,15,14,22,8,6,4,35.27,13.74,6655.21,0.16,93,0.07,369.73,29,64,19,41,0
10,3,4,12,2,2,1,15.6,6.67,693.33,0.03,26,0.15,38.52,8,18,6,14,0
9,3,3,3,2,1,1,13.38,8.25,910.48,0.04,27,0.12,50.58,9,18,6,12,0
9,3,3,3,2,1,1,20.27,9.17,1703.56,0.06,43,0.11,94.64,15,28,9,12,0
98,19,6,57,10,7,10,125.84,27.25,93428.15,1.14,486,0.04,5190.45,172,314,101,104,0
172,49,20,56,25,24,15,243.12,22.99,128457.87,1.86,750,0.04,7136.55,252,498,148,192,0
43,7,1,29,4,4,1,84.37,19.2,31093.83,0.54,267,0.05,1727.43,97,170,48,44,0
36,3,11,31,2,2,1,37.89,24.18,22153.96,0.31,171,0.04,1230.78,56,115,22,47,0
21,7,11,5,4,3,1,49.79,9.48,4476.07,0.16,87,0.11,248.67,32,55,27,32,0
16,7,1,1,4,2,1,24.97,20.38,10375.62,0.17,97,0.05,576.42,33,64,17,17,0
14,5,0,7,3,3,1,16.78,11.2,2105.41,0.06,41,0.09,116.97,16,25,10,14,0
88,37,6,51,19,9,9,66.11,50.27,167072.98,1.11,496,0.02,9281.83,207,289,70,94,0
29,6,7,6,4,3,1,49.27,18.53,16907.83,0.3,151,0.05,939.32,57,94,40,36,0
60,41,16,37,21,15,5,78.4,74.77,438244.07,1.95,821,0.01,24346.89,319,502,96,76,0
52,19,12,25,10,6,3,47.49,47.96,109246.59,0.76,350,0.02,6069.25,140,210,54,64,0
101,37,44,76,19,8,9,75.03,66.0,326814.89,1.65,685,0.02,18156.38,264,421,100,145,0
29,15,28,6,8,6,1,78.29,48.05,180758.79,1.25,565,0.02,10042.15,217,348,70,57,0
22,11,3,8,6,4,5,37.5,29.45,32535.15,0.37,187,0.03,1807.51,72,115,33,25,0
29,8,7,3,6,6,1,29.49,24.0,16987.59,0.24,133,0.04,943.76,48,85,20,36,0
15,7,1,0,4,2,4,22.03,12.0,3172.85,0.09,55,0.08,176.27,18,37,12,16,0
14,3,2,7,2,1,1,25.23,9.5,2277.36,0.08,51,0.11,126.52,19,32,13,16,0
63,20,5,0,15,3,4,45.89,35.45,57670.7,0.54,262,0.03,3203.93,79,183,39,68,0
9,3,2,1,2,1,1,24.7,7.22,1288.28,0.06,40,0.14,71.57,10,30,9,11,0
9,3,2,0,2,1,1,24.08,7.22,1256.07,0.06,39,0.14,69.78,10,29,9,11,0
17,7,1,1,4,2,1,25.0,13.6,4624.0,0.11,68,0.07,256.89,24,44,15,18,0
27,9,7,0,5,5,1,50.43,10.62,5682.29,0.18,102,0.09,315.68,46,56,26,34,0
62,17,2,0,9,9,1,183.65,7.02,9044.12,0.43,214,0.14,502.45,100,114,57,64,0
12,3,0,9,2,2,1,22.78,2.33,124.02,0.02,16,0.43,6.89,7,9,6,12,0
24,7,0,0,4,2,1,20.18,16.36,5403.6,0.11,73,0.06,300.2,30,43,11,24,0
13,5,4,0,3,3,1,25.58,13.2,4456.28,0.11,71,0.08,247.57,33,38,15,17,0
32,5,3,13,3,1,1,58.73,53.2,166215.79,1.04,538,0.02,9234.21,266,272,40,35,0
10,3,0,0,2,2,1,22.35,7.27,1181.93,0.05,37,0.14,65.66,16,21,11,10,0
17,5,4,3,3,3,1,29.6,24.29,17460.6,0.24,137,0.04,970.03,60,77,21,21,0
7,3,0,0,2,1,1,8.79,12.0,1265.83,0.04,27,0.08,70.32,12,15,5,7,0
9,5,0,0,3,1,1,12.09,14.14,2417.96,0.06,41,0.07,134.33,18,23,7,9,0
11,5,0,0,3,1,1,14.67,14.67,3156.61,0.07,49,0.07,175.37,22,27,9,11,0
7,3,0,0,2,1,1,8.79,12.0,1265.83,0.04,27,0.08,70.32,12,15,5,7,0
9,5,0,0,3,1,1,12.09,14.14,2417.96,0.06,41,0.07,134.33,18,23,7,9,0
11,5,0,0,3,1,1,14.67,14.67,3156.61,0.07,49,0.07,175.37,22,27,9,11,0
7,3,0,0,2,1,1,8.79,12.0,1265.83,0.04,27,0.08,70.32,12,15,5,7,0
9,5,0,0,3,1,1,12.09,14.14,2417.96,0.06,41,0.07,134.33,18,23,7,9,0
11,5,0,0,3,1,1,14.67,14.67,3156.61,0.07,49,0.07,175.37,22,27,9,11,0
48,11,25,13,6,4,5,71.01,24.77,43561.75,0.59,279,0.04,2420.1,107,172,54,73,0
7,3,0,2,2,2,1,16.52,6.19,632.28,0.03,25,0.16,35.13,11,14,8,7,0
7,3,0,2,2,2,1,16.52,6.19,632.28,0.03,25,0.16,35.13,11,14,8,7,0
7,3,0,2,2,2,1,16.52,6.19,632.28,0.03,25,0.16,35.13,11,14,8,7,0
7,3,0,2,2,2,1,16.52,6.19,632.28,0.03,25,0.16,35.13,11,14,8,7,0
7,3,0,2,2,2,1,16.52,6.19,632.28,0.03,25,0.16,35.13,11,14,8,7,0
7,3,0,2,2,2,1,16.52,6.19,632.28,0.03,25,0.16,35.13,11,14,8,7,0
7,3,0,2,2,2,1,16.52,6.19,632.28,0.03,25,0.16,35.13,11,14,8,7,0
15,7,2,14,4,1,3,17.03,14.68,3670.2,0.08,52,0.07,203.9,19,33,11,17,0
9,3,0,8,2,1,1,11.86,4.38,227.03,0.02,15,0.23,12.61,5,10,4,9,0
8,3,0,10,2,1,1,11.07,4.38,211.89,0.02,14,0.23,11.77,5,9,4,8,0
8,3,0,5,2,1,1,17.16,6.19,657.1,0.04,25,0.16,36.51,9,16,8,8,0
8,3,0,10,2,1,1,11.07,4.38,211.89,0.02,14,0.23,11.77,5,9,4,8,0
9,3,0,2,2,2,1,19.71,5.5,596.3,0.04,26,0.18,33.13,11,15,9,9,0
13,5,4,19,3,2,1,22.53,13.93,4371.1,0.1,66,0.07,242.84,30,36,14,17,0
24,17,0,0,9,8,1,30.54,11.65,4143.37,0.12,74,0.09,230.19,36,38,17,24,0
25,7,0,15,4,3,1,21.39,22.46,10795.37,0.16,97,0.04,599.74,37,60,14,25,0
176,43,6,100,23,17,15,140.31,37.2,194194.61,1.74,696,0.03,10788.59,280,416,143,182,0
32,7,9,31,4,3,1,45.51,16.36,12184.85,0.25,130,0.06,676.94,54,76,33,41,0
18,3,0,12,2,2,1,35.45,10.29,3750.81,0.12,70,0.1,208.38,27,43,21,18,0
14,5,3,4,3,2,3,15.83,13.82,3022.38,0.07,46,0.07,167.91,19,27,11,17,0
29,7,4,21,4,3,3,39.73,19.35,14882.34,0.26,133,0.05,826.8,50,83,31,33,0
104,35,5,70,18,7,13,58.36,41.38,99929.77,0.8,372,0.02,5551.65,150,222,58,109,0
68,23,4,58,12,7,5,52.05,21.71,24543.69,0.38,187,0.05,1363.54,76,111,42,72,0
21,7,4,16,4,4,1,31.79,17.86,10140.57,0.19,104,0.06,563.36,47,57,25,25,0
10,3,0,0,2,2,1,10.75,7.0,526.99,0.03,21,0.14,29.28,7,14,4,10,0
66,17,5,26,9,7,4,76.03,28.98,63864.99,0.73,342,0.03,3548.06,136,206,61,71,0
19,5,9,7,3,3,1,37.6,9.75,3574.45,0.12,74,0.1,198.58,27,47,18,28,0
19,3,0,0,2,1,1,24.71,10.58,2764.2,0.09,57,0.09,153.57,25,32,13,19,0
10,3,1,6,2,1,1,16.21,5.4,472.87,0.03,23,0.19,26.27,6,17,5,11,0
15,3,0,0,2,1,1,18.54,9.63,1717.22,0.06,42,0.1,95.4,14,28,8,15,0
10,3,4,15,2,2,1,16.21,10.56,1809.36,0.06,39,0.09,100.52,13,26,8,14,0
44,11,1,16,6,6,1,46.89,18.91,16764.79,0.3,152,0.05,931.38,52,100,33,45,0
15,3,0,0,2,1,1,42.88,6.87,2026.77,0.1,62,0.15,112.6,20,42,16,15,0
12,3,2,0,2,2,1,20.76,2.5,129.72,0.02,15,0.4,7.21,6,9,6,14,0
17,5,4,0,3,3,1,34.27,2.78,264.4,0.03,25,0.36,14.69,10,15,9,21,0
17,7,0,0,4,1,3,10.6,10.13,1086.54,0.04,29,0.1,60.36,9,20,4,17,0
15,11,0,0,6,1,4,7.45,30.8,7065.15,0.08,54,0.03,392.51,22,32,5,15,0
14,3,0,0,2,1,1,11.85,9.0,959.45,0.04,28,0.11,53.3,10,18,5,14,0
10,3,0,0,2,1,1,6.92,8.0,442.81,0.02,16,0.13,24.6,6,10,3,10,0
70,25,6,15,13,9,7,80.81,26.6,57176.91,0.72,343,0.04,3176.49,133,210,55,76,0
24,7,3,2,4,4,1,26.32,16.0,6737.71,0.14,85,0.06,374.32,30,55,15,27,0
12,5,7,9,3,2,1,28.99,18.12,9514.39,0.18,106,0.06,528.58,44,62,17,19,0
9,3,2,2,2,1,1,13.77,13.5,2508.88,0.06,43,0.07,139.38,18,25,8,11,0
9,3,2,2,2,1,1,13.64,17.06,3972.03,0.08,53,0.06,220.67,21,32,8,11,0
8,13,15,2,7,1,1,21.3,16.32,5681.26,0.12,74,0.06,315.63,28,46,12,23,0
19,5,1,9,3,3,1,35.6,10.11,3640.0,0.12,72,0.1,202.22,26,46,18,20,0
76,31,28,17,16,11,10,108.35,33.87,124313.16,1.22,526,0.03,6906.29,199,327,94,104,0
8,5,7,2,3,2,1,17.71,10.67,2014.61,0.06,43,0.09,111.92,16,27,9,15,0
27,9,8,19,5,4,1,42.9,20.7,18381.79,0.3,159,0.05,1021.21,45,114,25,35,0
20,5,10,7,3,2,1,37.71,30.2,34384.39,0.38,205,0.03,1910.24,89,116,28,30,0
27,11,14,5,6,2,1,48.56,33.51,54539.1,0.54,279,0.03,3029.95,124,155,37,41,0
423,162,80,165,96,63,27,131.72,126.56,2109679.46,5.56,2027,0.01,117204.41,798,1229,227,503,0
10,7,2,2,4,3,1,19.23,5.69,622.17,0.04,28,0.18,34.57,13,15,8,12,0
49,31,35,12,16,3,10,83.81,31.06,80843.05,0.87,399,0.03,4491.28,176,223,68,84,0
85,63,53,27,32,10,12,78.34,51.47,207526.23,1.34,589,0.02,11529.23,267,322,83,138,0
165,57,61,32,29,22,27,204.29,41.72,355647.88,2.84,1112,0.02,19758.22,463,649,172,226,0
61,21,6,8,11,10,7,87.92,17.2,26010.73,0.5,253,0.06,1445.04,86,167,45,67,0
63,23,30,18,12,10,3,85.71,38.23,125251.55,1.09,487,0.03,6958.42,203,284,77,93,0
16,5,8,4,3,3,1,28.18,15.16,6475.08,0.14,82,0.07,359.73,32,50,19,24,0
19,7,3,0,4,4,1,40.01,18.29,13377.17,0.24,134,0.05,743.18,64,70,28,22,0
25,11,3,0,6,6,1,42.36,23.73,23858.84,0.34,182,0.04,1325.49,89,93,30,28,0
35,9,1,0,5,5,1,110.24,10.11,11259.34,0.37,191,0.1,625.52,95,96,47,36,0
25,9,2,0,5,4,1,27.4,20.16,11135.5,0.18,100,0.05,618.64,48,52,25,27,0
30,9,1,0,5,5,1,78.0,13.61,14437.64,0.35,189,0.07,802.09,94,95,38,31,0
17,3,1,0,2,2,1,54.5,9.27,4686.53,0.17,103,0.11,260.36,51,52,22,18,0
15,7,1,0,4,4,1,20.45,13.07,3491.27,0.09,55,0.08,193.96,28,27,15,16,0
49,16,1,0,13,13,1,35.91,21.53,16649.11,0.26,132,0.05,924.95,53,79,32,50,0
52,18,1,0,14,14,1,36.57,23.03,19394.56,0.28,142,0.04,1077.48,58,84,34,53,0
42,13,1,0,7,7,1,160.8,10.16,16586.02,0.54,263,0.1,921.45,130,133,64,43,0
62,25,5,8,13,10,9,84.92,18.79,29993.03,0.53,265,0.05,1666.28,91,174,46,67,0
65,25,30,19,13,10,3,83.84,41.66,145477.36,1.16,514,0.02,8082.08,215,299,80,95,0
75,33,25,15,17,11,9,88.15,36.04,114516.56,1.06,465,0.03,6362.03,193,272,83,100,0
10,3,4,0,2,1,1,23.58,12.5,3685.04,0.1,62,0.08,204.72,20,42,12,14,0
6,3,2,6,2,2,1,17.91,6.29,707.7,0.04,27,0.16,39.32,8,19,7,8,0
6,3,2,6,2,2,1,17.91,6.29,707.7,0.04,27,0.16,39.32,8,19,7,8,0
15,3,0,7,2,1,1,17.24,10.64,1950.69,0.06,40,0.09,108.37,18,22,11,15,0
9,3,2,5,2,1,1,17.13,10.0,1713.0,0.06,39,0.1,95.17,15,24,9,11,0
38,13,4,33,10,4,4,32.0,26.1,21802.25,0.28,142,0.04,1211.24,54,88,30,42,0
14,11,2,2,6,1,5,15.76,17.6,4880.94,0.09,59,0.06,271.16,22,37,10,16,0
47,21,7,14,13,2,3,30.99,27.86,24047.21,0.29,150,0.04,1335.96,60,90,28,54,0
11,3,0,1,2,1,1,20.51,6.11,765.94,0.04,29,0.16,42.55,10,19,9,11,0
11,3,0,2,2,1,1,19.8,6.11,739.53,0.04,28,0.16,41.08,10,18,9,11,0
11,3,1,2,2,1,1,14.83,9.63,1373.5,0.05,32,0.1,76.31,11,21,8,12,0
21,7,3,7,4,4,4,46.9,10.5,5170.32,0.16,96,0.1,287.24,28,68,20,24,0
23,7,1,5,4,4,4,46.9,10.5,5170.32,0.16,96,0.1,287.24,28,68,20,24,0
13,5,0,0,3,3,1,33.1,7.26,1746.71,0.08,49,0.14,97.04,19,30,17,13,0
21,5,0,0,3,3,1,34.57,10.93,4129.37,0.13,72,0.09,229.41,27,45,21,21,0
21,5,0,0,3,3,1,36.48,10.43,3969.82,0.13,72,0.1,220.55,27,45,22,21,0
22,7,0,0,4,3,4,41.71,12.75,6780.12,0.18,98,0.08,376.67,39,59,26,22,0
41,15,1,9,8,6,6,75.22,14.8,16481.41,0.37,187,0.07,915.63,67,120,43,42,0
22,7,0,0,4,2,3,21.05,14.77,4591.91,0.1,64,0.07,255.11,24,40,13,22,0
28,9,5,1,5,5,4,18.72,21.54,8684.58,0.13,83,0.05,482.48,35,48,13,33,0
10,3,0,0,2,2,1,10.42,6.75,474.58,0.02,19,0.15,26.37,6,13,4,10,0
50,19,0,0,10,9,10,65.44,11.21,8218.63,0.24,136,0.09,456.59,50,86,29,50,0
29,19,1,0,10,8,10,31.33,20.43,13084.38,0.21,118,0.05,726.91,47,71,23,30,0
50,19,0,0,10,9,10,74.62,10.16,7697.18,0.25,138,0.1,427.62,50,88,32,50,0
22,5,2,0,3,2,1,55.95,7.24,2931.85,0.14,81,0.14,162.88,37,44,23,24,0
18,11,2,3,6,5,4,26.39,12.07,3845.69,0.11,67,0.08,213.65,26,41,14,20,0
12,5,0,0,3,2,1,15.22,12.0,2191.93,0.06,43,0.08,121.77,14,29,7,12,0
41,21,1,8,11,5,7,42.16,35.93,54431.16,0.5,241,0.03,3023.95,98,143,45,42,0
59,13,0,5,7,6,1,95.6,31.4,94278.09,1.0,449,0.03,5237.67,186,263,77,59,0
42,9,0,4,5,5,1,66.6,18.54,22884.16,0.41,209,0.05,1271.34,80,129,41,42,0
9,3,0,0,2,1,1,14.83,3.5,181.62,0.02,15,0.29,10.09,4,11,4,9,0
39,13,1,16,7,5,1,29.5,36.25,38771.24,0.36,185,0.03,2153.96,65,120,26,40,0
