LOC_EXECUTABLE,BRANCH_COUNT,LOC_CODE_AND_COMMENT,LOC_COMMENTS,CYCLOMATIC_COMPLEXITY,DESIGN_COMPLEXITY,ESSENTIAL_COMPLEXITY,HALSTEAD_CONTENT,HALSTEAD_DIFFICULTY,HALSTEAD_EFFORT,HALSTEAD_ERROR_EST,HALSTEAD_LENGTH,HALSTEAD_LEVEL,HALSTEAD_PROG_TIME,NUM_OPERANDS,NUM_OPERATORS,NUM_UNIQUE_OPERANDS,LOC_TOTAL,bug
67,18,14,27,1,1,1,28.6,47.67,64981.35,0.45,238,0.02,3610.07,99,139,27,81,1
67,18,14,27,1,1,1,28.6,47.67,64981.35,0.45,238,0.02,3610.07,99,139,27,81,1
67,18,14,27,1,1,1,31.0,44.38,61064.32,0.46,238,0.02,3392.46,99,139,29,81,1
67,18,14,27,1,1,1,31.0,44.38,61064.32,0.46,238,0.02,3392.46,99,139,29,81,1
14,1,5,6,1,1,1,46.18,8.5,3336.69,0.13,80,0.12,185.37,34,46,20,19,1
14,1,5,6,1,1,1,46.18,8.5,3336.69,0.13,80,0.12,185.37,34,46,20,19,1
21,10,22,13,7,1,1,28.4,22.92,14912.49,0.22,129,0.04,828.47,55,74,18,43,1
21,10,22,13,7,7,1,28.4,22.92,14912.49,0.22,129,0.04,828.47,55,74,18,43,1
1,1,1,0,1,1,1,9.51,3.0,85.59,0.01,9,0.33,4.75,3,6,3,2,1
1,1,1,0,1,1,1,9.51,3.0,85.59,0.01,9,0.33,4.75,3,6,3,2,1
1,1,1,0,1,1,1,8.54,4.67,186.03,0.01,12,0.21,10.33,4,8,3,2,1
1,1,1,0,1,1,1,8.54,4.67,186.03,0.01,12,0.21,10.33,4,8,3,2,1
30,21,25,10,11,6,5,24.44,38.5,36220.86,0.31,178,0.03,2012.27,66,112,18,55,1
55,39,3,17,20,2,18,43.19,29.48,37542.5,0.42,228,0.03,2085.69,90,138,29,58,1
1,1,1,0,1,1,1,7.74,1.5,17.41,0.0,5,0.67,0.97,2,3,2,2,1
1,1,1,0,1,1,1,7.74,1.5,17.41,0.0,5,0.67,0.97,2,3,2,2,1
1,1,3,2,1,1,1,17.17,2.4,98.9,0.01,13,0.42,5.49,6,7,5,4,1
1,1,3,2,1,1,1,16.21,2.25,82.12,0.01,13,0.44,4.56,6,7,4,4,1
5,5,5,0,3,2,1,15.65,4.2,276.06,0.02,19,0.24,15.34,7,12,5,10,1
12,11,2,0,6,5,4,32.4,5.33,922.01,0.06,40,0.19,51.22,16,24,12,14,1
37,23,13,18,1,1,1,71.58,16.79,20169.3,0.4,206,0.06,1120.52,94,112,42,50,1
48,17,32,3,13,10,4,49.82,25.34,31983.69,0.42,212,0.04,1776.87,75,137,37,80,1
39,5,2,4,3,2,3,55.48,19.5,21096.95,0.36,197,0.05,1172.05,96,101,32,41,1
39,5,2,4,3,2,3,55.48,19.5,21096.95,0.36,197,0.05,1172.05,96,101,32,41,1
39,5,2,4,3,2,3,55.48,19.5,21096.95,0.36,197,0.05,1172.05,96,101,32,41,1
39,5,2,4,3,2,3,55.48,19.5,21096.95,0.36,197,0.05,1172.05,96,101,32,41,1
39,5,2,4,3,2,3,55.48,19.5,21096.95,0.36,197,0.05,1172.05,96,101,32,41,1
39,5,2,4,3,2,3,55.48,19.5,21096.95,0.36,197,0.05,1172.05,96,101,32,41,1
39,5,2,4,3,2,3,55.48,19.5,21096.95,0.36,197,0.05,1172.05,96,101,32,41,1
39,5,2,4,3,2,3,55.48,19.5,21096.95,0.36,197,0.05,1172.05,96,101,32,41,1
39,5,2,4,3,2,3,55.48,19.5,21096.95,0.36,197,0.05,1172.05,96,101,32,41,1
39,5,2,4,3,2,3,55.48,19.5,21096.95,0.36,197,0.05,1172.05,96,101,32,41,1
39,5,2,4,3,2,3,55.48,19.5,21096.95,0.36,197,0.05,1172.05,96,101,32,41,1
39,5,2,4,3,2,3,55.48,19.5,21096.95,0.36,197,0.05,1172.05,96,101,32,41,1
39,5,2,4,3,2,3,55.48,19.5,21096.95,0.36,197,0.05,1172.05,96,101,32,41,1
39,5,2,4,3,2,3,55.48,19.5,21096.95,0.36,197,0.05,1172.05,96,101,32,41,1
39,5,2,4,3,2,3,55.48,19.5,21096.95,0.36,197,0.05,1172.05,96,101,32,41,1
39,5,2,4,3,2,3,55.48,19.5,21096.95,0.36,197,0.05,1172.05,96,101,32,41,1
39,5,2,4,3,2,3,55.48,19.5,21096.95,0.36,197,0.05,1172.05,96,101,32,41,1
25,11,0,3,6,4,3,38.91,9.55,3545.04,0.12,73,0.1,196.95,35,38,22,25,1
19,7,1,0,4,1,1,18.03,12.67,2893.07,0.08,52,0.08,160.73,19,33,9,20,1
66,23,11,8,12,8,7,74.53,21.0,32866.37,0.52,249,0.05,1825.91,114,135,57,77,1
52,43,1,17,22,10,13,45.12,30.48,41924.98,0.46,249,0.03,2329.17,104,145,29,53,1
33,13,9,7,9,5,3,29.94,36.35,39555.7,0.36,190,0.03,2197.54,70,120,26,42,1
33,13,9,7,9,5,3,22.48,40.3,36506.33,0.3,164,0.02,2028.13,62,102,20,42,1
44,16,17,15,12,7,3,40.53,57.35,133316.06,0.77,378,0.02,7406.45,148,230,40,61,1
44,16,17,15,12,7,3,34.55,65.19,146834.36,0.75,374,0.02,8157.46,143,231,34,61,1
146,52,2,108,1,1,1,102.5,61.98,393734.55,2.12,909,0.02,21874.14,368,541,95,148,1
91,11,47,27,6,1,1,253.3,20.6,107527.91,1.74,753,0.05,5973.77,273,480,106,138,1
578,197,61,52,1,1,1,89.82,201.29,3639354.46,6.03,2205,0.0,202186.38,781,1424,194,639,1
10,1,12,88,1,1,1,107.19,4.0,1715.09,0.14,85,0.25,95.28,36,49,27,22,1
10,1,12,88,1,1,1,122.07,3.6,1582.0,0.15,85,0.28,87.89,36,49,30,22,1
8,1,0,0,1,1,1,93.01,3.5,1139.36,0.11,71,0.29,63.3,35,36,20,8,1
8,1,0,0,1,1,1,93.01,3.5,1139.36,0.11,71,0.29,63.3,35,36,20,8,1
12,1,1,24,1,1,1,74.92,2.5,468.24,0.06,42,0.4,26.01,17,25,17,13,1
12,1,1,24,1,1,1,74.92,2.5,468.24,0.06,42,0.4,26.01,17,25,17,13,1
13,1,0,24,1,1,1,74.92,2.5,468.24,0.06,42,0.4,26.01,17,25,17,13,1
13,1,0,24,1,1,1,74.92,2.5,468.24,0.06,42,0.4,26.01,17,25,17,13,1
37,25,32,2,13,9,8,29.84,37.04,40946.5,0.37,199,0.03,2274.81,71,128,23,69,1
16,9,0,8,5,2,4,31.28,10.0,3127.52,0.1,62,0.1,173.75,24,38,18,16,1
20,9,0,4,5,2,3,17.35,22.85,9054.75,0.13,80,0.04,503.04,33,47,13,20,1
49,5,6,30,3,3,1,100.47,12.98,16924.43,0.43,219,0.08,940.25,89,130,48,55,1
11,1,0,0,1,1,1,12.68,10.0,1267.97,0.04,40,0.1,70.44,10,30,3,11,1
231,69,5,18,38,12,1,161.36,45.73,337457.65,2.46,970,0.02,18747.65,449,521,162,236,1
12,7,5,1,4,2,1,24.67,9.04,2014.11,0.07,48,0.11,111.89,23,25,14,17,1
12,7,5,1,4,2,1,20.6,10.54,2288.92,0.07,48,0.09,127.16,23,25,12,17,1
34,5,4,3,3,3,1,43.4,21.27,19640.49,0.31,180,0.05,1091.14,72,108,22,38,1
34,5,4,3,3,3,1,41.8,21.67,19620.65,0.3,178,0.05,1090.04,70,108,21,38,1
0,1,0,0,1,1,1,0.0,0.0,0.0,0.0,1,0.0,0.0,0,1,0,0,0
0,1,0,0,1,1,1,0.0,0.0,0.0,0.0,1,0.0,0.0,0,1,0,0,0
0,1,0,0,1,1,1,0.0,0.0,0.0,0.0,0,0.0,0.0,0,0,0,0,0
0,1,0,0,1,1,1,0.0,0.0,0.0,0.0,0,0.0,0.0,0,0,0,0,0
0,1,0,0,1,1,1,0.0,0.0,0.0,0.0,1,0.0,0.0,0,1,0,0,0
0,1,0,0,1,1,1,0.0,0.0,0.0,0.0,1,0.0,0.0,0,1,0,0,0
0,1,0,0,1,1,1,0.0,0.0,0.0,0.0,0,0.0,0.0,0,0,0,0,0
0,1,0,0,1,1,1,0.0,0.0,0.0,0.0,0,0.0,0.0,0,0,0,0,0
0,1,0,0,1,1,1,0.0,0.0,0.0,0.0,1,0.0,0.0,0,1,0,0,0
0,1,0,0,1,1,1,0.0,0.0,0.0,0.0,1,0.0,0.0,0,1,0,0,0
0,1,0,0,1,1,1,0.0,0.0,0.0,0.0,0,0.0,0.0,0,0,0,0,0
0,1,0,0,1,1,1,0.0,0.0,0.0,0.0,0,0.0,0.0,0,0,0,0,0
0,1,0,0,1,1,1,0.0,0.0,0.0,0.0,1,0.0,0.0,0,1,0,0,0
0,1,0,0,1,1,1,0.0,0.0,0.0,0.0,1,0.0,0.0,0,1,0,0,0
0,1,0,0,1,1,1,0.0,0.0,0.0,0.0,0,0.0,0.0,0,0,0,0,0
0,1,0,0,1,1,1,0.0,0.0,0.0,0.0,0,0.0,0.0,0,0,0,0,0
0,1,0,0,1,1,1,0.0,0.0,0.0,0.0,1,0.0,0.0,0,1,0,0,0
0,1,0,0,1,1,1,0.0,0.0,0.0,0.0,1,0.0,0.0,0,1,0,0,0
0,1,0,0,1,1,1,0.0,0.0,0.0,0.0,0,0.0,0.0,0,0,0,0,0
0,1,0,0,1,1,1,0.0,0.0,0.0,0.0,0,0.0,0.0,0,0,0,0,0
2,1,0,0,1,1,1,7.35,8.0,470.48,0.02,17,0.13,26.14,6,11,3,2,0
2,1,0,0,1,1,1,7.81,9.0,632.78,0.02,19,0.11,35.15,8,11,4,2,0
67,18,15,27,1,1,1,31.0,44.38,61064.32,0.46,238,0.02,3392.46,99,139,29,82,0
67,18,14,27,1,1,1,31.0,44.38,61064.32,0.46,238,0.02,3392.46,99,139,29,81,0
67,18,14,27,1,1,1,28.6,47.67,64981.35,0.45,238,0.02,3610.07,99,139,27,81,0
67,18,14,27,1,1,1,31.0,44.38,61064.32,0.46,238,0.02,3392.46,99,139,29,81,0
67,18,14,27,1,1,1,28.6,47.67,64981.35,0.45,238,0.02,3610.07,99,139,27,81,0
67,18,14,27,1,1,1,31.0,44.38,61064.32,0.46,238,0.02,3392.46,99,139,29,81,0
67,18,14,27,1,1,1,28.6,47.67,64981.35,0.45,238,0.02,3610.07,99,139,27,81,0
67,18,14,27,1,1,1,31.0,44.38,61064.32,0.46,238,0.02,3392.46,99,139,29,81,0
67,18,14,27,1,1,1,31.0,44.38,61064.32,0.46,238,0.02,3392.46,99,139,29,81,0
67,18,14,27,1,1,1,28.6,47.67,64981.35,0.45,238,0.02,3610.07,99,139,27,81,0
67,18,15,27,1,1,1,31.0,44.38,61064.32,0.46,238,0.02,3392.46,99,139,29,82,0
67,18,15,27,1,1,1,28.6,47.67,64981.35,0.45,238,0.02,3610.07,99,139,27,82,0
67,18,14,27,1,1,1,31.0,44.38,61064.32,0.46,238,0.02,3392.46,99,139,29,81,0
67,18,14,27,1,1,1,28.6,47.67,64981.35,0.45,238,0.02,3610.07,99,139,27,81,0
67,18,15,27,1,1,1,28.6,47.67,64981.35,0.45,238,0.02,3610.07,99,139,27,82,0
67,18,14,27,1,1,1,28.6,47.67,64981.35,0.45,238,0.02,3610.07,99,139,27,81,0
20,11,14,4,6,3,1,26.76,22.02,12978.67,0.2,110,0.05,721.04,51,59,22,34,0
20,11,14,4,6,3,1,26.76,22.02,12978.67,0.2,110,0.05,721.04,51,59,22,34,0
19,9,13,4,5,3,1,29.26,19.96,11654.07,0.19,109,0.05,647.45,51,58,23,32,0
20,11,14,4,6,3,1,26.76,22.02,12978.67,0.2,110,0.05,721.04,51,59,22,34,0
19,9,13,4,5,3,1,29.26,19.96,11654.07,0.19,109,0.05,647.45,51,58,23,32,0
20,11,14,4,6,3,1,26.76,22.02,12978.67,0.2,110,0.05,721.04,51,59,22,34,0
20,11,14,4,6,3,1,26.76,22.02,12978.67,0.2,110,0.05,721.04,51,59,22,34,0
20,11,14,4,6,3,1,26.76,22.02,12978.67,0.2,110,0.05,721.04,51,59,22,34,0
20,11,14,4,6,3,1,26.76,22.02,12978.67,0.2,110,0.05,721.04,51,59,22,34,0
20,11,14,4,6,3,1,26.76,22.02,12978.67,0.2,110,0.05,721.04,51,59,22,34,0
7,1,0,3,1,1,1,20.08,5.5,607.27,0.04,29,0.18,33.74,11,18,7,7,0
7,1,0,3,1,1,1,20.08,5.5,607.27,0.04,29,0.18,33.74,11,18,7,7,0
7,1,0,3,1,1,1,20.08,5.5,607.27,0.04,29,0.18,33.74,11,18,7,7,0
7,1,0,3,1,1,1,20.08,5.5,607.27,0.04,29,0.18,33.74,11,18,7,7,0
7,1,0,3,1,1,1,20.08,5.5,607.27,0.04,29,0.18,33.74,11,18,7,7,0
7,1,0,3,1,1,1,20.08,5.5,607.27,0.04,29,0.18,33.74,11,18,7,7,0
7,1,0,3,1,1,1,20.08,5.5,607.27,0.04,29,0.18,33.74,11,18,7,7,0
7,1,0,3,1,1,1,20.08,5.5,607.27,0.04,29,0.18,33.74,11,18,7,7,0
7,1,0,3,1,1,1,20.08,5.5,607.27,0.04,29,0.18,33.74,11,18,7,7,0
7,1,0,3,1,1,1,20.08,5.5,607.27,0.04,29,0.18,33.74,11,18,7,7,0
7,1,0,3,1,1,1,20.08,5.5,607.27,0.04,29,0.18,33.74,11,18,7,7,0
7,1,0,3,1,1,1,20.08,5.5,607.27,0.04,29,0.18,33.74,11,18,7,7,0
7,1,0,3,1,1,1,20.08,5.5,607.27,0.04,29,0.18,33.74,11,18,7,7,0
7,1,0,3,1,1,1,20.08,5.5,607.27,0.04,29,0.18,33.74,11,18,7,7,0
7,1,0,3,1,1,1,20.08,5.5,607.27,0.04,29,0.18,33.74,11,18,7,7,0
7,1,0,3,1,1,1,20.08,5.5,607.27,0.04,29,0.18,33.74,11,18,7,7,0
7,1,0,3,1,1,1,20.08,5.5,607.27,0.04,29,0.18,33.74,11,18,7,7,0
7,1,0,3,1,1,1,20.08,5.5,607.27,0.04,29,0.18,33.74,11,18,7,7,0
7,1,0,3,1,1,1,20.08,5.5,607.27,0.04,29,0.18,33.74,11,18,7,7,0
7,1,0,3,1,1,1,20.08,5.5,607.27,0.04,29,0.18,33.74,11,18,7,7,0
1,1,1,0,1,1,1,9.83,2.0,39.3,0.01,7,0.5,2.18,3,4,3,2,0
1,1,1,0,1,1,1,9.83,2.0,39.3,0.01,7,0.5,2.18,3,4,3,2,0
1,1,1,0,1,1,1,9.83,2.0,39.3,0.01,7,0.5,2.18,3,4,3,2,0
1,1,1,0,1,1,1,9.83,2.0,39.3,0.01,7,0.5,2.18,3,4,3,2,0
1,1,1,0,1,1,1,9.83,2.0,39.3,0.01,7,0.5,2.18,3,4,3,2,0
1,1,1,0,1,1,1,9.83,2.0,39.3,0.01,7,0.5,2.18,3,4,3,2,0
1,1,1,0,1,1,1,9.83,2.0,39.3,0.01,7,0.5,2.18,3,4,3,2,0
1,1,1,0,1,1,1,9.83,2.0,39.3,0.01,7,0.5,2.18,3,4,3,2,0
1,1,1,0,1,1,1,9.83,2.0,39.3,0.01,7,0.5,2.18,3,4,3,2,0
1,1,1,0,1,1,1,9.83,2.0,39.3,0.01,7,0.5,2.18,3,4,3,2,0
1,1,1,0,1,1,1,9.83,2.0,39.3,0.01,7,0.5,2.18,3,4,3,2,0
1,1,1,0,1,1,1,9.83,2.0,39.3,0.01,7,0.5,2.18,3,4,3,2,0
1,1,1,0,1,1,1,9.83,2.0,39.3,0.01,7,0.5,2.18,3,4,3,2,0
1,1,1,0,1,1,1,9.83,2.0,39.3,0.01,7,0.5,2.18,3,4,3,2,0
1,1,1,0,1,1,1,9.83,2.0,39.3,0.01,7,0.5,2.18,3,4,3,2,0
1,1,1,0,1,1,1,9.83,2.0,39.3,0.01,7,0.5,2.18,3,4,3,2,0
1,1,1,0,1,1,1,9.83,2.0,39.3,0.01,7,0.5,2.18,3,4,3,2,0
1,1,1,0,1,1,1,9.83,2.0,39.3,0.01,7,0.5,2.18,3,4,3,2,0
1,1,1,0,1,1,1,9.83,2.0,39.3,0.01,7,0.5,2.18,3,4,3,2,0
1,1,1,0,1,1,1,9.83,2.0,39.3,0.01,7,0.5,2.18,3,4,3,2,0
1,1,1,0,1,1,1,10.44,3.5,127.89,0.01,11,0.29,7.11,3,8,3,2,0
1,1,1,0,1,1,1,10.44,3.5,127.89,0.01,11,0.29,7.11,3,8,3,2,0
1,1,1,0,1,1,1,10.44,3.5,127.89,0.01,11,0.29,7.11,3,8,3,2,0
1,1,1,0,1,1,1,10.44,3.5,127.89,0.01,11,0.29,7.11,3,8,3,2,0
1,1,1,0,1,1,1,10.44,3.5,127.89,0.01,11,0.29,7.11,3,8,3,2,0
1,1,1,0,1,1,1,10.44,3.5,127.89,0.01,11,0.29,7.11,3,8,3,2,0
1,1,1,0,1,1,1,10.44,3.5,127.89,0.01,11,0.29,7.11,3,8,3,2,0
1,1,1,0,1,1,1,10.44,3.5,127.89,0.01,11,0.29,7.11,3,8,3,2,0
1,1,1,0,1,1,1,10.44,3.5,127.89,0.01,11,0.29,7.11,3,8,3,2,0
1,1,1,0,1,1,1,10.44,3.5,127.89,0.01,11,0.29,7.11,3,8,3,2,0
4,3,4,0,2,1,1,8.76,10.0,875.69,0.03,23,0.1,48.65,8,15,4,8,0
4,3,4,0,2,1,1,8.76,10.0,875.69,0.03,23,0.1,48.65,8,15,4,8,0
4,3,4,0,2,1,1,8.76,10.0,875.69,0.03,23,0.1,48.65,8,15,4,8,0
4,3,4,0,2,1,1,8.76,10.0,875.69,0.03,23,0.1,48.65,8,15,4,8,0
4,3,4,0,2,1,1,8.76,10.0,875.69,0.03,23,0.1,48.65,8,15,4,8,0
4,3,4,0,2,1,1,8.76,10.0,875.69,0.03,23,0.1,48.65,8,15,4,8,0
4,3,4,0,2,1,1,8.76,10.0,875.69,0.03,23,0.1,48.65,8,15,4,8,0
4,3,4,0,2,1,1,8.76,10.0,875.69,0.03,23,0.1,48.65,8,15,4,8,0
4,3,4,0,2,1,1,8.76,10.0,875.69,0.03,23,0.1,48.65,8,15,4,8,0
4,3,4,0,2,1,1,8.76,10.0,875.69,0.03,23,0.1,48.65,8,15,4,8,0
7,3,1,0,2,1,1,7.32,8.17,488.32,0.02,18,0.12,27.13,7,11,3,8,0
7,3,1,0,2,1,1,7.32,8.17,488.32,0.02,18,0.12,27.13,7,11,3,8,0
7,3,1,0,2,1,1,7.32,8.17,488.32,0.02,18,0.12,27.13,7,11,3,8,0
7,3,1,0,2,1,1,7.32,8.17,488.32,0.02,18,0.12,27.13,7,11,3,8,0
7,3,1,0,2,1,1,7.32,8.17,488.32,0.02,18,0.12,27.13,7,11,3,8,0
7,3,1,0,2,1,1,7.32,8.17,488.32,0.02,18,0.12,27.13,7,11,3,8,0
7,3,1,0,2,1,1,7.32,8.17,488.32,0.02,18,0.12,27.13,7,11,3,8,0
7,3,1,0,2,1,1,7.32,8.17,488.32,0.02,18,0.12,27.13,7,11,3,8,0
7,3,1,0,2,1,1,7.32,8.17,488.32,0.02,18,0.12,27.13,7,11,3,8,0
7,3,1,0,2,1,1,7.32,8.17,488.32,0.02,18,0.12,27.13,7,11,3,8,0
14,1,5,6,1,1,1,46.18,8.5,3336.69,0.13,80,0.12,185.37,34,46,20,19,0
14,1,5,6,1,1,1,46.18,8.5,3336.69,0.13,80,0.12,185.37,34,46,20,19,0
14,1,5,6,1,1,1,46.18,8.5,3336.69,0.13,80,0.12,185.37,34,46,20,19,0
14,1,5,6,1,1,1,46.18,8.5,3336.69,0.13,80,0.12,185.37,34,46,20,19,0
14,1,5,6,1,1,1,46.18,8.5,3336.69,0.13,80,0.12,185.37,34,46,20,19,0
14,1,5,6,1,1,1,46.18,8.5,3336.69,0.13,80,0.12,185.37,34,46,20,19,0
14,1,5,6,1,1,1,46.18,8.5,3336.69,0.13,80,0.12,185.37,34,46,20,19,0
14,1,5,6,1,1,1,46.18,8.5,3336.69,0.13,80,0.12,185.37,34,46,20,19,0
14,1,5,6,1,1,1,46.18,8.5,3336.69,0.13,80,0.12,185.37,34,46,20,19,0
14,1,5,6,1,1,1,46.18,8.5,3336.69,0.13,80,0.12,185.37,34,46,20,19,0
14,1,5,6,1,1,1,46.18,8.5,3336.69,0.13,80,0.12,185.37,34,46,20,19,0
14,1,5,6,1,1,1,46.18,8.5,3336.69,0.13,80,0.12,185.37,34,46,20,19,0
14,1,5,6,1,1,1,46.18,8.5,3336.69,0.13,80,0.12,185.37,34,46,20,19,0
14,1,5,6,1,1,1,46.18,8.5,3336.69,0.13,80,0.12,185.37,34,46,20,19,0
14,1,5,6,1,1,1,46.18,8.5,3336.69,0.13,80,0.12,185.37,34,46,20,19,0
14,1,5,6,1,1,1,46.18,8.5,3336.69,0.13,80,0.12,185.37,34,46,20,19,0
14,1,5,6,1,1,1,46.18,8.5,3336.69,0.13,80,0.12,185.37,34,46,20,19,0
14,1,5,6,1,1,1,46.18,8.5,3336.69,0.13,80,0.12,185.37,34,46,20,19,0
6,5,5,0,3,1,1,13.67,11.43,1786.01,0.05,40,0.09,99.22,20,20,7,11,0
6,5,5,0,3,1,1,13.67,11.43,1786.01,0.05,40,0.09,99.22,20,20,7,11,0
6,5,5,0,3,1,1,13.67,11.43,1786.01,0.05,40,0.09,99.22,20,20,7,11,0
6,5,5,0,3,1,1,13.67,11.43,1786.01,0.05,40,0.09,99.22,20,20,7,11,0
6,5,5,0,3,1,1,13.67,11.43,1786.01,0.05,40,0.09,99.22,20,20,7,11,0
6,5,5,0,3,1,1,13.67,11.43,1786.01,0.05,40,0.09,99.22,20,20,7,11,0
6,5,5,0,3,1,1,13.67,11.43,1786.01,0.05,40,0.09,99.22,20,20,7,11,0
6,5,5,0,3,1,1,13.67,11.43,1786.01,0.05,40,0.09,99.22,20,20,7,11,0
6,5,5,0,3,1,1,13.67,11.43,1786.01,0.05,40,0.09,99.22,20,20,7,11,0
6,5,5,0,3,1,1,13.67,11.43,1786.01,0.05,40,0.09,99.22,20,20,7,11,0
6,5,5,0,3,1,1,13.67,11.43,1786.01,0.05,40,0.09,99.22,20,20,7,11,0
6,5,5,0,3,1,1,13.67,11.43,1786.01,0.05,40,0.09,99.22,20,20,7,11,0
6,5,5,0,3,1,1,13.67,11.43,1786.01,0.05,40,0.09,99.22,20,20,7,11,0
6,5,5,0,3,1,1,13.67,11.43,1786.01,0.05,40,0.09,99.22,20,20,7,11,0
6,5,5,0,3,1,1,13.67,11.43,1786.01,0.05,40,0.09,99.22,20,20,7,11,0
6,5,5,0,3,1,1,13.67,11.43,1786.01,0.05,40,0.09,99.22,20,20,7,11,0
6,5,5,0,3,1,1,13.67,11.43,1786.01,0.05,40,0.09,99.22,20,20,7,11,0
6,5,5,0,3,1,1,13.67,11.43,1786.01,0.05,40,0.09,99.22,20,20,7,11,0
6,5,5,0,3,1,1,13.67,11.43,1786.01,0.05,40,0.09,99.22,20,20,7,11,0
6,5,5,0,3,1,1,13.67,11.43,1786.01,0.05,40,0.09,99.22,20,20,7,11,0
3,1,0,9,1,1,1,16.84,1.5,37.9,0.01,9,0.67,2.11,4,5,4,3,0
3,1,0,9,1,1,1,16.84,1.5,37.9,0.01,9,0.67,2.11,4,5,4,3,0
3,1,0,9,1,1,1,16.84,1.5,37.9,0.01,9,0.67,2.11,4,5,4,3,0
3,1,0,9,1,1,1,16.84,1.5,37.9,0.01,9,0.67,2.11,4,5,4,3,0
3,1,0,9,1,1,1,16.84,1.5,37.9,0.01,9,0.67,2.11,4,5,4,3,0
3,1,0,9,1,1,1,16.84,1.5,37.9,0.01,9,0.67,2.11,4,5,4,3,0
3,1,0,9,1,1,1,16.84,1.5,37.9,0.01,9,0.67,2.11,4,5,4,3,0
3,1,0,9,1,1,1,16.84,1.5,37.9,0.01,9,0.67,2.11,4,5,4,3,0
3,1,0,9,1,1,1,16.84,1.5,37.9,0.01,9,0.67,2.11,4,5,4,3,0
3,1,0,9,1,1,1,16.84,1.5,37.9,0.01,9,0.67,2.11,4,5,4,3,0
4,1,0,0,1,1,1,10.24,7.0,501.89,0.02,20,0.14,27.88,7,13,4,4,0
4,1,0,0,1,1,1,10.24,7.0,501.89,0.02,20,0.14,27.88,7,13,4,4,0
4,3,0,0,2,2,1,21.5,7.15,1099.18,0.05,35,0.14,61.07,13,22,10,4,0
4,3,0,0,2,2,1,21.5,7.15,1099.18,0.05,35,0.14,61.07,13,22,10,4,0
8,3,0,0,2,2,1,23.46,10.29,2485.24,0.08,52,0.1,138.07,19,33,12,8,0
8,3,0,0,2,2,1,23.46,10.29,2485.24,0.08,52,0.1,138.07,19,33,12,8,0
54,13,1,8,7,6,6,25.11,40.0,40181.42,0.33,184,0.03,2232.3,80,104,22,55,0
54,13,1,8,7,6,6,25.11,40.0,40181.42,0.33,184,0.03,2232.3,80,104,22,55,0
0,1,0,0,1,1,1,8.3,6.67,369.01,0.02,16,0.15,20.5,5,11,3,0,0
0,1,0,0,1,1,1,8.3,6.67,369.01,0.02,16,0.15,20.5,5,11,3,0,0
23,5,0,1,3,2,1,19.78,20.04,7940.87,0.13,80,0.05,441.16,33,47,14,23,0
23,5,0,1,3,2,1,19.78,20.04,7940.87,0.13,80,0.05,441.16,33,47,14,23,0
0,1,0,0,1,1,1,8.6,7.5,483.97,0.02,18,0.13,26.89,5,13,3,0,0
0,1,0,0,1,1,1,8.6,7.5,483.97,0.02,18,0.13,26.89,5,13,3,0,0
19,5,0,3,3,3,1,20.96,10.5,2310.82,0.07,48,0.1,128.38,21,27,12,19,0
19,5,0,3,3,3,1,19.07,10.91,2270.01,0.07,46,0.09,126.11,20,26,11,19,0
12,3,0,2,2,2,1,16.67,8.56,1220.22,0.05,33,0.12,67.79,14,19,9,12,0
12,3,0,2,2,2,1,14.73,8.94,1176.94,0.04,31,0.11,65.39,13,18,8,12,0
12,9,0,0,5,3,3,17.46,16.55,4779.2,0.1,63,0.06,265.51,28,35,11,12,0
12,9,0,0,5,3,3,17.46,16.55,4779.2,0.1,63,0.06,265.51,28,35,11,12,0
4,1,0,0,1,1,1,9.47,2.67,67.38,0.01,9,0.38,3.74,4,5,3,4,0
4,1,0,0,1,1,1,9.47,2.67,67.38,0.01,9,0.38,3.74,4,5,3,4,0
13,5,0,0,3,3,1,16.4,7.07,820.29,0.04,29,0.14,45.57,11,18,7,13,0
13,5,0,0,3,3,1,16.4,7.07,820.29,0.04,29,0.14,45.57,11,18,7,13,0
13,5,0,0,3,3,1,17.24,7.5,969.51,0.04,31,0.13,53.86,12,19,8,13,0
13,5,0,0,3,3,1,17.24,7.5,969.51,0.04,31,0.13,53.86,12,19,8,13,0
4,3,0,0,2,2,1,11.99,6.67,533.03,0.03,21,0.15,29.61,10,11,6,4,0
4,3,0,0,2,2,1,11.99,6.67,533.03,0.03,21,0.15,29.61,10,11,6,4,0
0,1,0,0,1,1,1,6.55,3.0,58.95,0.01,7,0.33,3.28,1,6,1,0,0
0,3,0,0,2,2,1,6.69,7.5,376.42,0.02,14,0.13,20.91,5,9,3,0,0
0,1,0,0,1,1,1,7.86,2.5,49.13,0.01,7,0.4,2.73,2,5,2,0,0
0,3,0,0,2,2,1,9.32,5.0,233.02,0.02,13,0.2,12.95,5,8,4,0,0
0,1,0,0,1,1,1,6.55,3.0,58.95,0.01,7,0.33,3.28,1,6,1,0,0
0,3,0,0,2,2,1,6.69,7.5,376.42,0.02,14,0.13,20.91,5,9,3,0,0
0,1,0,0,1,1,1,7.86,2.5,49.13,0.01,7,0.4,2.73,2,5,2,0,0
0,3,0,0,2,2,1,9.32,5.0,233.02,0.02,13,0.2,12.95,5,8,4,0,0
6,1,0,0,1,1,1,17.51,5.0,437.85,0.03,23,0.2,24.32,10,13,7,6,0
6,1,0,0,1,1,1,17.51,5.0,437.85,0.03,23,0.2,24.32,10,13,7,6,0
0,3,0,0,2,2,1,7.75,2.0,31.02,0.01,6,0.5,1.72,2,4,2,0,0
0,3,0,0,2,2,1,7.75,2.0,31.02,0.01,6,0.5,1.72,2,4,2,0,0
0,3,0,0,2,2,1,7.86,2.5,49.13,0.01,7,0.4,2.73,2,5,2,0,0
0,3,0,0,2,2,1,7.86,2.5,49.13,0.01,7,0.4,2.73,2,5,2,0,0
11,7,0,0,4,2,3,12.35,16.0,3162.47,0.07,45,0.06,175.69,16,29,7,11,0
11,7,0,0,4,2,3,12.35,16.0,3162.47,0.07,45,0.06,175.69,16,29,7,11,0
3,3,0,0,2,2,1,14.28,4.0,228.44,0.02,15,0.25,12.69,6,9,6,3,0
3,3,0,0,2,2,1,14.28,4.0,228.44,0.02,15,0.25,12.69,6,9,6,3,0
0,1,0,0,1,1,1,7.75,2.0,31.02,0.01,6,0.5,1.72,2,4,2,0,0
0,1,0,0,1,1,1,7.75,2.0,31.02,0.01,6,0.5,1.72,2,4,2,0,0
0,1,0,0,1,1,1,0.0,0.0,0.0,0.0,1,0.0,0.0,0,1,0,0,0
0,1,0,0,1,1,1,0.0,0.0,0.0,0.0,1,0.0,0.0,0,1,0,0,0
2,1,0,0,1,1,1,13.5,2.0,54.0,0.01,9,0.5,3.0,4,5,4,2,0
2,1,0,0,1,1,1,13.5,2.0,54.0,0.01,9,0.5,3.0,4,5,4,2,0
0,1,0,0,1,1,1,7.75,2.0,31.02,0.01,6,0.5,1.72,2,4,2,0,0
0,1,0,0,1,1,1,7.75,2.0,31.02,0.01,6,0.5,1.72,2,4,2,0,0
0,1,0,0,1,1,1,7.75,2.0,31.02,0.01,6,0.5,1.72,2,4,2,0,0
0,1,0,0,1,1,1,7.75,2.0,31.02,0.01,6,0.5,1.72,2,4,2,0,0
0,1,0,0,1,1,1,9.83,2.0,39.3,0.01,7,0.5,2.18,3,4,3,0,0
0,1,0,0,1,1,1,9.83,2.0,39.3,0.01,7,0.5,2.18,3,4,3,0,0
0,1,0,0,1,1,1,7.75,2.0,31.02,0.01,6,0.5,1.72,2,4,2,0,0
0,1,0,0,1,1,1,7.75,2.0,31.02,0.01,6,0.5,1.72,2,4,2,0,0
0,1,0,0,1,1,1,7.74,1.5,17.41,0.0,5,0.67,0.97,2,3,2,0,0
0,1,0,0,1,1,1,7.74,1.5,17.41,0.0,5,0.67,0.97,2,3,2,0,0
1,1,0,0,1,1,1,7.74,1.5,17.41,0.0,5,0.67,0.97,2,3,2,1,0
1,1,0,0,1,1,1,7.74,1.5,17.41,0.0,5,0.67,0.97,2,3,2,1,0
0,1,0,0,1,1,1,5.8,2.0,23.22,0.0,5,0.5,1.29,1,4,1,0,0
0,1,0,0,1,1,1,5.8,2.0,23.22,0.0,5,0.5,1.29,1,4,1,0,0
2,1,0,0,1,1,1,7.75,2.0,31.02,0.01,6,0.5,1.72,2,4,2,2,0
2,1,0,0,1,1,1,7.75,2.0,31.02,0.01,6,0.5,1.72,2,4,2,2,0
1,1,0,1,1,1,1,0.0,0.0,0.0,0.0,1,0.0,0.0,0,1,0,1,0
1,1,0,1,1,1,1,0.0,0.0,0.0,0.0,1,0.0,0.0,0,1,0,1,0
2,1,0,0,1,1,1,7.75,2.0,31.02,0.01,6,0.5,1.72,2,4,2,2,0
2,1,0,0,1,1,1,7.75,2.0,31.02,0.01,6,0.5,1.72,2,4,2,2,0
0,1,0,0,1,1,1,9.31,2.5,58.16,0.01,9,0.4,3.23,1,8,1,0,0
0,1,0,0,1,1,1,9.31,2.5,58.16,0.01,9,0.4,3.23,1,8,1,0,0
0,1,0,0,1,1,1,7.75,2.0,31.02,0.01,6,0.5,1.72,2,4,2,0,0
0,1,0,0,1,1,1,7.75,2.0,31.02,0.01,6,0.5,1.72,2,4,2,0,0
35,17,2,6,9,5,1,73.85,14.67,15885.23,0.36,190,0.07,882.51,88,102,39,37,0
35,17,2,6,9,5,1,73.85,14.67,15885.23,0.36,190,0.07,882.51,88,102,39,37,0
37,17,2,5,9,5,1,78.21,15.38,18496.28,0.4,209,0.07,1027.56,97,112,41,39,0
37,17,2,5,9,5,1,78.21,15.38,18496.28,0.4,209,0.07,1027.56,97,112,41,39,0
36,17,2,5,9,5,1,73.86,15.67,18129.3,0.39,203,0.06,1007.18,94,109,39,38,0
36,17,2,5,9,5,1,73.86,15.67,18129.3,0.39,203,0.06,1007.18,94,109,39,38,0
3,1,0,0,1,1,1,9.51,3.0,85.59,0.01,9,0.33,4.75,3,6,3,3,0
3,1,0,0,1,1,1,9.51,3.0,85.59,0.01,9,0.33,4.75,3,6,3,3,0
5,3,0,0,2,2,1,15.36,3.5,188.21,0.02,15,0.29,10.46,5,10,5,5,0
5,3,0,0,2,2,1,15.36,3.5,188.21,0.02,15,0.29,10.46,5,10,5,5,0
4,3,0,0,2,2,1,10.88,5.6,341.29,0.02,17,0.18,18.96,8,9,5,4,0
4,3,0,0,2,2,1,10.88,5.6,341.29,0.02,17,0.18,18.96,8,9,5,4,0
0,1,0,0,1,1,1,7.74,1.5,17.41,0.0,5,0.67,0.97,2,3,2,0,0
0,1,0,0,1,1,1,7.74,1.5,17.41,0.0,5,0.67,0.97,2,3,2,0,0
2,1,0,0,1,1,1,7.35,8.0,470.48,0.02,17,0.13,26.14,6,11,3,2,0
0,1,0,0,1,1,1,12.68,2.5,79.25,0.01,10,0.4,4.4,4,6,4,0,0
0,1,0,0,1,1,1,12.68,2.5,79.25,0.01,10,0.4,4.4,4,6,4,0,0
0,1,0,0,1,1,1,7.74,1.5,17.41,0.0,5,0.67,0.97,2,3,2,0,0
0,1,0,0,1,1,1,7.74,1.5,17.41,0.0,5,0.67,0.97,2,3,2,0,0
0,1,0,0,1,1,1,7.75,2.0,31.02,0.01,6,0.5,1.72,2,4,2,0,0
0,1,0,0,1,1,1,7.75,2.0,31.02,0.01,6,0.5,1.72,2,4,2,0,0
0,1,0,0,1,1,1,7.75,2.0,31.02,0.01,6,0.5,1.72,2,4,2,0,0
0,1,0,0,1,1,1,7.75,2.0,31.02,0.01,6,0.5,1.72,2,4,2,0,0
0,1,0,0,1,1,1,7.75,2.0,31.02,0.01,6,0.5,1.72,2,4,2,0,0
0,1,0,0,1,1,1,7.75,2.0,31.02,0.01,6,0.5,1.72,2,4,2,0,0
0,1,0,0,1,1,1,7.75,2.0,31.02,0.01,6,0.5,1.72,2,4,2,0,0
0,1,0,0,1,1,1,7.75,2.0,31.02,0.01,6,0.5,1.72,2,4,2,0,0
2,1,0,0,1,1,1,7.81,9.0,632.78,0.02,19,0.11,35.15,8,11,4,2,0
7,3,0,0,2,2,1,15.65,7.31,836.91,0.04,28,0.14,46.49,13,15,8,7,0
31,13,2,9,7,5,1,73.7,13.26,12966.91,0.33,178,0.08,720.38,82,96,34,33,0
31,13,2,9,7,5,1,73.7,13.26,12966.91,0.33,178,0.08,720.38,82,96,34,33,0
29,9,2,6,5,5,1,75.92,12.5,11863.1,0.32,176,0.08,659.06,80,96,32,31,0
29,9,2,6,5,5,1,75.92,12.5,11863.1,0.32,176,0.08,659.06,80,96,32,31,0
25,13,2,6,7,5,1,57.5,14.06,11359.43,0.27,154,0.07,631.08,69,85,27,27,0
25,13,2,6,7,5,1,57.5,14.06,11359.43,0.27,154,0.07,631.08,69,85,27,27,0
0,1,0,0,1,1,1,10.68,4.67,232.53,0.02,15,0.21,12.92,4,11,3,0,0
0,1,0,0,1,1,1,10.68,4.67,232.53,0.02,15,0.21,12.92,4,11,3,0,0
7,5,0,0,3,2,1,11.89,13.13,2048.55,0.05,35,0.08,113.81,15,20,8,7,0
7,5,0,0,3,2,1,11.89,13.13,2048.55,0.05,35,0.08,113.81,15,20,8,7,0
13,7,0,1,4,3,1,26.06,9.58,2393.23,0.08,56,0.1,132.96,23,33,12,13,0
13,7,0,1,4,3,1,26.06,9.58,2393.23,0.08,56,0.1,132.96,23,33,12,13,0
15,9,0,1,5,4,1,25.82,11.05,3150.69,0.1,66,0.09,175.04,27,39,11,15,0
15,9,0,1,5,4,1,25.82,11.05,3150.69,0.1,66,0.09,175.04,27,39,11,15,0
5,3,0,0,2,2,1,17.22,4.08,287.09,0.02,19,0.24,15.95,7,12,6,5,0
5,3,0,0,2,2,1,17.22,4.08,287.09,0.02,19,0.24,15.95,7,12,6,5,0
4,3,0,0,2,2,1,11.18,5.63,353.85,0.02,17,0.18,19.66,5,12,4,4,0
4,3,0,0,2,2,1,11.18,5.63,353.85,0.02,17,0.18,19.66,5,12,4,4,0
0,1,0,0,1,1,1,0.0,0.0,0.0,0.0,0,0.0,0.0,0,0,0,0,0
0,1,0,0,1,1,1,0.0,0.0,0.0,0.0,0,0.0,0.0,0,0,0,0,0
46,23,4,18,12,10,11,62.33,27.16,45986.37,0.56,297,0.04,2554.8,134,163,37,50,0
46,23,4,18,12,10,11,62.33,27.16,45986.37,0.56,297,0.04,2554.8,134,163,37,50,0
0,1,0,0,1,1,1,0.0,0.0,0.0,0.0,1,0.0,0.0,0,1,0,0,0
0,1,0,0,1,1,1,0.0,0.0,0.0,0.0,0,0.0,0.0,0,0,0,0,0
40,23,4,18,12,10,11,62.52,23.8,35411.97,0.5,265,0.04,1967.33,119,146,35,44,0
40,23,4,18,12,10,11,62.52,23.8,35411.97,0.5,265,0.04,1967.33,119,146,35,44,0
0,1,0,0,1,1,1,6.2,2.5,38.77,0.01,6,0.4,2.15,1,5,1,0,0
0,1,0,0,1,1,1,6.2,2.5,38.77,0.01,6,0.4,2.15,1,5,1,0,0
0,1,0,0,1,1,1,0.0,0.0,0.0,0.0,1,0.0,0.0,0,1,0,0,0
0,1,0,0,1,1,1,0.0,0.0,0.0,0.0,1,0.0,0.0,0,1,0,0,0
0,1,0,0,1,1,1,0.0,0.0,0.0,0.0,0,0.0,0.0,0,0,0,0,0
0,1,0,0,1,1,1,0.0,0.0,0.0,0.0,0,0.0,0.0,0,0,0,0,0
0,1,0,0,1,1,1,0.0,0.0,0.0,0.0,3,0.0,0.0,0,3,0,0,0
0,1,0,0,1,1,1,0.0,0.0,0.0,0.0,3,0.0,0.0,0,3,0,0,0
0,1,0,0,1,1,1,0.0,0.0,0.0,0.0,2,0.0,0.0,0,2,0,0,0
0,1,0,0,1,1,1,0.0,0.0,0.0,0.0,2,0.0,0.0,0,2,0,0,0
0,1,0,0,1,1,1,0.0,0.0,0.0,0.0,1,0.0,0.0,0,1,0,0,0
0,1,0,0,1,1,1,0.0,0.0,0.0,0.0,0,0.0,0.0,0,0,0,0,0
0,1,0,0,1,1,1,5.33,1.5,12.0,0.0,4,0.67,0.67,1,3,1,0,0
0,1,0,0,1,1,1,5.33,1.5,12.0,0.0,4,0.67,0.67,1,3,1,0,0
0,1,0,0,1,1,1,5.33,1.5,12.0,0.0,4,0.67,0.67,1,3,1,0,0
0,1,0,0,1,1,1,5.33,1.5,12.0,0.0,4,0.67,0.67,1,3,1,0,0
38,19,6,6,10,10,6,79.49,15.92,20158.99,0.42,221,0.06,1119.94,98,123,40,44,0
38,19,6,6,10,10,6,79.49,15.92,20158.99,0.42,221,0.06,1119.94,98,123,40,44,0
27,11,0,1,6,5,5,36.14,14.33,7425.49,0.17,101,0.07,412.53,43,58,21,27,0
27,11,0,1,6,5,5,36.14,14.33,7425.49,0.17,101,0.07,412.53,43,58,21,27,0
0,1,0,0,1,1,1,11.86,3.5,145.3,0.01,12,0.29,8.07,4,8,4,0,0
0,1,0,0,1,1,1,11.86,3.5,145.3,0.01,12,0.29,8.07,4,8,4,0,0
0,1,0,0,1,1,1,0.0,0.0,0.0,0.0,0,0.0,0.0,0,0,0,0,0
0,1,0,0,1,1,1,0.0,0.0,0.0,0.0,0,0.0,0.0,0,0,0,0,0
0,1,0,0,1,1,1,0.0,0.0,0.0,0.0,0,0.0,0.0,0,0,0,0,0
0,1,0,0,1,1,1,0.0,0.0,0.0,0.0,0,0.0,0.0,0,0,0,0,0
0,1,0,0,1,1,1,0.0,0.0,0.0,0.0,0,0.0,0.0,0,0,0,0,0
0,1,0,0,1,1,1,0.0,0.0,0.0,0.0,0,0.0,0.0,0,0,0,0,0
0,1,0,0,1,1,1,0.0,0.0,0.0,0.0,1,0.0,0.0,0,1,0,0,0
0,1,0,0,1,1,1,0.0,0.0,0.0,0.0,1,0.0,0.0,0,1,0,0,0
0,1,0,0,1,1,1,0.0,0.0,0.0,0.0,1,0.0,0.0,0,1,0,0,0
0,1,0,0,1,1,1,0.0,0.0,0.0,0.0,0,0.0,0.0,0,0,0,0,0
0,1,0,0,1,1,1,7.33,4.5,148.5,0.01,11,0.22,8.25,3,8,2,0,0
0,1,0,0,1,1,1,7.33,4.5,148.5,0.01,11,0.22,8.25,3,8,2,0,0
18,5,0,4,3,3,1,64.17,6.0,2310.0,0.13,77,0.17,128.33,36,41,24,18,0
18,5,0,4,3,3,1,64.17,6.0,2310.0,0.13,77,0.17,128.33,36,41,24,18,0
8,3,0,0,2,1,1,15.07,9.75,1432.72,0.05,34,0.1,79.6,13,21,8,8,0
8,3,0,0,2,1,1,15.07,9.75,1432.72,0.05,34,0.1,79.6,13,21,8,8,0
25,5,1,0,3,3,1,69.28,9.62,6412.06,0.22,127,0.1,356.23,62,65,29,26,0
25,5,1,0,3,3,1,69.28,9.62,6412.06,0.22,127,0.1,356.23,62,65,29,26,0
0,1,0,0,1,1,1,0.0,0.0,0.0,0.0,1,0.0,0.0,0,1,0,0,0
0,1,0,0,1,1,1,0.0,0.0,0.0,0.0,0,0.0,0.0,0,0,0,0,0
0,1,0,0,1,1,1,0.0,0.0,0.0,0.0,1,0.0,0.0,0,1,0,0,0
0,1,0,0,1,1,1,0.0,0.0,0.0,0.0,0,0.0,0.0,0,0,0,0,0
0,1,0,0,1,1,1,0.0,0.0,0.0,0.0,1,0.0,0.0,0,1,0,0,0
0,1,0,0,1,1,1,0.0,0.0,0.0,0.0,1,0.0,0.0,0,1,0,0,0
0,1,0,0,1,1,1,7.74,1.5,17.41,0.0,5,0.67,0.97,2,3,2,0,0
0,1,0,0,1,1,1,7.74,1.5,17.41,0.0,5,0.67,0.97,2,3,2,0,0
0,1,0,0,1,1,1,9.6,2.5,60.0,0.01,8,0.4,3.33,3,5,3,0,0
0,1,0,0,1,1,1,9.6,2.5,60.0,0.01,8,0.4,3.33,3,5,3,0,0
0,1,0,0,1,1,1,7.75,2.0,31.02,0.01,6,0.5,1.72,2,4,2,0,0
0,1,0,0,1,1,1,7.75,2.0,31.02,0.01,6,0.5,1.72,2,4,2,0,0
0,1,0,0,1,1,1,6.86,3.5,84.0,0.01,8,0.29,4.67,1,7,1,0,0
0,1,0,0,1,1,1,6.86,3.5,84.0,0.01,8,0.29,4.67,1,7,1,0,0
0,1,0,0,1,1,1,7.74,1.5,17.41,0.0,5,0.67,0.97,2,3,2,0,0
0,1,0,0,1,1,1,7.74,1.5,17.41,0.0,5,0.67,0.97,2,3,2,0,0
0,1,0,0,1,1,1,7.75,2.0,31.02,0.01,6,0.5,1.72,2,4,2,0,0
0,1,0,0,1,1,1,7.75,2.0,31.02,0.01,6,0.5,1.72,2,4,2,0,0
9,1,0,0,1,1,1,16.05,10.31,1708.46,0.06,39,0.1,94.91,15,24,8,9,0
9,1,0,0,1,1,1,16.05,10.31,1708.46,0.06,39,0.1,94.91,15,24,8,9,0
0,1,0,0,1,1,1,8.3,6.0,298.97,0.02,15,0.17,16.61,3,12,2,0,0
0,1,0,0,1,1,1,8.3,6.0,298.97,0.02,15,0.17,16.61,3,12,2,0,0
0,1,0,0,1,1,1,8.3,6.0,298.97,0.02,15,0.17,16.61,3,12,2,0,0
0,1,0,0,1,1,1,8.3,6.0,298.97,0.02,15,0.17,16.61,3,12,2,0,0
0,1,0,0,1,1,1,8.3,6.0,298.97,0.02,15,0.17,16.61,3,12,2,0,0
0,1,0,0,1,1,1,8.3,6.0,298.97,0.02,15,0.17,16.61,3,12,2,0,0
0,1,0,0,1,1,1,5.33,1.5,12.0,0.0,4,0.67,0.67,1,3,1,0,0
0,1,0,0,1,1,1,5.33,1.5,12.0,0.0,4,0.67,0.67,1,3,1,0,0
0,1,0,0,1,1,1,5.33,1.5,12.0,0.0,4,0.67,0.67,1,3,1,0,0
0,1,0,0,1,1,1,5.33,1.5,12.0,0.0,4,0.67,0.67,1,3,1,0,0
0,1,0,0,1,1,1,5.33,1.5,12.0,0.0,4,0.67,0.67,1,3,1,0,0
0,1,0,0,1,1,1,5.33,1.5,12.0,0.0,4,0.67,0.67,1,3,1,0,0
0,1,0,0,1,1,1,5.33,1.5,12.0,0.0,4,0.67,0.67,1,3,1,0,0
0,1,0,0,1,1,1,5.33,1.5,12.0,0.0,4,0.67,0.67,1,3,1,0,0
0,1,0,0,1,1,1,5.33,1.5,12.0,0.0,4,0.67,0.67,1,3,1,0,0
0,1,0,0,1,1,1,5.33,1.5,12.0,0.0,4,0.67,0.67,1,3,1,0,0
0,1,0,0,1,1,1,5.33,1.5,12.0,0.0,4,0.67,0.67,1,3,1,0,0
0,1,0,0,1,1,1,5.33,1.5,12.0,0.0,4,0.67,0.67,1,3,1,0,0
0,1,0,0,1,1,1,5.33,1.5,12.0,0.0,4,0.67,0.67,1,3,1,0,0
0,1,0,0,1,1,1,5.33,1.5,12.0,0.0,4,0.67,0.67,1,3,1,0,0
0,1,0,0,1,1,1,5.33,1.5,12.0,0.0,4,0.67,0.67,1,3,1,0,0
0,1,0,0,1,1,1,5.33,1.5,12.0,0.0,4,0.67,0.67,1,3,1,0,0
0,1,0,0,1,1,1,5.33,1.5,12.0,0.0,4,0.67,0.67,1,3,1,0,0
0,1,0,0,1,1,1,5.33,1.5,12.0,0.0,4,0.67,0.67,1,3,1,0,0
0,1,0,0,1,1,1,5.33,1.5,12.0,0.0,4,0.67,0.67,1,3,1,0,0
0,1,0,0,1,1,1,5.33,1.5,12.0,0.0,4,0.67,0.67,1,3,1,0,0
0,1,0,0,1,1,1,5.33,1.5,12.0,0.0,4,0.67,0.67,1,3,1,0,0
0,1,0,0,1,1,1,5.33,1.5,12.0,0.0,4,0.67,0.67,1,3,1,0,0
0,1,0,0,1,1,1,5.33,1.5,12.0,0.0,4,0.67,0.67,1,3,1,0,0
0,1,0,0,1,1,1,5.33,1.5,12.0,0.0,4,0.67,0.67,1,3,1,0,0
34,17,3,5,9,9,7,77.51,14.27,15784.32,0.37,197,0.07,876.91,88,109,37,37,0
34,17,3,5,9,9,7,77.51,14.27,15784.32,0.37,197,0.07,876.91,88,109,37,37,0
37,21,6,4,11,8,7,61.59,17.5,18863.21,0.36,193,0.06,1047.96,85,108,34,43,0
37,21,6,4,11,8,7,61.59,17.5,18863.21,0.36,193,0.06,1047.96,85,108,34,43,0
18,11,5,0,6,5,4,34.8,12.29,5260.09,0.14,89,0.08,292.23,38,51,17,23,0
18,11,5,0,6,5,4,34.8,12.29,5260.09,0.14,89,0.08,292.23,38,51,17,23,0
34,17,6,4,9,9,5,74.55,14.83,16403.02,0.37,198,0.07,911.28,89,109,36,40,0
34,17,6,4,9,9,5,74.55,14.83,16403.02,0.37,198,0.07,911.28,89,109,36,40,0
0,1,0,0,1,1,1,7.75,2.0,31.02,0.01,6,0.5,1.72,2,4,2,0,0
0,1,0,0,1,1,1,7.75,2.0,31.02,0.01,6,0.5,1.72,2,4,2,0,0
0,1,0,0,1,1,1,7.75,2.0,31.02,0.01,6,0.5,1.72,2,4,2,0,0
0,1,0,0,1,1,1,7.75,2.0,31.02,0.01,6,0.5,1.72,2,4,2,0,0
0,1,0,0,1,1,1,7.75,2.0,31.02,0.01,6,0.5,1.72,2,4,2,0,0
0,1,0,0,1,1,1,7.75,2.0,31.02,0.01,6,0.5,1.72,2,4,2,0,0
0,1,0,0,1,1,1,7.75,2.0,31.02,0.01,6,0.5,1.72,2,4,2,0,0
0,1,0,0,1,1,1,7.75,2.0,31.02,0.01,6,0.5,1.72,2,4,2,0,0
0,1,0,0,1,1,1,7.74,1.5,17.41,0.0,5,0.67,0.97,2,3,2,0,0
0,1,0,0,1,1,1,7.74,1.5,17.41,0.0,5,0.67,0.97,2,3,2,0,0
0,1,0,0,1,1,1,5.33,1.5,12.0,0.0,4,0.67,0.67,1,3,1,0,0
0,1,0,0,1,1,1,5.33,1.5,12.0,0.0,4,0.67,0.67,1,3,1,0,0
0,3,0,0,2,1,1,7.75,2.0,31.02,0.01,6,0.5,1.72,2,4,2,0,0
0,3,0,0,2,1,1,7.75,2.0,31.02,0.01,6,0.5,1.72,2,4,2,0,0
0,1,0,0,1,1,1,5.8,2.0,23.22,0.0,5,0.5,1.29,1,4,1,0,0
0,1,0,0,1,1,1,5.8,2.0,23.22,0.0,5,0.5,1.29,1,4,1,0,0
0,3,0,0,2,1,1,7.75,2.0,31.02,0.01,6,0.5,1.72,2,4,2,0,0
0,3,0,0,2,1,1,7.75,2.0,31.02,0.01,6,0.5,1.72,2,4,2,0,0
0,1,0,0,1,1,1,12.18,3.0,109.62,0.01,11,0.33,6.09,4,7,4,0,0
0,1,0,0,1,1,1,12.18,3.0,109.62,0.01,11,0.33,6.09,4,7,4,0,0
0,1,0,0,1,1,1,7.75,2.0,31.02,0.01,6,0.5,1.72,2,4,2,0,0
0,1,0,0,1,1,1,7.75,2.0,31.02,0.01,6,0.5,1.72,2,4,2,0,0
0,1,0,0,1,1,1,7.75,2.0,31.02,0.01,6,0.5,1.72,2,4,2,0,0
0,1,0,0,1,1,1,7.75,2.0,31.02,0.01,6,0.5,1.72,2,4,2,0,0
0,1,0,0,1,1,1,7.75,2.0,31.02,0.01,6,0.5,1.72,2,4,2,0,0
0,1,0,0,1,1,1,7.75,2.0,31.02,0.01,6,0.5,1.72,2,4,2,0,0
0,1,0,0,1,1,1,5.8,2.0,23.22,0.0,5,0.5,1.29,1,4,1,0,0
0,1,0,0,1,1,1,5.8,2.0,23.22,0.0,5,0.5,1.29,1,4,1,0,0
0,1,0,0,1,1,1,7.75,2.0,31.02,0.01,6,0.5,1.72,2,4,2,0,0
0,1,0,0,1,1,1,7.75,2.0,31.02,0.01,6,0.5,1.72,2,4,2,0,0
31,11,2,5,6,5,1,77.08,13.04,13111.83,0.34,182,0.08,728.44,83,99,35,33,0
31,11,2,5,6,5,1,77.08,13.04,13111.83,0.34,182,0.08,728.44,83,99,35,33,0
35,11,2,4,6,5,1,84.05,13.03,14262.1,0.36,195,0.08,792.34,90,105,38,37,0
35,11,2,4,6,5,1,84.05,13.03,14262.1,0.36,195,0.08,792.34,90,105,38,37,0
2,1,0,0,1,1,1,8.98,2.5,56.15,0.01,8,0.4,3.12,2,6,2,2,0
2,1,0,0,1,1,1,8.98,2.5,56.15,0.01,8,0.4,3.12,2,6,2,2,0
2,1,0,0,1,1,1,5.33,1.5,12.0,0.0,4,0.67,0.67,1,3,1,2,0
2,1,0,0,1,1,1,5.33,1.5,12.0,0.0,4,0.67,0.67,1,3,1,2,0
0,1,0,0,1,1,1,5.33,1.5,12.0,0.0,4,0.67,0.67,1,3,1,0,0
0,1,0,0,1,1,1,5.33,1.5,12.0,0.0,4,0.67,0.67,1,3,1,0,0
2,1,0,0,1,1,1,5.33,1.5,12.0,0.0,4,0.67,0.67,1,3,1,2,0
2,1,0,0,1,1,1,5.33,1.5,12.0,0.0,4,0.67,0.67,1,3,1,2,0
2,1,0,0,1,1,1,5.33,1.5,12.0,0.0,4,0.67,0.67,1,3,1,2,0
2,1,0,0,1,1,1,5.33,1.5,12.0,0.0,4,0.67,0.67,1,3,1,2,0
3,1,0,0,1,1,1,12.0,2.5,75.0,0.01,10,0.4,4.17,3,7,3,3,0
3,1,0,0,1,1,1,12.0,2.5,75.0,0.01,10,0.4,4.17,3,7,3,3,0
0,1,0,0,1,1,1,7.86,2.5,49.13,0.01,7,0.4,2.73,2,5,2,0,0
0,1,0,0,1,1,1,7.86,2.5,49.13,0.01,7,0.4,2.73,2,5,2,0,0
0,1,0,0,1,1,1,6.55,3.0,58.95,0.01,7,0.33,3.28,1,6,1,0,0
0,1,0,0,1,1,1,6.55,3.0,58.95,0.01,7,0.33,3.28,1,6,1,0,0
0,1,0,0,1,1,1,6.55,3.0,58.95,0.01,7,0.33,3.28,1,6,1,0,0
0,1,0,0,1,1,1,6.55,3.0,58.95,0.01,7,0.33,3.28,1,6,1,0,0
2,1,0,0,1,1,1,8.98,2.5,56.15,0.01,8,0.4,3.12,2,6,2,2,0
2,1,0,0,1,1,1,8.98,2.5,56.15,0.01,8,0.4,3.12,2,6,2,2,0
2,1,0,0,1,1,1,5.33,1.5,12.0,0.0,4,0.67,0.67,1,3,1,2,0
2,1,0,0,1,1,1,5.33,1.5,12.0,0.0,4,0.67,0.67,1,3,1,2,0
0,1,0,0,1,1,1,5.33,1.5,12.0,0.0,4,0.67,0.67,1,3,1,0,0
0,1,0,0,1,1,1,5.33,1.5,12.0,0.0,4,0.67,0.67,1,3,1,0,0
2,1,0,0,1,1,1,5.33,1.5,12.0,0.0,4,0.67,0.67,1,3,1,2,0
2,1,0,0,1,1,1,5.33,1.5,12.0,0.0,4,0.67,0.67,1,3,1,2,0
2,1,0,0,1,1,1,5.33,1.5,12.0,0.0,4,0.67,0.67,1,3,1,2,0
2,1,0,0,1,1,1,5.33,1.5,12.0,0.0,4,0.67,0.67,1,3,1,2,0
0,1,0,0,1,1,1,5.33,1.5,12.0,0.0,4,0.67,0.67,1,3,1,0,0
0,1,0,0,1,1,1,5.33,1.5,12.0,0.0,4,0.67,0.67,1,3,1,0,0
0,1,0,0,1,1,1,5.33,1.5,12.0,0.0,4,0.67,0.67,1,3,1,0,0
0,1,0,0,1,1,1,5.33,1.5,12.0,0.0,4,0.67,0.67,1,3,1,0,0
0,1,0,0,1,1,1,7.86,2.5,49.13,0.01,7,0.4,2.73,2,5,2,0,0
0,1,0,0,1,1,1,7.86,2.5,49.13,0.01,7,0.4,2.73,2,5,2,0,0
0,1,0,0,1,1,1,0.0,0.0,0.0,0.0,3,0.0,0.0,0,3,0,0,0
0,1,0,0,1,1,1,0.0,0.0,0.0,0.0,3,0.0,0.0,0,3,0,0,0
0,1,0,0,1,1,1,7.75,2.0,31.02,0.01,6,0.5,1.72,2,4,2,0,0
0,1,0,0,1,1,1,7.75,2.0,31.02,0.01,6,0.5,1.72,2,4,2,0,0
3,1,0,0,1,1,1,11.23,2.0,44.92,0.01,8,0.5,2.5,3,5,3,3,0
3,1,0,0,1,1,1,11.23,2.0,44.92,0.01,8,0.5,2.5,3,5,3,3,0
0,1,0,0,1,1,1,9.29,1.5,20.9,0.0,6,0.67,1.16,2,4,2,0,0
0,1,0,0,1,1,1,9.29,1.5,20.9,0.0,6,0.67,1.16,2,4,2,0,0
28,7,0,4,1,1,1,38.35,13.0,6481.43,0.17,98,0.08,360.08,42,56,21,28,0
28,7,0,4,1,1,1,38.35,13.0,6481.43,0.17,98,0.08,360.08,42,56,21,28,0
20,11,0,1,1,1,1,21.1,18.56,7271.57,0.13,77,0.05,403.98,33,44,16,20,0
20,11,0,1,1,1,1,21.1,18.56,7271.57,0.13,77,0.05,403.98,33,44,16,20,0
28,7,0,4,1,1,1,38.35,13.0,6481.43,0.17,98,0.08,360.08,42,56,21,28,0
28,7,0,4,1,1,1,38.35,13.0,6481.43,0.17,98,0.08,360.08,42,56,21,28,0
27,7,1,4,1,1,1,38.35,13.0,6481.43,0.17,98,0.08,360.08,42,56,21,28,0
27,7,1,4,1,1,1,38.35,13.0,6481.43,0.17,98,0.08,360.08,42,56,21,28,0
0,1,0,0,1,1,1,9.29,1.5,20.9,0.0,6,0.67,1.16,2,4,2,0,0
0,1,0,0,1,1,1,9.29,1.5,20.9,0.0,6,0.67,1.16,2,4,2,0,0
0,1,0,0,1,1,1,11.23,2.0,44.92,0.01,8,0.5,2.5,3,5,3,0,0
0,1,0,0,1,1,1,11.23,2.0,44.92,0.01,8,0.5,2.5,3,5,3,0,0
0,1,0,0,1,1,1,9.29,1.5,20.9,0.0,6,0.67,1.16,2,4,2,0,0
0,1,0,0,1,1,1,9.29,1.5,20.9,0.0,6,0.67,1.16,2,4,2,0,0
0,1,0,0,1,1,1,11.23,2.0,44.92,0.01,8,0.5,2.5,3,5,3,0,0
0,1,0,0,1,1,1,11.23,2.0,44.92,0.01,8,0.5,2.5,3,5,3,0,0
0,1,0,0,1,1,1,9.0,3.0,81.0,0.01,9,0.33,4.5,2,7,2,0,0
0,1,0,0,1,1,1,9.0,3.0,81.0,0.01,9,0.33,4.5,2,7,2,0,0
0,1,0,0,1,1,1,9.0,3.0,81.0,0.01,9,0.33,4.5,2,7,2,0,0
0,1,0,0,1,1,1,9.0,3.0,81.0,0.01,9,0.33,4.5,2,7,2,0,0
0,1,0,0,1,1,1,8.3,6.0,298.97,0.02,15,0.17,16.61,3,12,2,0,0
0,1,0,0,1,1,1,8.3,6.0,298.97,0.02,15,0.17,16.61,3,12,2,0,0
0,1,0,0,1,1,1,7.74,1.5,17.41,0.0,5,0.67,0.97,2,3,2,0,0
0,1,0,0,1,1,1,7.74,1.5,17.41,0.0,5,0.67,0.97,2,3,2,0,0
0,1,0,0,1,1,1,7.74,1.5,17.41,0.0,5,0.67,0.97,2,3,2,0,0
0,1,0,0,1,1,1,7.74,1.5,17.41,0.0,5,0.67,0.97,2,3,2,0,0
0,1,0,0,1,1,1,7.74,1.5,17.41,0.0,5,0.67,0.97,2,3,2,0,0
0,1,0,0,1,1,1,7.74,1.5,17.41,0.0,5,0.67,0.97,2,3,2,0,0
0,1,0,0,1,1,1,7.74,1.5,17.41,0.0,5,0.67,0.97,2,3,2,0,0
0,1,0,0,1,1,1,7.74,1.5,17.41,0.0,5,0.67,0.97,2,3,2,0,0
0,1,0,0,1,1,1,7.74,1.5,17.41,0.0,5,0.67,0.97,2,3,2,0,0
0,1,0,0,1,1,1,7.74,1.5,17.41,0.0,5,0.67,0.97,2,3,2,0,0
0,1,0,0,1,1,1,7.74,1.5,17.41,0.0,5,0.67,0.97,2,3,2,0,0
0,1,0,0,1,1,1,7.74,1.5,17.41,0.0,5,0.67,0.97,2,3,2,0,0
12,5,0,1,3,3,1,18.15,7.71,1080.0,0.05,35,0.13,60.0,12,23,7,12,0
12,5,0,1,3,3,1,18.15,7.71,1080.0,0.05,35,0.13,60.0,12,23,7,12,0
0,1,0,0,1,1,1,9.51,3.0,85.59,0.01,9,0.33,4.75,3,6,3,0,0
0,1,0,0,1,1,1,9.51,3.0,85.59,0.01,9,0.33,4.75,3,6,3,0,0
0,1,0,0,1,1,1,9.51,3.0,85.59,0.01,9,0.33,4.75,3,6,3,0,0
0,1,0,0,1,1,1,9.51,3.0,85.59,0.01,9,0.33,4.75,3,6,3,0,0
0,1,0,0,1,1,1,9.51,3.0,85.59,0.01,9,0.33,4.75,3,6,3,0,0
0,1,0,0,1,1,1,9.51,3.0,85.59,0.01,9,0.33,4.75,3,6,3,0,0
0,1,0,0,1,1,1,9.51,3.0,85.59,0.01,9,0.33,4.75,3,6,3,0,0
0,1,0,0,1,1,1,9.51,3.0,85.59,0.01,9,0.33,4.75,3,6,3,0,0
4,3,0,0,2,2,1,13.67,6.0,492.27,0.03,21,0.17,27.35,6,15,5,4,0
4,3,0,0,2,2,1,13.67,6.0,492.27,0.03,21,0.17,27.35,6,15,5,4,0
46,23,4,19,12,10,11,62.33,27.16,45986.37,0.56,297,0.04,2554.8,134,163,37,50,0
46,23,4,19,12,10,11,62.33,27.16,45986.37,0.56,297,0.04,2554.8,134,163,37,50,0
40,23,4,18,12,10,11,62.52,23.8,35411.97,0.5,265,0.04,1967.33,119,146,35,44,0
40,23,4,18,12,10,11,62.52,23.8,35411.97,0.5,265,0.04,1967.33,119,146,35,44,0
32,13,0,6,7,5,7,66.91,11.92,9501.02,0.27,142,0.08,527.83,66,76,36,32,0
32,13,0,6,7,5,7,66.91,11.92,9501.02,0.27,142,0.08,527.83,66,76,36,32,0
34,15,1,6,8,5,7,73.7,11.83,10320.65,0.29,153,0.08,573.37,71,82,39,35,0
34,15,1,6,8,5,7,73.7,11.83,10320.65,0.29,153,0.08,573.37,71,82,39,35,0
17,13,1,2,7,5,1,28.71,13.08,4909.8,0.13,83,0.08,272.77,34,49,13,18,0
17,13,1,2,7,5,1,28.71,13.08,4909.8,0.13,83,0.08,272.77,34,49,13,18,0
36,25,3,6,13,11,9,46.36,22.4,23260.82,0.35,188,0.04,1292.27,84,104,30,39,0
36,25,3,6,13,11,9,46.36,22.4,23260.82,0.35,188,0.04,1292.27,84,104,30,39,0
29,15,1,5,8,5,7,61.4,11.42,8014.02,0.23,127,0.09,445.22,58,69,33,30,0
29,15,1,5,8,5,7,61.4,11.42,8014.02,0.23,127,0.09,445.22,58,69,33,30,0
15,5,0,4,3,3,1,43.59,6.0,1569.11,0.09,55,0.17,87.17,24,31,18,15,0
15,5,0,4,3,3,1,43.59,6.0,1569.11,0.09,55,0.17,87.17,24,31,18,15,0
15,5,0,4,3,3,1,43.59,6.0,1569.11,0.09,55,0.17,87.17,24,31,18,15,0
15,5,0,4,3,3,1,43.59,6.0,1569.11,0.09,55,0.17,87.17,24,31,18,15,0
15,5,0,4,3,3,1,43.59,6.0,1569.11,0.09,55,0.17,87.17,24,31,18,15,0
15,5,0,4,3,3,1,43.59,6.0,1569.11,0.09,55,0.17,87.17,24,31,18,15,0
20,7,1,3,4,4,1,45.78,10.66,5202.69,0.16,93,0.09,289.04,41,52,25,21,0
20,7,1,3,4,4,1,45.78,10.66,5202.69,0.16,93,0.09,289.04,41,52,25,21,0
2,1,0,0,1,1,1,6.2,2.5,38.77,0.01,6,0.4,2.15,1,5,1,2,0
2,1,0,0,1,1,1,6.2,2.5,38.77,0.01,6,0.4,2.15,1,5,1,2,0
13,7,0,2,4,3,1,23.37,9.45,2087.42,0.07,52,0.11,115.97,21,31,10,13,0
13,7,0,2,4,3,1,23.37,9.45,2087.42,0.07,52,0.11,115.97,21,31,10,13,0
10,3,0,1,2,2,1,35.57,7.35,1922.93,0.09,55,0.14,106.83,25,30,17,10,0
10,3,0,1,2,2,1,35.57,7.35,1922.93,0.09,55,0.14,106.83,25,30,17,10,0
0,1,0,0,1,1,1,7.74,1.5,17.41,0.0,5,0.67,0.97,2,3,2,0,0
0,1,0,0,1,1,1,7.74,1.5,17.41,0.0,5,0.67,0.97,2,3,2,0,0
0,1,0,0,1,1,1,5.33,1.5,12.0,0.0,4,0.67,0.67,1,3,1,0,0
0,1,0,0,1,1,1,5.33,1.5,12.0,0.0,4,0.67,0.67,1,3,1,0,0
1,1,2,0,1,1,1,11.63,2.0,46.53,0.01,9,0.5,2.58,4,5,3,3,0
1,1,2,0,1,1,1,11.63,2.0,46.53,0.01,9,0.5,2.58,4,5,3,3,0
21,9,12,1,5,2,1,37.35,18.77,13157.25,0.23,130,0.05,730.96,61,69,26,33,0
21,9,12,1,5,2,1,40.72,17.43,12369.51,0.24,130,0.06,687.2,61,69,28,33,0
9,1,2,0,1,1,1,35.81,10.5,3947.65,0.13,82,0.1,219.31,35,47,15,11,0
9,1,2,0,1,1,1,35.81,10.5,3947.65,0.13,82,0.1,219.31,35,47,15,11,0
1,1,3,0,1,1,1,19.02,2.0,76.08,0.01,12,0.5,4.23,5,7,5,4,0
1,1,3,0,1,1,1,19.02,2.0,76.08,0.01,12,0.5,4.23,5,7,5,4,0
1,1,2,0,1,1,1,16.84,1.5,37.9,0.01,9,0.67,2.11,4,5,4,3,0
1,1,2,0,1,1,1,13.5,2.0,54.0,0.01,9,0.5,3.0,4,5,4,3,0
2,1,0,0,1,1,1,7.74,1.5,17.41,0.0,5,0.67,0.97,2,3,2,2,0
2,1,0,0,1,1,1,7.74,1.5,17.41,0.0,5,0.67,0.97,2,3,2,2,0
2,1,0,0,1,1,1,7.74,1.5,17.41,0.0,5,0.67,0.97,2,3,2,2,0
2,1,0,0,1,1,1,7.74,1.5,17.41,0.0,5,0.67,0.97,2,3,2,2,0
10,5,6,0,3,1,1,14.41,12.0,2074.53,0.06,40,0.08,115.25,16,24,8,16,0
10,5,6,0,3,1,1,14.41,12.0,2074.53,0.06,40,0.08,115.25,16,24,8,16,0
1,1,1,0,1,1,1,7.74,1.5,17.41,0.0,5,0.67,0.97,2,3,2,2,0
1,1,1,0,1,1,1,7.74,1.5,17.41,0.0,5,0.67,0.97,2,3,2,2,0
1,1,3,0,1,1,1,16.21,2.25,82.12,0.01,13,0.44,4.56,6,7,4,4,0
1,1,3,0,1,1,1,16.21,2.25,82.12,0.01,13,0.44,4.56,6,7,4,4,0
20,5,1,0,3,3,1,23.97,11.57,3209.06,0.09,59,0.09,178.28,27,32,14,21,0
20,5,1,0,3,3,1,23.97,11.57,3209.06,0.09,59,0.09,178.28,27,32,14,21,0
2,1,1,0,1,1,1,16.84,1.5,37.9,0.01,9,0.67,2.11,4,5,4,3,0
2,1,1,0,1,1,1,16.84,1.5,37.9,0.01,9,0.67,2.11,4,5,4,3,0
2,1,1,0,1,1,1,16.84,1.5,37.9,0.01,9,0.67,2.11,4,5,4,3,0
2,1,1,0,1,1,1,16.84,1.5,37.9,0.01,9,0.67,2.11,4,5,4,3,0
9,3,6,0,2,1,1,28.48,8.64,2127.22,0.08,53,0.12,118.18,22,31,14,15,0
9,3,6,0,2,1,1,30.88,8.07,2009.59,0.08,53,0.12,111.64,22,31,15,15,0
3,3,3,0,2,2,1,8.96,8.0,573.59,0.02,20,0.13,31.87,8,12,4,6,0
3,3,3,0,2,2,1,8.96,8.0,573.59,0.02,20,0.13,31.87,8,12,4,6,0
9,3,6,0,2,1,1,35.12,5.71,1146.71,0.07,45,0.18,63.71,20,25,14,15,0
9,3,6,0,2,1,1,32.11,6.15,1216.33,0.07,45,0.16,67.57,20,25,13,15,0
3,3,3,0,2,2,1,11.56,6.4,473.66,0.02,20,0.16,26.31,8,12,5,6,0
3,3,3,0,2,2,1,11.56,6.4,473.66,0.02,20,0.16,26.31,8,12,5,6,0
1,1,3,0,1,1,1,14.4,2.5,90.0,0.01,12,0.4,5.0,5,7,4,4,0
1,1,3,0,1,1,1,19.02,2.0,76.08,0.01,12,0.5,4.23,5,7,5,4,0
2,1,0,0,1,1,1,3.48,4.0,55.73,0.0,6,0.25,3.1,2,4,1,2,0
2,1,0,0,1,1,1,3.48,4.0,55.73,0.0,6,0.25,3.1,2,4,1,2,0
2,1,0,0,1,1,1,11.86,3.5,145.3,0.01,12,0.29,8.07,4,8,4,2,0
2,1,0,0,1,1,1,11.86,3.5,145.3,0.01,12,0.29,8.07,4,8,4,2,0
7,7,3,1,4,2,3,14.33,7.86,884.62,0.04,27,0.13,49.15,10,17,7,10,0
7,7,3,1,4,2,3,14.33,7.86,884.62,0.04,27,0.13,49.15,10,17,7,10,0
15,15,8,2,8,3,1,12.11,23.57,6727.37,0.1,64,0.04,373.74,22,42,7,23,0
15,15,8,2,8,3,1,12.99,24.0,7482.66,0.1,68,0.04,415.7,24,44,8,23,0
2,1,1,0,1,1,1,16.84,1.5,37.9,0.01,9,0.67,2.11,4,5,4,3,0
2,1,1,0,1,1,1,16.84,1.5,37.9,0.01,9,0.67,2.11,4,5,4,3,0
2,1,1,0,1,1,1,16.84,1.5,37.9,0.01,9,0.67,2.11,4,5,4,3,0
2,1,1,0,1,1,1,16.84,1.5,37.9,0.01,9,0.67,2.11,4,5,4,3,0
2,1,1,0,1,1,1,16.84,1.5,37.9,0.01,9,0.67,2.11,4,5,4,3,0
2,1,1,0,1,1,1,16.84,1.5,37.9,0.01,9,0.67,2.11,4,5,4,3,0
2,1,1,0,1,1,1,16.84,1.5,37.9,0.01,9,0.67,2.11,4,5,4,3,0
2,1,1,0,1,1,1,16.84,1.5,37.9,0.01,9,0.67,2.11,4,5,4,3,0
2,1,1,0,1,1,1,16.84,1.5,37.9,0.01,9,0.67,2.11,4,5,4,3,0
2,1,1,0,1,1,1,16.84,1.5,37.9,0.01,9,0.67,2.11,4,5,4,3,0
2,1,1,0,1,1,1,16.84,1.5,37.9,0.01,9,0.67,2.11,4,5,4,3,0
2,1,1,0,1,1,1,16.84,1.5,37.9,0.01,9,0.67,2.11,4,5,4,3,0
2,1,1,0,1,1,1,16.84,1.5,37.9,0.01,9,0.67,2.11,4,5,4,3,0
2,1,1,0,1,1,1,16.84,1.5,37.9,0.01,9,0.67,2.11,4,5,4,3,0
2,1,1,0,1,1,1,16.84,1.5,37.9,0.01,9,0.67,2.11,4,5,4,3,0
2,1,1,0,1,1,1,16.84,1.5,37.9,0.01,9,0.67,2.11,4,5,4,3,0
1,1,2,0,1,1,1,11.23,2.0,44.92,0.01,8,0.5,2.5,3,5,3,3,0
1,1,2,0,1,1,1,13.79,1.5,31.02,0.01,8,0.67,1.72,3,5,3,3,0
8,5,9,0,3,3,1,41.36,4.55,854.55,0.06,47,0.22,47.47,20,27,11,17,0
8,5,9,0,3,3,1,31.33,6.0,1128.0,0.06,47,0.17,62.67,20,27,10,17,0
2,1,0,0,1,1,1,7.74,1.5,17.41,0.0,5,0.67,0.97,2,3,2,2,0
2,1,0,0,1,1,1,7.74,1.5,17.41,0.0,5,0.67,0.97,2,3,2,2,0
2,1,0,0,1,1,1,7.74,1.5,17.41,0.0,5,0.67,0.97,2,3,2,2,0
2,1,0,0,1,1,1,7.74,1.5,17.41,0.0,5,0.67,0.97,2,3,2,2,0
2,1,0,0,1,1,1,7.74,1.5,17.41,0.0,5,0.67,0.97,2,3,2,2,0
2,1,0,0,1,1,1,7.74,1.5,17.41,0.0,5,0.67,0.97,2,3,2,2,0
2,1,0,0,1,1,1,7.74,1.5,17.41,0.0,5,0.67,0.97,2,3,2,2,0
2,1,0,0,1,1,1,7.74,1.5,17.41,0.0,5,0.67,0.97,2,3,2,2,0
4,1,0,0,1,1,1,6.89,3.0,62.04,0.01,8,0.33,3.45,3,5,2,4,0
4,1,0,0,1,1,1,6.89,3.0,62.04,0.01,8,0.33,3.45,3,5,2,4,0
1,1,1,0,1,1,1,7.74,1.5,17.41,0.0,5,0.67,0.97,2,3,2,2,0
1,1,1,0,1,1,1,7.74,1.5,17.41,0.0,5,0.67,0.97,2,3,2,2,0
13,5,6,5,1,1,1,26.83,11.08,3292.14,0.1,64,0.09,182.9,24,40,13,19,0
13,5,6,5,1,1,1,26.83,11.08,3292.14,0.1,64,0.09,182.9,24,40,13,19,0
152,38,3,0,29,21,1,138.01,39.65,216976.11,1.82,732,0.03,12054.23,324,408,143,155,0
118,30,8,0,21,13,1,134.43,35.05,165171.64,1.57,660,0.03,9176.2,296,364,114,126,0
214,58,6,0,42,42,1,163.43,37.98,235736.52,2.07,785,0.03,13096.47,348,437,197,220,0
214,58,6,0,42,42,1,161.52,38.37,237790.7,2.07,785,0.03,13210.59,348,437,195,220,0
85,19,1,0,14,14,1,112.27,25.03,70333.48,0.94,416,0.04,3907.42,185,231,85,86,0
85,19,1,0,14,14,1,107.66,25.95,72468.0,0.93,416,0.04,4026.0,185,231,82,86,0
118,30,8,0,21,13,1,130.41,35.76,166740.62,1.55,656,0.03,9263.37,294,362,111,126,0
152,38,3,0,29,21,1,134.77,40.25,218335.39,1.81,728,0.02,12129.74,322,406,140,155,0
39,5,1,0,4,4,1,101.3,13.16,17544.81,0.44,219,0.08,974.71,93,126,53,40,0
39,5,1,0,4,4,1,101.3,13.16,17544.81,0.44,219,0.08,974.71,93,126,53,40,0
27,3,0,0,2,2,1,98.83,17.19,29200.73,0.57,290,0.06,1622.26,119,171,45,27,0
27,3,0,0,2,2,1,98.83,17.19,29200.73,0.57,290,0.06,1622.26,119,171,45,27,0
2,1,0,0,1,1,1,7.74,1.5,17.41,0.0,5,0.67,0.97,2,3,2,2,0
2,1,0,0,1,1,1,7.74,1.5,17.41,0.0,5,0.67,0.97,2,3,2,2,0
2,1,1,0,1,1,1,16.84,1.5,37.9,0.01,9,0.67,2.11,4,5,4,3,0
2,1,1,0,1,1,1,16.84,1.5,37.9,0.01,9,0.67,2.11,4,5,4,3,0
2,1,1,0,1,1,1,16.84,1.5,37.9,0.01,9,0.67,2.11,4,5,4,3,0
2,1,1,0,1,1,1,16.84,1.5,37.9,0.01,9,0.67,2.11,4,5,4,3,0
1,1,2,0,1,1,1,13.5,2.0,54.0,0.01,9,0.5,3.0,4,5,4,3,0
1,1,2,0,1,1,1,13.5,2.0,54.0,0.01,9,0.5,3.0,4,5,4,3,0
2,1,1,0,1,1,1,16.84,1.5,37.9,0.01,9,0.67,2.11,4,5,4,3,0
2,1,1,0,1,1,1,16.84,1.5,37.9,0.01,9,0.67,2.11,4,5,4,3,0
2,1,0,0,1,1,1,7.74,1.5,17.41,0.0,5,0.67,0.97,2,3,2,2,0
2,1,0,0,1,1,1,7.74,1.5,17.41,0.0,5,0.67,0.97,2,3,2,2,0
2,1,0,0,1,1,1,7.74,1.5,17.41,0.0,5,0.67,0.97,2,3,2,2,0
2,1,0,0,1,1,1,7.74,1.5,17.41,0.0,5,0.67,0.97,2,3,2,2,0
2,1,1,0,1,1,1,16.84,1.5,37.9,0.01,9,0.67,2.11,4,5,4,3,0
2,1,1,0,1,1,1,16.84,1.5,37.9,0.01,9,0.67,2.11,4,5,4,3,0
2,1,1,0,1,1,1,16.84,1.5,37.9,0.01,9,0.67,2.11,4,5,4,3,0
2,1,1,0,1,1,1,16.84,1.5,37.9,0.01,9,0.67,2.11,4,5,4,3,0
6,1,1,0,1,1,1,20.08,5.5,607.27,0.04,29,0.18,33.74,11,18,7,7,0
11,1,4,3,1,1,1,47.12,6.88,2232.16,0.11,69,0.15,124.01,26,43,17,15,0
11,1,4,3,1,1,1,43.82,7.31,2343.12,0.11,69,0.14,130.16,26,43,16,15,0
1,1,0,0,1,1,1,0.0,0.0,0.0,0.0,1,0.0,0.0,0,1,0,1,0
1,1,0,0,1,1,1,0.0,0.0,0.0,0.0,1,0.0,0.0,0,1,0,1,0
10,1,3,0,1,1,1,37.94,7.39,2073.4,0.09,62,0.14,115.19,23,39,14,13,0
18,1,6,10,1,1,1,60.8,10.87,7182.78,0.22,131,0.09,399.04,50,81,23,24,0
14,1,3,3,1,1,1,45.8,8.0,2931.27,0.12,81,0.13,162.85,30,51,15,17,0
14,1,3,3,1,1,1,45.8,8.0,2931.27,0.12,81,0.13,162.85,30,51,15,17,0
7,1,0,0,1,1,1,20.08,5.5,607.27,0.04,29,0.18,33.74,11,18,7,7,0
7,1,0,0,1,1,1,20.08,5.5,607.27,0.04,29,0.18,33.74,11,18,7,7,0
7,1,0,0,1,1,1,20.08,5.5,607.27,0.04,29,0.18,33.74,11,18,7,7,0
7,3,7,0,2,2,1,19.08,14.5,4010.75,0.09,64,0.07,222.82,29,35,10,14,0
7,1,0,0,1,1,1,20.08,5.5,607.27,0.04,29,0.18,33.74,11,18,7,7,0
6,1,1,0,1,1,1,20.08,5.5,607.27,0.04,29,0.18,33.74,11,18,7,7,0
7,3,7,0,2,2,1,19.08,14.5,4010.75,0.09,64,0.07,222.82,29,35,10,14,0
10,1,3,0,1,1,1,37.94,7.39,2073.4,0.09,62,0.14,115.19,23,39,14,13,0
7,1,0,0,1,1,1,20.08,5.5,607.27,0.04,29,0.18,33.74,11,18,7,7,0
7,1,0,0,1,1,1,20.08,5.5,607.27,0.04,29,0.18,33.74,11,18,7,7,0
18,1,6,10,1,1,1,60.8,10.87,7182.78,0.22,131,0.09,399.04,50,81,23,24,0
69,22,3,1,21,19,1,59.26,22.99,31321.11,0.45,212,0.04,1740.06,67,145,51,72,0
69,22,3,1,21,20,1,62.55,22.36,31277.79,0.47,216,0.04,1737.66,69,147,54,72,0
37,12,2,1,11,11,1,48.78,11.63,6592.37,0.19,101,0.09,366.24,31,70,28,39,0
13,6,8,1,5,5,1,20.84,14.38,4306.14,0.1,63,0.07,239.23,23,40,12,21,0
37,12,2,1,11,11,1,44.81,12.52,7023.46,0.19,101,0.08,390.19,31,70,26,39,0
2,1,0,0,1,1,1,7.74,1.5,17.41,0.0,5,0.67,0.97,2,3,2,2,0
2,1,0,0,1,1,1,7.74,1.5,17.41,0.0,5,0.67,0.97,2,3,2,2,0
2,1,0,0,1,1,1,7.74,1.5,17.41,0.0,5,0.67,0.97,2,3,2,2,0
2,1,0,0,1,1,1,7.74,1.5,17.41,0.0,5,0.67,0.97,2,3,2,2,0
12,6,4,3,4,3,4,23.64,8.75,1809.67,0.07,44,0.11,100.54,15,29,12,16,0
12,6,4,3,4,3,4,19.21,10.5,2118.25,0.07,44,0.1,117.68,15,29,10,16,0
7,3,1,0,2,2,1,19.16,5.33,545.0,0.03,25,0.19,30.28,12,13,9,8,0
7,3,1,0,2,2,1,19.16,5.33,545.0,0.03,25,0.19,30.28,12,13,9,8,0
2,1,0,0,1,1,1,7.74,1.5,17.41,0.0,5,0.67,0.97,2,3,2,2,0
2,1,0,0,1,1,1,7.74,1.5,17.41,0.0,5,0.67,0.97,2,3,2,2,0
13,6,8,1,5,5,1,28.95,10.78,3364.98,0.1,63,0.09,186.94,23,40,16,21,0
2,1,0,0,1,1,1,7.74,1.5,17.41,0.0,5,0.67,0.97,2,3,2,2,0
2,1,0,0,1,1,1,7.74,1.5,17.41,0.0,5,0.67,0.97,2,3,2,2,0
52,24,13,3,19,17,1,48.8,24.34,28915.56,0.4,189,0.04,1606.42,63,126,44,65,0
52,24,13,3,19,17,1,50.06,23.8,28355.67,0.4,189,0.04,1575.31,63,126,45,65,0
2,1,0,0,1,1,1,7.74,1.5,17.41,0.0,5,0.67,0.97,2,3,2,2,0
2,1,0,0,1,1,1,7.74,1.5,17.41,0.0,5,0.67,0.97,2,3,2,2,0
2,1,0,0,1,1,1,7.74,1.5,17.41,0.0,5,0.67,0.97,2,3,2,2,0
2,1,0,0,1,1,1,7.74,1.5,17.41,0.0,5,0.67,0.97,2,3,2,2,0
2,1,0,0,1,1,1,7.74,1.5,17.41,0.0,5,0.67,0.97,2,3,2,2,0
2,1,0,0,1,1,1,7.74,1.5,17.41,0.0,5,0.67,0.97,2,3,2,2,0
2,1,0,0,1,1,1,7.74,1.5,17.41,0.0,5,0.67,0.97,2,3,2,2,0
2,1,0,0,1,1,1,7.74,1.5,17.41,0.0,5,0.67,0.97,2,3,2,2,0
2,1,0,0,1,1,1,7.74,1.5,17.41,0.0,5,0.67,0.97,2,3,2,2,0
2,1,0,0,1,1,1,7.74,1.5,17.41,0.0,5,0.67,0.97,2,3,2,2,0
2,1,0,0,1,1,1,7.74,1.5,17.41,0.0,5,0.67,0.97,2,3,2,2,0
2,1,0,0,1,1,1,7.74,1.5,17.41,0.0,5,0.67,0.97,2,3,2,2,0
2,1,0,0,1,1,1,7.74,1.5,17.41,0.0,5,0.67,0.97,2,3,2,2,0
2,1,0,0,1,1,1,7.74,1.5,17.41,0.0,5,0.67,0.97,2,3,2,2,0
2,1,0,0,1,1,1,7.74,1.5,17.41,0.0,5,0.67,0.97,2,3,2,2,0
2,1,0,0,1,1,1,7.74,1.5,17.41,0.0,5,0.67,0.97,2,3,2,2,0
2,1,0,0,1,1,1,7.74,1.5,17.41,0.0,5,0.67,0.97,2,3,2,2,0
2,1,0,0,1,1,1,7.74,1.5,17.41,0.0,5,0.67,0.97,2,3,2,2,0
2,1,0,0,1,1,1,7.74,1.5,17.41,0.0,5,0.67,0.97,2,3,2,2,0
2,1,0,0,1,1,1,7.74,1.5,17.41,0.0,5,0.67,0.97,2,3,2,2,0
2,1,0,0,1,1,1,7.74,1.5,17.41,0.0,5,0.67,0.97,2,3,2,2,0
2,1,0,0,1,1,1,7.74,1.5,17.41,0.0,5,0.67,0.97,2,3,2,2,0
2,1,0,0,1,1,1,7.74,1.5,17.41,0.0,5,0.67,0.97,2,3,2,2,0
2,1,0,0,1,1,1,7.74,1.5,17.41,0.0,5,0.67,0.97,2,3,2,2,0
2,1,0,0,1,1,1,7.74,1.5,17.41,0.0,5,0.67,0.97,2,3,2,2,0
2,1,0,0,1,1,1,7.74,1.5,17.41,0.0,5,0.67,0.97,2,3,2,2,0
2,1,0,0,1,1,1,7.74,1.5,17.41,0.0,5,0.67,0.97,2,3,2,2,0
2,1,0,0,1,1,1,7.74,1.5,17.41,0.0,5,0.67,0.97,2,3,2,2,0
2,1,0,0,1,1,1,7.74,1.5,17.41,0.0,5,0.67,0.97,2,3,2,2,0
2,1,0,0,1,1,1,7.74,1.5,17.41,0.0,5,0.67,0.97,2,3,2,2,0
2,1,0,0,1,1,1,7.74,1.5,17.41,0.0,5,0.67,0.97,2,3,2,2,0
2,1,0,0,1,1,1,7.74,1.5,17.41,0.0,5,0.67,0.97,2,3,2,2,0
2,1,0,0,1,1,1,7.74,1.5,17.41,0.0,5,0.67,0.97,2,3,2,2,0
2,1,0,0,1,1,1,7.74,1.5,17.41,0.0,5,0.67,0.97,2,3,2,2,0
2,1,0,0,1,1,1,7.74,1.5,17.41,0.0,5,0.67,0.97,2,3,2,2,0
2,1,0,0,1,1,1,7.74,1.5,17.41,0.0,5,0.67,0.97,2,3,2,2,0
2,1,0,0,1,1,1,7.74,1.5,17.41,0.0,5,0.67,0.97,2,3,2,2,0
2,1,0,0,1,1,1,7.74,1.5,17.41,0.0,5,0.67,0.97,2,3,2,2,0
2,1,0,0,1,1,1,7.74,1.5,17.41,0.0,5,0.67,0.97,2,3,2,2,0
2,1,0,0,1,1,1,7.74,1.5,17.41,0.0,5,0.67,0.97,2,3,2,2,0
2,1,0,0,1,1,1,7.74,1.5,17.41,0.0,5,0.67,0.97,2,3,2,2,0
2,1,0,0,1,1,1,7.74,1.5,17.41,0.0,5,0.67,0.97,2,3,2,2,0
2,1,0,0,1,1,1,7.74,1.5,17.41,0.0,5,0.67,0.97,2,3,2,2,0
2,1,0,0,1,1,1,7.74,1.5,17.41,0.0,5,0.67,0.97,2,3,2,2,0
2,1,0,0,1,1,1,7.74,1.5,17.41,0.0,5,0.67,0.97,2,3,2,2,0
2,1,0,0,1,1,1,7.74,1.5,17.41,0.0,5,0.67,0.97,2,3,2,2,0
2,1,0,0,1,1,1,7.74,1.5,17.41,0.0,5,0.67,0.97,2,3,2,2,0
2,1,0,0,1,1,1,7.74,1.5,17.41,0.0,5,0.67,0.97,2,3,2,2,0
2,1,0,0,1,1,1,7.74,1.5,17.41,0.0,5,0.67,0.97,2,3,2,2,0
2,1,0,0,1,1,1,7.74,1.5,17.41,0.0,5,0.67,0.97,2,3,2,2,0
2,1,0,0,1,1,1,7.74,1.5,17.41,0.0,5,0.67,0.97,2,3,2,2,0
2,1,0,0,1,1,1,7.74,1.5,17.41,0.0,5,0.67,0.97,2,3,2,2,0
2,1,0,0,1,1,1,7.74,1.5,17.41,0.0,5,0.67,0.97,2,3,2,2,0
2,1,0,0,1,1,1,7.74,1.5,17.41,0.0,5,0.67,0.97,2,3,2,2,0
2,1,0,0,1,1,1,7.74,1.5,17.41,0.0,5,0.67,0.97,2,3,2,2,0
2,1,0,0,1,1,1,7.74,1.5,17.41,0.0,5,0.67,0.97,2,3,2,2,0
2,1,0,0,1,1,1,7.74,1.5,17.41,0.0,5,0.67,0.97,2,3,2,2,0
2,1,0,0,1,1,1,7.74,1.5,17.41,0.0,5,0.67,0.97,2,3,2,2,0
2,1,0,0,1,1,1,7.74,1.5,17.41,0.0,5,0.67,0.97,2,3,2,2,0
2,1,0,0,1,1,1,7.74,1.5,17.41,0.0,5,0.67,0.97,2,3,2,2,0
2,1,0,0,1,1,1,7.74,1.5,17.41,0.0,5,0.67,0.97,2,3,2,2,0
2,1,0,0,1,1,1,7.74,1.5,17.41,0.0,5,0.67,0.97,2,3,2,2,0
2,1,0,0,1,1,1,7.74,1.5,17.41,0.0,5,0.67,0.97,2,3,2,2,0
2,1,0,0,1,1,1,7.74,1.5,17.41,0.0,5,0.67,0.97,2,3,2,2,0
2,1,0,0,1,1,1,7.74,1.5,17.41,0.0,5,0.67,0.97,2,3,2,2,0
2,1,0,0,1,1,1,7.74,1.5,17.41,0.0,5,0.67,0.97,2,3,2,2,0
2,1,0,0,1,1,1,7.74,1.5,17.41,0.0,5,0.67,0.97,2,3,2,2,0
2,1,0,0,1,1,1,7.74,1.5,17.41,0.0,5,0.67,0.97,2,3,2,2,0
2,1,0,0,1,1,1,7.74,1.5,17.41,0.0,5,0.67,0.97,2,3,2,2,0
2,1,0,0,1,1,1,7.74,1.5,17.41,0.0,5,0.67,0.97,2,3,2,2,0
2,1,0,0,1,1,1,7.74,1.5,17.41,0.0,5,0.67,0.97,2,3,2,2,0
2,1,0,0,1,1,1,7.74,1.5,17.41,0.0,5,0.67,0.97,2,3,2,2,0
2,1,0,0,1,1,1,7.74,1.5,17.41,0.0,5,0.67,0.97,2,3,2,2,0
2,1,0,0,1,1,1,7.74,1.5,17.41,0.0,5,0.67,0.97,2,3,2,2,0
2,1,0,0,1,1,1,7.74,1.5,17.41,0.0,5,0.67,0.97,2,3,2,2,0
2,1,0,0,1,1,1,7.74,1.5,17.41,0.0,5,0.67,0.97,2,3,2,2,0
2,1,0,0,1,1,1,7.74,1.5,17.41,0.0,5,0.67,0.97,2,3,2,2,0
2,1,0,0,1,1,1,7.74,1.5,17.41,0.0,5,0.67,0.97,2,3,2,2,0
2,1,0,0,1,1,1,7.74,1.5,17.41,0.0,5,0.67,0.97,2,3,2,2,0
2,1,0,0,1,1,1,7.74,1.5,17.41,0.0,5,0.67,0.97,2,3,2,2,0
2,1,0,0,1,1,1,7.74,1.5,17.41,0.0,5,0.67,0.97,2,3,2,2,0
2,1,0,0,1,1,1,7.74,1.5,17.41,0.0,5,0.67,0.97,2,3,2,2,0
2,1,0,0,1,1,1,7.74,1.5,17.41,0.0,5,0.67,0.97,2,3,2,2,0
2,1,0,0,1,1,1,7.74,1.5,17.41,0.0,5,0.67,0.97,2,3,2,2,0
2,1,0,0,1,1,1,7.74,1.5,17.41,0.0,5,0.67,0.97,2,3,2,2,0
2,1,0,0,1,1,1,7.74,1.5,17.41,0.0,5,0.67,0.97,2,3,2,2,0
2,1,0,0,1,1,1,7.74,1.5,17.41,0.0,5,0.67,0.97,2,3,2,2,0
2,1,0,0,1,1,1,7.74,1.5,17.41,0.0,5,0.67,0.97,2,3,2,2,0
2,1,0,0,1,1,1,7.74,1.5,17.41,0.0,5,0.67,0.97,2,3,2,2,0
2,1,0,0,1,1,1,7.74,1.5,17.41,0.0,5,0.67,0.97,2,3,2,2,0
2,1,0,0,1,1,1,7.74,1.5,17.41,0.0,5,0.67,0.97,2,3,2,2,0
2,1,0,0,1,1,1,7.74,1.5,17.41,0.0,5,0.67,0.97,2,3,2,2,0
2,1,0,0,1,1,1,7.74,1.5,17.41,0.0,5,0.67,0.97,2,3,2,2,0
2,1,0,0,1,1,1,7.74,1.5,17.41,0.0,5,0.67,0.97,2,3,2,2,0
2,1,0,0,1,1,1,7.74,1.5,17.41,0.0,5,0.67,0.97,2,3,2,2,0
2,1,0,0,1,1,1,7.74,1.5,17.41,0.0,5,0.67,0.97,2,3,2,2,0
2,1,0,0,1,1,1,7.74,1.5,17.41,0.0,5,0.67,0.97,2,3,2,2,0
2,1,0,0,1,1,1,7.74,1.5,17.41,0.0,5,0.67,0.97,2,3,2,2,0
2,1,0,0,1,1,1,7.74,1.5,17.41,0.0,5,0.67,0.97,2,3,2,2,0
2,1,0,0,1,1,1,7.74,1.5,17.41,0.0,5,0.67,0.97,2,3,2,2,0
2,1,0,0,1,1,1,7.74,1.5,17.41,0.0,5,0.67,0.97,2,3,2,2,0
6,5,4,0,3,2,1,15.23,7.94,961.39,0.04,28,0.13,53.41,13,15,9,10,0
6,5,4,0,3,2,1,15.23,7.94,961.39,0.04,28,0.13,53.41,13,15,9,10,0
2,1,0,0,1,1,1,7.74,1.5,17.41,0.0,5,0.67,0.97,2,3,2,2,0
2,1,0,0,1,1,1,7.74,1.5,17.41,0.0,5,0.67,0.97,2,3,2,2,0
2,1,0,0,1,1,1,7.74,1.5,17.41,0.0,5,0.67,0.97,2,3,2,2,0
2,1,0,0,1,1,1,7.74,1.5,17.41,0.0,5,0.67,0.97,2,3,2,2,0
2,1,1,0,1,1,1,15.0,2.0,60.0,0.01,10,0.5,3.33,4,6,4,3,0
2,1,0,0,1,1,1,7.74,1.5,17.41,0.0,5,0.67,0.97,2,3,2,2,0
55,39,3,17,20,2,18,37.92,34.5,45133.85,0.44,233,0.03,2507.44,92,141,28,58,0
2,1,0,0,1,1,1,7.74,1.5,17.41,0.0,5,0.67,0.97,2,3,2,2,0
2,1,0,0,1,1,1,7.74,1.5,17.41,0.0,5,0.67,0.97,2,3,2,2,0
2,1,0,0,1,1,1,7.74,1.5,17.41,0.0,5,0.67,0.97,2,3,2,2,0
2,1,0,0,1,1,1,7.74,1.5,17.41,0.0,5,0.67,0.97,2,3,2,2,0
2,1,0,0,1,1,1,7.74,1.5,17.41,0.0,5,0.67,0.97,2,3,2,2,0
2,1,0,0,1,1,1,7.74,1.5,17.41,0.0,5,0.67,0.97,2,3,2,2,0
2,1,0,0,1,1,1,7.74,1.5,17.41,0.0,5,0.67,0.97,2,3,2,2,0
2,1,0,0,1,1,1,7.74,1.5,17.41,0.0,5,0.67,0.97,2,3,2,2,0
2,1,1,0,1,1,1,15.0,2.0,60.0,0.01,10,0.5,3.33,4,6,4,3,0
2,1,0,0,1,1,1,7.74,1.5,17.41,0.0,5,0.67,0.97,2,3,2,2,0
2,1,0,0,1,1,1,7.74,1.5,17.41,0.0,5,0.67,0.97,2,3,2,2,0
6,5,4,0,3,2,1,17.51,9.55,1595.8,0.06,36,0.1,88.66,15,21,11,10,0
2,1,0,0,1,1,1,7.74,1.5,17.41,0.0,5,0.67,0.97,2,3,2,2,0
6,5,4,0,3,2,1,13.75,11.67,1872.19,0.05,35,0.09,104.01,14,21,9,10,0
2,1,0,0,1,1,1,7.74,1.5,17.41,0.0,5,0.67,0.97,2,3,2,2,0
2,1,0,0,1,1,1,7.74,1.5,17.41,0.0,5,0.67,0.97,2,3,2,2,0
2,1,0,0,1,1,1,7.74,1.5,17.41,0.0,5,0.67,0.97,2,3,2,2,0
2,1,0,0,1,1,1,7.74,1.5,17.41,0.0,5,0.67,0.97,2,3,2,2,0
14,5,4,0,3,3,1,28.47,5.6,892.7,0.05,39,0.18,49.59,16,23,10,18,0
5,5,2,0,3,2,1,17.76,5.06,455.24,0.03,22,0.2,25.29,9,13,8,7,0
2,1,0,0,1,1,1,7.74,1.5,17.41,0.0,5,0.67,0.97,2,3,2,2,0
5,5,2,0,3,2,1,17.76,5.06,455.24,0.03,22,0.2,25.29,9,13,8,7,0
14,5,4,0,3,1,1,22.42,7.11,1133.59,0.05,39,0.14,62.98,16,23,9,18,0
2,1,0,0,1,1,1,7.74,1.5,17.41,0.0,5,0.67,0.97,2,3,2,2,0
2,1,0,0,1,1,1,7.74,1.5,17.41,0.0,5,0.67,0.97,2,3,2,2,0
2,1,0,0,1,1,1,7.74,1.5,17.41,0.0,5,0.67,0.97,2,3,2,2,0
2,1,0,0,1,1,1,7.74,1.5,17.41,0.0,5,0.67,0.97,2,3,2,2,0
2,1,0,0,1,1,1,7.74,1.5,17.41,0.0,5,0.67,0.97,2,3,2,2,0
2,1,0,0,1,1,1,7.74,1.5,17.41,0.0,5,0.67,0.97,2,3,2,2,0
8,3,2,0,2,2,1,21.83,3.94,338.43,0.03,22,0.25,18.8,9,13,8,10,0
2,1,0,0,1,1,1,7.74,1.5,17.41,0.0,5,0.67,0.97,2,3,2,2,0
2,1,0,0,1,1,1,7.74,1.5,17.41,0.0,5,0.67,0.97,2,3,2,2,0
2,1,0,0,1,1,1,7.74,1.5,17.41,0.0,5,0.67,0.97,2,3,2,2,0
2,1,0,0,1,1,1,7.74,1.5,17.41,0.0,5,0.67,0.97,2,3,2,2,0
2,1,0,0,1,1,1,7.74,1.5,17.41,0.0,5,0.67,0.97,2,3,2,2,0
2,1,0,0,1,1,1,7.74,1.5,17.41,0.0,5,0.67,0.97,2,3,2,2,0
4,5,3,0,3,2,1,17.76,5.06,455.24,0.03,22,0.2,25.29,9,13,8,7,0
8,3,2,0,2,1,1,16.71,5.14,442.04,0.03,22,0.19,24.56,9,13,7,10,0
2,1,0,0,1,1,1,7.74,1.5,17.41,0.0,5,0.67,0.97,2,3,2,2,0
2,1,0,0,1,1,1,7.74,1.5,17.41,0.0,5,0.67,0.97,2,3,2,2,0
2,1,0,0,1,1,1,7.74,1.5,17.41,0.0,5,0.67,0.97,2,3,2,2,0
2,1,0,0,1,1,1,7.74,1.5,17.41,0.0,5,0.67,0.97,2,3,2,2,0
2,1,0,0,1,1,1,7.74,1.5,17.41,0.0,5,0.67,0.97,2,3,2,2,0
2,1,0,0,1,1,1,7.74,1.5,17.41,0.0,5,0.67,0.97,2,3,2,2,0
2,1,0,0,1,1,1,7.74,1.5,17.41,0.0,5,0.67,0.97,2,3,2,2,0
11,5,1,0,3,2,1,16.8,10.91,1999.82,0.06,39,0.09,111.1,16,23,11,12,0
2,1,0,0,1,1,1,7.74,1.5,17.41,0.0,5,0.67,0.97,2,3,2,2,0
11,5,1,0,3,2,1,18.8,10.5,2072.88,0.07,42,0.1,115.16,18,24,12,12,0
4,5,3,0,3,2,1,17.76,5.06,455.24,0.03,22,0.2,25.29,9,13,8,7,0
2,1,0,0,1,1,1,7.74,1.5,17.41,0.0,5,0.67,0.97,2,3,2,2,0
2,1,0,0,1,1,1,7.74,1.5,17.41,0.0,5,0.67,0.97,2,3,2,2,0
2,1,0,0,1,1,1,7.74,1.5,17.41,0.0,5,0.67,0.97,2,3,2,2,0
2,1,0,0,1,1,1,7.74,1.5,17.41,0.0,5,0.67,0.97,2,3,2,2,0
2,1,0,0,1,1,1,7.74,1.5,17.41,0.0,5,0.67,0.97,2,3,2,2,0
2,1,0,0,1,1,1,7.74,1.5,17.41,0.0,5,0.67,0.97,2,3,2,2,0
2,1,0,0,1,1,1,7.74,1.5,17.41,0.0,5,0.67,0.97,2,3,2,2,0
2,1,0,0,1,1,1,7.74,1.5,17.41,0.0,5,0.67,0.97,2,3,2,2,0
2,1,0,0,1,1,1,7.74,1.5,17.41,0.0,5,0.67,0.97,2,3,2,2,0
2,1,0,0,1,1,1,7.74,1.5,17.41,0.0,5,0.67,0.97,2,3,2,2,0
2,1,0,0,1,1,1,7.74,1.5,17.41,0.0,5,0.67,0.97,2,3,2,2,0
2,1,0,0,1,1,1,7.74,1.5,17.41,0.0,5,0.67,0.97,2,3,2,2,0
2,1,0,0,1,1,1,7.74,1.5,17.41,0.0,5,0.67,0.97,2,3,2,2,0
2,1,0,0,1,1,1,7.74,1.5,17.41,0.0,5,0.67,0.97,2,3,2,2,0
2,1,0,0,1,1,1,7.74,1.5,17.41,0.0,5,0.67,0.97,2,3,2,2,0
2,1,0,0,1,1,1,7.74,1.5,17.41,0.0,5,0.67,0.97,2,3,2,2,0
2,1,0,0,1,1,1,7.74,1.5,17.41,0.0,5,0.67,0.97,2,3,2,2,0
2,1,0,0,1,1,1,7.74,1.5,17.41,0.0,5,0.67,0.97,2,3,2,2,0
2,1,0,0,1,1,1,7.74,1.5,17.41,0.0,5,0.67,0.97,2,3,2,2,0
2,1,0,0,1,1,1,7.74,1.5,17.41,0.0,5,0.67,0.97,2,3,2,2,0
2,1,0,0,1,1,1,7.74,1.5,17.41,0.0,5,0.67,0.97,2,3,2,2,0
2,1,0,0,1,1,1,7.74,1.5,17.41,0.0,5,0.67,0.97,2,3,2,2,0
2,1,0,0,1,1,1,7.74,1.5,17.41,0.0,5,0.67,0.97,2,3,2,2,0
2,1,0,0,1,1,1,7.74,1.5,17.41,0.0,5,0.67,0.97,2,3,2,2,0
2,1,0,0,1,1,1,7.74,1.5,17.41,0.0,5,0.67,0.97,2,3,2,2,0
2,1,0,0,1,1,1,7.74,1.5,17.41,0.0,5,0.67,0.97,2,3,2,2,0
2,1,0,0,1,1,1,7.74,1.5,17.41,0.0,5,0.67,0.97,2,3,2,2,0
2,1,0,0,1,1,1,7.74,1.5,17.41,0.0,5,0.67,0.97,2,3,2,2,0
2,1,0,0,1,1,1,7.74,1.5,17.41,0.0,5,0.67,0.97,2,3,2,2,0
2,1,0,0,1,1,1,7.74,1.5,17.41,0.0,5,0.67,0.97,2,3,2,2,0
2,1,0,0,1,1,1,7.74,1.5,17.41,0.0,5,0.67,0.97,2,3,2,2,0
2,1,0,0,1,1,1,7.74,1.5,17.41,0.0,5,0.67,0.97,2,3,2,2,0
2,1,0,0,1,1,1,7.74,1.5,17.41,0.0,5,0.67,0.97,2,3,2,2,0
2,1,0,0,1,1,1,7.74,1.5,17.41,0.0,5,0.67,0.97,2,3,2,2,0
2,1,0,0,1,1,1,7.74,1.5,17.41,0.0,5,0.67,0.97,2,3,2,2,0
2,1,0,0,1,1,1,7.74,1.5,17.41,0.0,5,0.67,0.97,2,3,2,2,0
2,1,0,0,1,1,1,7.74,1.5,17.41,0.0,5,0.67,0.97,2,3,2,2,0
2,1,0,0,1,1,1,7.74,1.5,17.41,0.0,5,0.67,0.97,2,3,2,2,0
2,1,0,0,1,1,1,7.74,1.5,17.41,0.0,5,0.67,0.97,2,3,2,2,0
2,1,0,0,1,1,1,7.74,1.5,17.41,0.0,5,0.67,0.97,2,3,2,2,0
2,3,2,0,2,1,1,8.72,4.0,139.48,0.01,11,0.25,7.75,4,7,3,4,0
2,3,2,0,2,1,1,8.72,4.0,139.48,0.01,11,0.25,7.75,4,7,3,4,0
2,3,2,0,2,1,1,8.72,4.0,139.48,0.01,11,0.25,7.75,4,7,3,4,0
2,3,2,0,2,1,1,8.72,4.0,139.48,0.01,11,0.25,7.75,4,7,3,4,0
2,3,2,0,2,1,1,8.72,4.0,139.48,0.01,11,0.25,7.75,4,7,3,4,0
6,5,3,0,3,2,1,14.46,7.5,813.14,0.04,26,0.13,45.17,12,14,8,9,0
2,3,2,0,2,1,1,8.72,4.0,139.48,0.01,11,0.25,7.75,4,7,3,4,0
2,3,4,0,2,2,1,12.16,5.6,381.44,0.02,19,0.18,21.19,8,11,5,6,0
2,3,2,0,2,1,1,8.72,4.0,139.48,0.01,11,0.25,7.75,4,7,3,4,0
2,3,2,0,2,1,1,8.72,4.0,139.48,0.01,11,0.25,7.75,4,7,3,4,0
6,5,3,0,3,2,1,14.46,7.5,813.14,0.04,26,0.13,45.17,12,14,8,9,0
2,3,3,0,2,2,1,11.07,4.38,211.89,0.02,14,0.23,11.77,5,9,4,5,0
2,3,2,0,2,1,1,8.72,4.0,139.48,0.01,11,0.25,7.75,4,7,3,4,0
2,3,2,0,2,1,1,8.72,4.0,139.48,0.01,11,0.25,7.75,4,7,3,4,0
2,3,3,0,2,2,1,11.07,4.38,211.89,0.02,14,0.23,11.77,5,9,4,5,0
2,3,3,0,2,2,1,11.07,4.38,211.89,0.02,14,0.23,11.77,5,9,4,5,0
2,3,2,0,2,1,1,8.72,4.0,139.48,0.01,11,0.25,7.75,4,7,3,4,0
2,3,2,0,2,1,1,8.72,4.0,139.48,0.01,11,0.25,7.75,4,7,3,4,0
2,3,3,0,2,2,1,11.07,4.38,211.89,0.02,14,0.23,11.77,5,9,4,5,0
2,3,4,0,2,2,1,15.07,4.67,328.11,0.02,19,0.21,18.23,8,11,6,6,0
1,1,1,0,1,1,1,7.74,1.5,17.41,0.0,5,0.67,0.97,2,3,2,2,0
1,1,1,0,1,1,1,7.74,1.5,17.41,0.0,5,0.67,0.97,2,3,2,2,0
1,1,1,0,1,1,1,7.74,1.5,17.41,0.0,5,0.67,0.97,2,3,2,2,0
1,1,1,0,1,1,1,7.74,1.5,17.41,0.0,5,0.67,0.97,2,3,2,2,0
1,1,1,0,1,1,1,7.74,1.5,17.41,0.0,5,0.67,0.97,2,3,2,2,0
1,1,1,0,1,1,1,7.74,1.5,17.41,0.0,5,0.67,0.97,2,3,2,2,0
1,1,1,0,1,1,1,7.74,1.5,17.41,0.0,5,0.67,0.97,2,3,2,2,0
1,1,1,0,1,1,1,7.74,1.5,17.41,0.0,5,0.67,0.97,2,3,2,2,0
1,1,1,0,1,1,1,7.74,1.5,17.41,0.0,5,0.67,0.97,2,3,2,2,0
1,1,1,0,1,1,1,7.74,1.5,17.41,0.0,5,0.67,0.97,2,3,2,2,0
1,1,1,0,1,1,1,7.74,1.5,17.41,0.0,5,0.67,0.97,2,3,2,2,0
1,1,1,0,1,1,1,7.74,1.5,17.41,0.0,5,0.67,0.97,2,3,2,2,0
1,1,1,0,1,1,1,7.74,1.5,17.41,0.0,5,0.67,0.97,2,3,2,2,0
1,1,1,0,1,1,1,7.74,1.5,17.41,0.0,5,0.67,0.97,2,3,2,2,0
5,3,2,0,2,2,1,8.54,5.83,290.67,0.02,15,0.17,16.14,5,10,3,7,0
5,3,2,0,2,2,1,8.54,5.83,290.67,0.02,15,0.17,16.14,5,10,3,7,0
1,1,1,0,1,1,1,7.74,1.5,17.41,0.0,5,0.67,0.97,2,3,2,2,0
1,1,1,0,1,1,1,7.74,1.5,17.41,0.0,5,0.67,0.97,2,3,2,2,0
1,1,1,0,1,1,1,7.74,1.5,17.41,0.0,5,0.67,0.97,2,3,2,2,0
1,1,1,0,1,1,1,7.74,1.5,17.41,0.0,5,0.67,0.97,2,3,2,2,0
1,1,1,0,1,1,1,7.74,1.5,17.41,0.0,5,0.67,0.97,2,3,2,2,0
1,1,1,0,1,1,1,7.74,1.5,17.41,0.0,5,0.67,0.97,2,3,2,2,0
1,1,1,0,1,1,1,7.74,1.5,17.41,0.0,5,0.67,0.97,2,3,2,2,0
1,1,1,0,1,1,1,7.74,1.5,17.41,0.0,5,0.67,0.97,2,3,2,2,0
1,1,2,0,1,1,1,11.23,2.0,44.92,0.01,8,0.5,2.5,3,5,3,3,0
1,1,2,0,1,1,1,11.23,2.0,44.92,0.01,8,0.5,2.5,3,5,3,3,0
1,1,1,0,1,1,1,7.74,1.5,17.41,0.0,5,0.67,0.97,2,3,2,2,0
1,1,2,0,1,1,1,11.23,2.0,44.92,0.01,8,0.5,2.5,3,5,3,3,0
1,1,1,0,1,1,1,7.74,1.5,17.41,0.0,5,0.67,0.97,2,3,2,2,0
1,1,1,0,1,1,1,7.74,1.5,17.41,0.0,5,0.67,0.97,2,3,2,2,0
2,1,1,0,1,1,1,11.23,2.0,44.92,0.01,8,0.5,2.5,3,5,3,3,0
1,1,1,0,1,1,1,7.74,1.5,17.41,0.0,5,0.67,0.97,2,3,2,2,0
5,3,2,0,2,2,1,15.23,5.0,380.74,0.03,20,0.2,21.15,10,10,7,7,0
5,3,2,0,2,2,1,15.23,5.0,380.74,0.03,20,0.2,21.15,10,10,7,7,0
2,1,1,0,1,1,1,11.23,2.0,44.92,0.01,8,0.5,2.5,3,5,3,3,0
1,1,2,0,1,1,1,11.23,2.0,44.92,0.01,8,0.5,2.5,3,5,3,3,0
8,11,13,0,6,4,5,45.97,7.64,2680.63,0.12,69,0.13,148.92,28,41,22,21,0
8,11,13,0,6,4,5,45.97,7.64,2680.63,0.12,69,0.13,148.92,28,41,22,21,0
1,1,2,0,1,1,1,10.84,1.5,24.38,0.01,7,0.67,1.35,2,5,2,3,0
1,1,2,0,1,1,1,10.84,1.5,24.38,0.01,7,0.67,1.35,2,5,2,3,0
27,23,11,1,12,3,1,29.02,11.14,3602.85,0.11,68,0.09,200.16,24,44,14,38,0
5,5,4,0,3,2,1,11.81,4.5,239.18,0.02,16,0.22,13.29,6,10,4,9,0
1,1,0,0,1,1,1,0.0,0.0,0.0,0.0,1,0.0,0.0,0,1,0,1,0
51,37,4,1,19,1,1,73.7,8.1,4835.34,0.2,127,0.12,268.63,54,73,20,55,0
51,37,4,1,19,1,1,73.7,8.1,4835.34,0.2,127,0.12,268.63,54,73,20,55,0
1,1,0,0,1,1,1,0.0,0.0,0.0,0.0,1,0.0,0.0,0,1,0,1,0
5,5,5,0,3,2,1,15.65,4.2,276.06,0.02,19,0.24,15.34,7,12,5,10,0
2,3,1,0,2,1,1,3.48,4.0,55.73,0.0,6,0.25,3.1,2,4,1,3,0
1,1,0,0,1,1,1,0.0,0.0,0.0,0.0,1,0.0,0.0,0,1,0,1,0
5,5,4,0,3,2,1,11.81,4.5,239.18,0.02,16,0.22,13.29,6,10,4,9,0
27,23,11,1,12,3,1,29.02,11.14,3602.85,0.11,68,0.09,200.16,24,44,14,38,0
6,5,4,0,3,3,1,13.71,6.67,609.18,0.03,24,0.15,33.84,10,14,6,10,0
41,29,6,1,15,2,1,47.28,10.12,4839.44,0.16,103,0.1,268.86,43,60,17,47,0
1,1,0,0,1,1,1,0.0,0.0,0.0,0.0,1,0.0,0.0,0,1,0,1,0
6,9,4,0,5,1,1,12.24,9.33,1066.06,0.04,30,0.11,59.23,14,16,6,10,0
41,29,6,1,15,2,1,47.28,10.12,4839.44,0.16,103,0.1,268.86,43,60,17,47,0
1,1,0,0,1,1,1,0.0,0.0,0.0,0.0,1,0.0,0.0,0,1,0,1,0
1,1,0,0,1,1,1,0.0,0.0,0.0,0.0,1,0.0,0.0,0,1,0,1,0
2,3,1,0,2,1,1,3.48,4.0,55.73,0.0,6,0.25,3.1,2,4,1,3,0
72,19,9,6,10,1,1,71.51,12.75,11624.49,0.3,167,0.08,645.81,68,99,32,81,0
72,19,9,6,10,1,1,66.21,13.6,12247.03,0.3,167,0.07,680.39,68,99,30,81,0
8,3,5,0,2,1,1,24.82,8.4,1751.07,0.07,51,0.12,97.28,24,27,10,13,0
8,3,5,0,2,1,1,24.82,8.4,1751.07,0.07,51,0.12,97.28,24,27,10,13,0
21,9,12,5,5,1,1,26.48,22.0,12815.44,0.19,111,0.05,711.97,44,67,19,33,0
18,5,0,1,3,3,1,28.22,8.25,1920.54,0.08,53,0.12,106.7,22,31,12,18,0
18,5,0,1,3,3,1,28.22,8.25,1920.54,0.08,53,0.12,106.7,22,31,12,18,0
18,5,0,1,3,3,1,28.22,8.25,1920.54,0.08,53,0.12,106.7,22,31,12,18,0
18,5,0,1,3,3,1,28.22,8.25,1920.54,0.08,53,0.12,106.7,22,31,12,18,0
17,5,1,0,3,3,1,31.45,6.36,1273.72,0.07,48,0.16,70.76,20,28,11,18,0
17,5,1,0,3,3,1,31.45,6.36,1273.72,0.07,48,0.16,70.76,20,28,11,18,0
27,3,0,0,2,2,1,98.83,17.19,29200.73,0.57,290,0.06,1622.26,119,171,45,27,0
27,3,0,0,2,2,1,98.83,17.19,29200.73,0.57,290,0.06,1622.26,119,171,45,27,0
7,1,0,0,1,1,1,20.08,5.5,607.27,0.04,29,0.18,33.74,11,18,7,7,0
2,1,0,0,1,1,1,7.74,1.5,17.41,0.0,5,0.67,0.97,2,3,2,2,0
2,1,0,0,1,1,1,7.74,1.5,17.41,0.0,5,0.67,0.97,2,3,2,2,0
2,1,0,0,1,1,1,7.74,1.5,17.41,0.0,5,0.67,0.97,2,3,2,2,0
2,1,0,0,1,1,1,7.74,1.5,17.41,0.0,5,0.67,0.97,2,3,2,2,0
2,1,0,0,1,1,1,7.74,1.5,17.41,0.0,5,0.67,0.97,2,3,2,2,0
2,1,0,0,1,1,1,7.74,1.5,17.41,0.0,5,0.67,0.97,2,3,2,2,0
2,1,0,0,1,1,1,7.74,1.5,17.41,0.0,5,0.67,0.97,2,3,2,2,0
2,1,0,0,1,1,1,7.74,1.5,17.41,0.0,5,0.67,0.97,2,3,2,2,0
2,1,0,0,1,1,1,7.74,1.5,17.41,0.0,5,0.67,0.97,2,3,2,2,0
2,1,0,0,1,1,1,7.74,1.5,17.41,0.0,5,0.67,0.97,2,3,2,2,0
2,1,0,0,1,1,1,7.74,1.5,17.41,0.0,5,0.67,0.97,2,3,2,2,0
2,3,2,0,2,1,1,8.72,4.0,139.48,0.01,11,0.25,7.75,4,7,3,4,0
1,1,1,0,1,1,1,7.74,1.5,17.41,0.0,5,0.67,0.97,2,3,2,2,0
1,1,1,0,1,1,1,7.74,1.5,17.41,0.0,5,0.67,0.97,2,3,2,2,0
1,1,0,0,1,1,1,0.0,0.0,0.0,0.0,1,0.0,0.0,0,1,0,1,0
74,40,40,12,28,16,13,61.8,40.48,101245.81,0.83,379,0.02,5624.77,150,229,63,114,0
74,40,40,12,28,16,13,61.8,40.48,101245.81,0.83,379,0.02,5624.77,150,229,63,114,0
1,1,2,0,1,1,1,13.79,1.5,31.02,0.01,8,0.67,1.72,3,5,3,3,0
1,1,2,0,1,1,1,11.23,2.0,44.92,0.01,8,0.5,2.5,3,5,3,3,0
8,9,0,1,5,2,1,19.98,4.5,404.66,0.03,22,0.22,22.48,8,14,8,8,0
8,9,0,1,5,2,1,19.98,4.5,404.66,0.03,22,0.22,22.48,8,14,8,8,0
1,1,2,0,1,1,1,13.79,1.5,31.02,0.01,8,0.67,1.72,3,5,3,3,0
1,1,2,0,1,1,1,11.23,2.0,44.92,0.01,8,0.5,2.5,3,5,3,3,0
1,1,2,0,1,1,1,11.23,2.0,44.92,0.01,8,0.5,2.5,3,5,3,3,0
1,1,2,0,1,1,1,11.23,2.0,44.92,0.01,8,0.5,2.5,3,5,3,3,0
49,35,36,10,18,10,12,52.39,20.71,22466.83,0.36,186,0.05,1248.16,71,115,36,85,0
49,35,36,10,18,10,12,52.39,20.71,22466.83,0.36,186,0.05,1248.16,71,115,36,85,0
15,5,10,0,3,1,1,22.9,11.46,3006.28,0.09,58,0.09,167.02,25,33,12,25,0
15,5,10,0,3,1,1,22.9,11.46,3006.28,0.09,58,0.09,167.02,25,33,12,25,0
2,1,0,0,1,1,1,11.86,3.5,145.3,0.01,12,0.29,8.07,4,8,4,2,0
2,1,0,0,1,1,1,11.86,3.5,145.3,0.01,12,0.29,8.07,4,8,4,2,0
6,5,6,1,3,3,1,14.85,6.67,659.94,0.03,26,0.15,36.66,10,16,6,12,0
6,5,6,1,3,3,1,14.85,6.67,659.94,0.03,26,0.15,36.66,10,16,6,12,0
1,1,4,0,1,1,1,25.16,2.5,157.27,0.02,17,0.4,8.74,8,9,8,5,0
1,1,4,0,1,1,1,25.16,2.5,157.27,0.02,17,0.4,8.74,8,9,8,5,0
4,3,6,0,2,2,1,33.43,3.55,420.27,0.04,29,0.28,23.35,13,16,11,10,0
4,3,6,0,2,2,1,33.43,3.55,420.27,0.04,29,0.28,23.35,13,16,11,10,0
2,1,0,0,1,1,1,7.74,1.5,17.41,0.0,5,0.67,0.97,2,3,2,2,0
2,1,0,0,1,1,1,7.74,1.5,17.41,0.0,5,0.67,0.97,2,3,2,2,0
2,1,0,0,1,1,1,7.74,1.5,17.41,0.0,5,0.67,0.97,2,3,2,2,0
2,1,0,0,1,1,1,7.74,1.5,17.41,0.0,5,0.67,0.97,2,3,2,2,0
11,11,13,2,6,4,4,43.15,6.37,1749.95,0.09,56,0.16,97.22,22,34,19,24,0
11,11,13,2,6,4,4,43.15,6.37,1749.95,0.09,56,0.16,97.22,22,34,19,24,0
20,1,15,10,1,1,1,108.08,8.29,7432.26,0.3,158,0.12,412.9,68,90,41,35,0
20,1,15,10,1,1,1,111.26,8.1,7291.13,0.3,158,0.12,405.06,68,90,42,35,0
2,1,1,0,1,1,1,11.23,2.0,44.92,0.01,8,0.5,2.5,3,5,3,3,0
2,1,1,0,1,1,1,11.23,2.0,44.92,0.01,8,0.5,2.5,3,5,3,3,0
14,7,11,1,4,3,1,34.23,10.32,3642.58,0.12,70,0.1,202.37,28,42,19,25,0
14,7,11,1,4,3,1,34.23,10.32,3642.58,0.12,70,0.1,202.37,28,42,19,25,0
1,1,2,0,1,1,1,16.84,1.5,37.9,0.01,9,0.67,2.11,4,5,4,3,0
1,1,2,0,1,1,1,13.5,2.0,54.0,0.01,9,0.5,3.0,4,5,4,3,0
1,1,4,0,1,1,1,20.97,3.0,188.72,0.02,17,0.33,10.48,7,10,7,5,0
1,1,4,0,1,1,1,20.97,3.0,188.72,0.02,17,0.33,10.48,7,10,7,5,0
7,1,0,0,1,1,1,20.76,4.0,332.19,0.03,25,0.25,18.46,12,13,6,7,0
2,1,0,0,1,1,1,7.35,8.0,470.48,0.02,17,0.13,26.14,6,11,3,2,0
2,1,0,0,1,1,1,7.81,9.0,632.78,0.02,19,0.11,35.15,8,11,4,2,0
1,1,5,0,1,1,1,23.42,3.21,241.98,0.03,21,0.31,13.44,9,12,7,6,0
17,7,2,0,4,3,3,20.92,23.68,11730.83,0.17,100,0.04,651.71,39,61,14,19,0
6,5,1,0,3,1,1,14.58,12.75,2369.5,0.06,43,0.08,131.64,17,26,8,7,0
0,1,0,0,1,1,1,5.33,1.5,12.0,0.0,4,0.67,0.67,1,3,1,0,0
0,1,0,0,1,1,1,5.33,1.5,12.0,0.0,4,0.67,0.67,1,3,1,0,0
0,1,0,0,1,1,1,5.33,1.5,12.0,0.0,4,0.67,0.67,1,3,1,0,0
0,1,0,0,1,1,1,5.33,1.5,12.0,0.0,4,0.67,0.67,1,3,1,0,0
0,1,0,0,1,1,1,5.33,1.5,12.0,0.0,4,0.67,0.67,1,3,1,0,0
0,1,0,0,1,1,1,5.33,1.5,12.0,0.0,4,0.67,0.67,1,3,1,0,0
0,1,0,0,1,1,1,5.33,1.5,12.0,0.0,4,0.67,0.67,1,3,1,0,0
0,1,0,0,1,1,1,5.33,1.5,12.0,0.0,4,0.67,0.67,1,3,1,0,0
0,1,0,0,1,1,1,5.33,1.5,12.0,0.0,4,0.67,0.67,1,3,1,0,0
0,1,0,0,1,1,1,5.33,1.5,12.0,0.0,4,0.67,0.67,1,3,1,0,0
0,1,0,0,1,1,1,5.33,1.5,12.0,0.0,4,0.67,0.67,1,3,1,0,0
16,1,0,0,1,1,1,93.23,3.0,839.05,0.09,61,0.33,46.61,30,31,20,16,0
0,1,0,0,1,1,1,7.74,1.5,17.41,0.0,5,0.67,0.97,2,3,2,0,0
0,1,0,0,1,1,1,7.74,1.5,17.41,0.0,5,0.67,0.97,2,3,2,0,0
0,1,0,0,1,1,1,7.74,1.5,17.41,0.0,5,0.67,0.97,2,3,2,0,0
0,1,0,0,1,1,1,7.74,1.5,17.41,0.0,5,0.67,0.97,2,3,2,0,0
0,1,0,0,1,1,1,7.74,1.5,17.41,0.0,5,0.67,0.97,2,3,2,0,0
0,1,0,0,1,1,1,7.74,1.5,17.41,0.0,5,0.67,0.97,2,3,2,0,0
0,1,0,0,1,1,1,9.47,2.67,67.38,0.01,9,0.38,3.74,4,5,3,0,0
0,1,0,0,1,1,1,7.74,1.5,17.41,0.0,5,0.67,0.97,2,3,2,0,0
4,1,0,0,1,1,1,14.4,2.5,90.0,0.01,12,0.4,5.0,5,7,4,4,0
6,1,13,9,1,1,1,76.17,7.41,4179.42,0.19,110,0.14,232.19,50,60,27,19,0
6,1,13,9,1,1,1,76.17,7.41,4179.42,0.19,110,0.14,232.19,50,60,27,19,0
6,1,13,9,1,1,1,69.36,8.0,4439.07,0.18,110,0.13,246.61,50,60,25,19,0
6,1,13,9,1,1,1,76.17,7.41,4179.42,0.19,110,0.14,232.19,50,60,27,19,0
6,1,13,9,1,1,1,69.36,8.0,4439.07,0.18,110,0.13,246.61,50,60,25,19,0
6,1,13,9,1,1,1,76.17,7.41,4179.42,0.19,110,0.14,232.19,50,60,27,19,0
6,1,13,9,1,1,1,69.36,8.0,4439.07,0.18,110,0.13,246.61,50,60,25,19,0
6,1,13,9,1,1,1,69.36,8.0,4439.07,0.18,110,0.13,246.61,50,60,25,19,0
6,1,13,9,1,1,1,69.36,8.0,4439.07,0.18,110,0.13,246.61,50,60,25,19,0
6,1,13,9,1,1,1,69.36,8.0,4439.07,0.18,110,0.13,246.61,50,60,25,19,0
6,1,13,9,1,1,1,69.36,8.0,4439.07,0.18,110,0.13,246.61,50,60,25,19,0
6,1,13,9,1,1,1,76.17,7.41,4179.42,0.19,110,0.14,232.19,50,60,27,19,0
6,1,13,9,1,1,1,69.36,8.0,4439.07,0.18,110,0.13,246.61,50,60,25,19,0
6,1,13,9,1,1,1,76.17,7.41,4179.42,0.19,110,0.14,232.19,50,60,27,19,0
6,1,13,9,1,1,1,76.17,7.41,4179.42,0.19,110,0.14,232.19,50,60,27,19,0
6,1,13,9,1,1,1,76.17,7.41,4179.42,0.19,110,0.14,232.19,50,60,27,19,0
6,1,13,9,1,1,1,76.17,7.41,4179.42,0.19,110,0.14,232.19,50,60,27,19,0
6,1,13,9,1,1,1,69.36,8.0,4439.07,0.18,110,0.13,246.61,50,60,25,19,0
6,1,13,9,1,1,1,76.17,7.41,4179.42,0.19,110,0.14,232.19,50,60,27,19,0
6,1,13,9,1,1,1,69.36,8.0,4439.07,0.18,110,0.13,246.61,50,60,25,19,0
3,3,0,0,2,2,1,8.1,3.33,90.0,0.01,9,0.3,5.0,4,5,3,3,0
3,3,0,0,2,2,1,8.1,3.33,90.0,0.01,9,0.3,5.0,4,5,3,3,0
5,1,0,0,1,1,1,21.25,2.4,122.4,0.02,17,0.42,6.8,8,9,5,5,0
5,1,0,0,1,1,1,21.25,2.4,122.4,0.02,17,0.42,6.8,8,9,5,5,0
10,1,0,17,1,1,1,43.56,6.92,2088.02,0.1,71,0.14,116.0,30,41,13,10,0
10,1,0,17,1,1,1,43.56,6.92,2088.02,0.1,71,0.14,116.0,30,41,13,10,0
11,5,0,0,3,1,3,10.66,7.5,599.66,0.03,21,0.13,33.31,6,15,4,11,0
11,5,0,0,3,1,3,10.66,7.5,599.66,0.03,21,0.13,33.31,6,15,4,11,0
81,29,3,8,16,9,13,34.25,60.91,127060.67,0.7,349,0.02,7058.93,134,215,33,84,0
81,29,3,8,16,9,13,34.25,60.91,127060.67,0.7,349,0.02,7058.93,134,215,33,84,0
10,3,0,1,2,2,1,14.14,10.56,1577.39,0.05,34,0.09,87.63,13,21,8,10,0
10,3,0,1,2,2,1,14.14,10.56,1577.39,0.05,34,0.09,87.63,13,21,8,10,0
11,3,0,1,2,2,1,18.83,9.0,1525.13,0.06,38,0.11,84.73,15,23,10,11,0
11,3,0,1,2,2,1,18.83,9.0,1525.13,0.06,38,0.11,84.73,15,23,10,11,0
4,1,1,1,1,1,1,18.98,2.92,161.44,0.02,16,0.34,8.97,7,9,6,5,0
2,1,0,1,1,1,1,7.74,1.5,17.41,0.0,5,0.67,0.97,2,3,2,2,0
0,1,0,0,1,1,1,0.0,0.0,0.0,0.0,1,0.0,0.0,0,1,0,0,0
0,1,0,0,1,1,1,0.0,0.0,0.0,0.0,1,0.0,0.0,0,1,0,0,0
0,1,0,0,1,1,1,0.0,0.0,0.0,0.0,1,0.0,0.0,0,1,0,0,0
0,1,0,0,1,1,1,0.0,0.0,0.0,0.0,1,0.0,0.0,0,1,0,0,0
0,1,0,0,1,1,1,0.0,0.0,0.0,0.0,1,0.0,0.0,0,1,0,0,0
0,1,0,0,1,1,1,0.0,0.0,0.0,0.0,1,0.0,0.0,0,1,0,0,0
0,1,0,0,1,1,1,0.0,0.0,0.0,0.0,1,0.0,0.0,0,1,0,0,0
0,1,0,0,1,1,1,0.0,0.0,0.0,0.0,1,0.0,0.0,0,1,0,0,0
0,1,0,0,1,1,1,0.0,0.0,0.0,0.0,1,0.0,0.0,0,1,0,0,0
0,1,0,0,1,1,1,0.0,0.0,0.0,0.0,1,0.0,0.0,0,1,0,0,0
0,1,0,0,1,1,1,0.0,0.0,0.0,0.0,1,0.0,0.0,0,1,0,0,0
0,1,0,0,1,1,1,0.0,0.0,0.0,0.0,1,0.0,0.0,0,1,0,0,0
5,1,38,75,1,1,1,142.01,9.77,13558.89,0.46,259,0.1,753.27,114,145,35,43,0
5,1,38,75,1,1,1,142.01,9.77,13558.89,0.46,259,0.1,753.27,114,145,35,43,0
5,1,38,75,1,1,1,142.01,9.77,13558.89,0.46,259,0.1,753.27,114,145,35,43,0
5,1,38,75,1,1,1,142.01,9.77,13558.89,0.46,259,0.1,753.27,114,145,35,43,0
5,1,38,75,1,1,1,142.01,9.77,13558.89,0.46,259,0.1,753.27,114,145,35,43,0
5,1,38,75,1,1,1,142.01,9.77,13558.89,0.46,259,0.1,753.27,114,145,35,43,0
5,1,38,75,1,1,1,142.01,9.77,13558.89,0.46,259,0.1,753.27,114,145,35,43,0
5,1,38,75,1,1,1,142.01,9.77,13558.89,0.46,259,0.1,753.27,114,145,35,43,0
5,1,38,75,1,1,1,142.01,9.77,13558.89,0.46,259,0.1,753.27,114,145,35,43,0
5,1,38,75,1,1,1,142.01,9.77,13558.89,0.46,259,0.1,753.27,114,145,35,43,0
5,1,38,75,1,1,1,142.01,9.77,13558.89,0.46,259,0.1,753.27,114,145,35,43,0
5,1,38,75,1,1,1,142.01,9.77,13558.89,0.46,259,0.1,753.27,114,145,35,43,0
5,1,38,75,1,1,1,142.01,9.77,13558.89,0.46,259,0.1,753.27,114,145,35,43,0
5,1,38,75,1,1,1,142.01,9.77,13558.89,0.46,259,0.1,753.27,114,145,35,43,0
5,1,38,75,1,1,1,142.01,9.77,13558.89,0.46,259,0.1,753.27,114,145,35,43,0
5,1,38,75,1,1,1,142.01,9.77,13558.89,0.46,259,0.1,753.27,114,145,35,43,0
5,1,38,75,1,1,1,142.01,9.77,13558.89,0.46,259,0.1,753.27,114,145,35,43,0
5,1,38,75,1,1,1,142.01,9.77,13558.89,0.46,259,0.1,753.27,114,145,35,43,0
5,1,38,75,1,1,1,142.01,9.77,13558.89,0.46,259,0.1,753.27,114,145,35,43,0
5,1,38,75,1,1,1,142.01,9.77,13558.89,0.46,259,0.1,753.27,114,145,35,43,0
6,3,0,0,2,1,1,10.15,9.0,822.39,0.03,24,0.11,45.69,10,14,5,6,0
6,1,1,0,1,1,1,14.47,6.75,659.29,0.03,25,0.15,36.63,9,16,6,7,0
2,1,0,0,1,1,1,12.68,2.5,79.25,0.01,10,0.4,4.4,4,6,4,2,0
11,5,0,0,3,2,1,16.47,12.0,2371.85,0.07,45,0.08,131.77,18,27,9,11,0
13,5,1,1,3,3,1,19.9,13.64,3701.1,0.09,60,0.07,205.62,25,35,11,14,0
13,5,1,1,3,3,1,19.9,13.64,3701.1,0.09,60,0.07,205.62,25,35,11,14,0
3,1,0,0,1,1,1,13.29,3.0,119.59,0.01,12,0.33,6.64,4,8,4,3,0
5,1,0,0,1,1,1,13.8,6.67,613.33,0.03,23,0.15,34.07,8,15,6,5,0
0,1,0,0,1,1,1,0.0,0.0,0.0,0.0,1,0.0,0.0,0,1,0,0,0
0,1,0,0,1,1,1,0.0,0.0,0.0,0.0,0,0.0,0.0,0,0,0,0,0
35,13,1,4,7,5,1,60.13,9.98,5986.96,0.2,120,0.1,332.61,51,69,23,36,0
8,3,0,0,1,1,1,13.83,8.57,1016.03,0.04,29,0.12,56.45,12,17,7,8,0
4,1,0,0,1,1,1,5.43,8.75,416.05,0.02,15,0.11,23.11,5,10,2,4,0
8,3,0,0,2,2,1,13.83,8.57,1016.03,0.04,29,0.12,56.45,12,17,7,8,0
3,3,2,0,2,2,1,13.95,2.5,87.17,0.01,11,0.4,4.84,4,7,4,5,0
4,1,0,0,1,1,1,12.58,6.6,547.97,0.03,24,0.15,30.44,11,13,5,4,0
0,1,0,0,1,1,1,6.89,3.0,62.04,0.01,8,0.33,3.45,3,5,2,0,0
6,3,0,3,2,2,1,16.61,3.0,149.49,0.02,15,0.33,8.3,6,9,5,6,0
0,1,0,0,1,1,1,0.0,0.0,0.0,0.0,1,0.0,0.0,0,1,0,0,0
0,1,0,0,1,1,1,0.0,0.0,0.0,0.0,0,0.0,0.0,0,0,0,0,0
0,1,0,0,1,1,1,5.33,1.5,12.0,0.0,4,0.67,0.67,1,3,1,0,0
0,1,0,0,1,1,1,5.33,1.5,12.0,0.0,4,0.67,0.67,1,3,1,0,0
0,1,0,0,1,1,1,5.33,1.5,12.0,0.0,4,0.67,0.67,1,3,1,0,0
0,1,0,0,1,1,1,5.33,1.5,12.0,0.0,4,0.67,0.67,1,3,1,0,0
0,1,0,0,1,1,1,5.33,1.5,12.0,0.0,4,0.67,0.67,1,3,1,0,0
0,1,0,0,1,1,1,9.51,3.0,85.59,0.01,9,0.33,4.75,3,6,3,0,0
0,1,0,0,1,1,1,5.33,1.5,12.0,0.0,4,0.67,0.67,1,3,1,0,0
0,1,0,0,1,1,1,5.33,1.5,12.0,0.0,4,0.67,0.67,1,3,1,0,0
0,1,0,0,1,1,1,5.33,1.5,12.0,0.0,4,0.67,0.67,1,3,1,0,0
0,1,0,0,1,1,1,0.0,0.0,0.0,0.0,1,0.0,0.0,0,1,0,0,0
0,1,0,0,1,1,1,0.0,0.0,0.0,0.0,1,0.0,0.0,0,1,0,0,0
12,1,0,5,1,1,1,55.25,3.83,811.8,0.07,49,0.26,45.1,23,26,15,12,0
2,1,0,0,1,1,1,7.35,8.0,470.48,0.02,17,0.13,26.14,6,11,3,2,0
2,1,0,0,1,1,1,7.81,9.0,632.78,0.02,19,0.11,35.15,8,11,4,2,0
0,1,0,0,1,1,1,0.0,0.0,0.0,0.0,3,0.0,0.0,0,3,0,0,0
0,1,0,0,1,1,1,0.0,0.0,0.0,0.0,2,0.0,0.0,0,2,0,0,0
0,1,0,0,1,1,1,5.33,1.5,12.0,0.0,4,0.67,0.67,1,3,1,0,0
0,1,0,0,1,1,1,5.33,1.5,12.0,0.0,4,0.67,0.67,1,3,1,0,0
0,1,0,0,1,1,1,5.33,1.5,12.0,0.0,4,0.67,0.67,1,3,1,0,0
0,1,0,0,1,1,1,7.74,1.5,17.41,0.0,5,0.67,0.97,2,3,2,0,0
0,1,0,0,1,1,1,0.0,0.0,0.0,0.0,1,0.0,0.0,0,1,0,0,0
0,1,0,0,1,1,1,7.74,1.5,17.41,0.0,5,0.67,0.97,2,3,2,0,0
0,1,0,0,1,1,1,7.74,1.5,17.41,0.0,5,0.67,0.97,2,3,2,0,0
0,1,0,0,1,1,1,7.74,1.5,17.41,0.0,5,0.67,0.97,2,3,2,0,0
0,1,0,0,1,1,1,16.5,2.0,66.0,0.01,11,0.5,3.67,4,7,4,0,0
0,1,0,0,1,1,1,5.33,1.5,12.0,0.0,4,0.67,0.67,1,3,1,0,0
0,1,0,0,1,1,1,16.5,2.0,66.0,0.01,11,0.5,3.67,4,7,4,0,0
0,1,0,0,1,1,1,5.33,1.5,12.0,0.0,4,0.67,0.67,1,3,1,0,0
0,1,0,0,1,1,1,5.33,1.5,12.0,0.0,4,0.67,0.67,1,3,1,0,0
0,1,0,0,1,1,1,16.5,2.0,66.0,0.01,11,0.5,3.67,4,7,4,0,0
0,1,0,0,1,1,1,5.33,1.5,12.0,0.0,4,0.67,0.67,1,3,1,0,0
0,1,0,0,1,1,1,7.74,1.5,17.41,0.0,5,0.67,0.97,2,3,2,0,0
0,1,0,0,1,1,1,7.74,1.5,17.41,0.0,5,0.67,0.97,2,3,2,0,0
0,1,0,0,1,1,1,16.84,1.5,37.9,0.01,9,0.67,2.11,4,5,4,0,0
0,1,0,0,1,1,1,7.74,1.5,17.41,0.0,5,0.67,0.97,2,3,2,0,0
0,1,0,0,1,1,1,16.84,1.5,37.9,0.01,9,0.67,2.11,4,5,4,0,0
0,1,0,0,1,1,1,7.74,1.5,17.41,0.0,5,0.67,0.97,2,3,2,0,0
0,1,0,0,1,1,1,7.74,1.5,17.41,0.0,5,0.67,0.97,2,3,2,0,0
0,1,0,0,1,1,1,7.74,1.5,17.41,0.0,5,0.67,0.97,2,3,2,0,0
0,1,0,0,1,1,1,7.86,2.5,49.13,0.01,7,0.4,2.73,2,5,2,0,0
0,1,0,0,1,1,1,7.86,2.5,49.13,0.01,7,0.4,2.73,2,5,2,0,0
0,1,0,0,1,1,1,5.33,1.5,12.0,0.0,4,0.67,0.67,1,3,1,0,0
0,1,0,0,1,1,1,5.33,1.5,12.0,0.0,4,0.67,0.67,1,3,1,0,0
0,1,0,0,1,1,1,5.33,1.5,12.0,0.0,4,0.67,0.67,1,3,1,0,0
0,1,0,0,1,1,1,5.33,1.5,12.0,0.0,4,0.67,0.67,1,3,1,0,0
0,1,0,0,1,1,1,5.33,1.5,12.0,0.0,4,0.67,0.67,1,3,1,0,0
0,1,0,0,1,1,1,5.33,1.5,12.0,0.0,4,0.67,0.67,1,3,1,0,0
0,1,0,0,1,1,1,5.33,1.5,12.0,0.0,4,0.67,0.67,1,3,1,0,0
0,1,0,0,1,1,1,5.33,1.5,12.0,0.0,4,0.67,0.67,1,3,1,0,0
0,1,0,0,1,1,1,5.33,1.5,12.0,0.0,4,0.67,0.67,1,3,1,0,0
0,1,0,0,1,1,1,5.33,1.5,12.0,0.0,4,0.67,0.67,1,3,1,0,0
0,1,0,0,1,1,1,5.33,1.5,12.0,0.0,4,0.67,0.67,1,3,1,0,0
0,1,0,0,1,1,1,5.33,1.5,12.0,0.0,4,0.67,0.67,1,3,1,0,0
0,1,0,0,1,1,1,5.33,1.5,12.0,0.0,4,0.67,0.67,1,3,1,0,0
0,1,0,0,1,1,1,5.33,1.5,12.0,0.0,4,0.67,0.67,1,3,1,0,0
0,1,0,0,1,1,1,5.33,1.5,12.0,0.0,4,0.67,0.67,1,3,1,0,0
0,1,0,0,1,1,1,6.2,2.5,38.77,0.01,6,0.4,2.15,1,5,1,0,0
0,1,0,0,1,1,1,5.33,1.5,12.0,0.0,4,0.67,0.67,1,3,1,0,0
0,1,0,0,1,1,1,5.33,1.5,12.0,0.0,4,0.67,0.67,1,3,1,0,0
0,1,0,0,1,1,1,5.33,1.5,12.0,0.0,4,0.67,0.67,1,3,1,0,0
0,1,0,0,1,1,1,5.33,1.5,12.0,0.0,4,0.67,0.67,1,3,1,0,0
0,1,0,0,1,1,1,5.33,1.5,12.0,0.0,4,0.67,0.67,1,3,1,0,0
0,1,0,0,1,1,1,5.33,1.5,12.0,0.0,4,0.67,0.67,1,3,1,0,0
0,1,0,0,1,1,1,5.33,1.5,12.0,0.0,4,0.67,0.67,1,3,1,0,0
0,1,0,0,1,1,1,5.33,1.5,12.0,0.0,4,0.67,0.67,1,3,1,0,0
0,1,0,0,1,1,1,5.33,1.5,12.0,0.0,4,0.67,0.67,1,3,1,0,0
0,1,0,0,1,1,1,5.33,1.5,12.0,0.0,4,0.67,0.67,1,3,1,0,0
0,1,0,0,1,1,1,5.33,1.5,12.0,0.0,4,0.67,0.67,1,3,1,0,0
0,1,0,0,1,1,1,5.33,1.5,12.0,0.0,4,0.67,0.67,1,3,1,0,0
0,1,0,0,1,1,1,5.33,1.5,12.0,0.0,4,0.67,0.67,1,3,1,0,0
0,1,0,0,1,1,1,5.33,1.5,12.0,0.0,4,0.67,0.67,1,3,1,0,0
0,1,0,0,1,1,1,7.86,2.5,49.13,0.01,7,0.4,2.73,2,5,2,0,0
0,1,0,0,1,1,1,5.33,1.5,12.0,0.0,4,0.67,0.67,1,3,1,0,0
0,1,0,0,1,1,1,7.86,2.5,49.13,0.01,7,0.4,2.73,2,5,2,0,0
0,1,0,0,1,1,1,0.0,0.0,0.0,0.0,3,0.0,0.0,0,3,0,0,0
0,1,0,0,1,1,1,7.74,1.5,17.41,0.0,5,0.67,0.97,2,3,2,0,0
0,1,0,0,1,1,1,7.74,1.5,17.41,0.0,5,0.67,0.97,2,3,2,0,0
0,1,0,0,1,1,1,7.74,1.5,17.41,0.0,5,0.67,0.97,2,3,2,0,0
0,1,0,0,1,1,1,7.74,1.5,17.41,0.0,5,0.67,0.97,2,3,2,0,0
14,9,11,2,1,1,1,51.89,12.22,7751.92,0.21,120,0.08,430.66,55,65,27,25,0
0,1,0,0,1,1,1,7.74,1.5,17.41,0.0,5,0.67,0.97,2,3,2,0,0
0,1,0,0,1,1,1,7.74,1.5,17.41,0.0,5,0.67,0.97,2,3,2,0,0
0,1,0,0,1,1,1,7.74,1.5,17.41,0.0,5,0.67,0.97,2,3,2,0,0
0,1,0,0,1,1,1,7.74,1.5,17.41,0.0,5,0.67,0.97,2,3,2,0,0
0,1,0,0,1,1,1,7.74,1.5,17.41,0.0,5,0.67,0.97,2,3,2,0,0
0,1,0,0,1,1,1,7.74,1.5,17.41,0.0,5,0.67,0.97,2,3,2,0,0
0,1,0,0,1,1,1,5.8,2.0,23.22,0.0,5,0.5,1.29,1,4,1,0,0
1,1,0,0,1,1,1,0.0,0.0,0.0,0.0,1,0.0,0.0,0,1,0,1,0
1,1,0,0,1,1,1,0.0,0.0,0.0,0.0,1,0.0,0.0,0,1,0,1,0
0,1,0,0,1,1,1,5.33,1.5,12.0,0.0,4,0.67,0.67,1,3,1,0,0
0,1,0,0,1,1,1,5.33,1.5,12.0,0.0,4,0.67,0.67,1,3,1,0,0
0,1,0,0,1,1,1,5.33,1.5,12.0,0.0,4,0.67,0.67,1,3,1,0,0
0,1,0,0,1,1,1,5.33,1.5,12.0,0.0,4,0.67,0.67,1,3,1,0,0
0,1,0,0,1,1,1,5.33,1.5,12.0,0.0,4,0.67,0.67,1,3,1,0,0
0,1,0,0,1,1,1,0.0,0.0,0.0,0.0,0,0.0,0.0,0,0,0,0,0
0,1,0,0,1,1,1,0.0,0.0,0.0,0.0,0,0.0,0.0,0,0,0,0,0
0,1,0,0,1,1,1,5.33,1.5,12.0,0.0,4,0.67,0.67,1,3,1,0,0
0,1,0,0,1,1,1,5.33,1.5,12.0,0.0,4,0.67,0.67,1,3,1,0,0
0,1,0,0,1,1,1,5.33,1.5,12.0,0.0,4,0.67,0.67,1,3,1,0,0
0,1,0,0,1,1,1,5.33,1.5,12.0,0.0,4,0.67,0.67,1,3,1,0,0
0,1,0,0,1,1,1,0.0,0.0,0.0,0.0,1,0.0,0.0,0,1,0,0,0
0,1,0,0,1,1,1,0.0,0.0,0.0,0.0,1,0.0,0.0,0,1,0,0,0
0,1,0,0,1,1,1,0.0,0.0,0.0,0.0,0,0.0,0.0,0,0,0,0,0
0,1,0,0,1,1,1,0.0,0.0,0.0,0.0,0,0.0,0.0,0,0,0,0,0
0,1,0,0,1,1,1,0.0,0.0,0.0,0.0,3,0.0,0.0,0,3,0,0,0
0,1,0,0,1,1,1,0.0,0.0,0.0,0.0,3,0.0,0.0,0,3,0,0,0
0,1,0,0,1,1,1,0.0,0.0,0.0,0.0,2,0.0,0.0,0,2,0,0,0
0,1,0,0,1,1,1,0.0,0.0,0.0,0.0,2,0.0,0.0,0,2,0,0,0
0,1,0,0,1,1,1,0.0,0.0,0.0,0.0,1,0.0,0.0,0,1,0,0,0
0,1,0,0,1,1,1,0.0,0.0,0.0,0.0,1,0.0,0.0,0,1,0,0,0
0,1,0,0,1,1,1,0.0,0.0,0.0,0.0,0,0.0,0.0,0,0,0,0,0
0,1,0,0,1,1,1,0.0,0.0,0.0,0.0,0,0.0,0.0,0,0,0,0,0
2,1,0,0,1,1,1,7.35,8.0,470.48,0.02,17,0.13,26.14,6,11,3,2,0
2,1,0,0,1,1,1,7.81,9.0,632.78,0.02,19,0.11,35.15,8,11,4,2,0
0,1,0,0,1,1,1,5.33,1.5,12.0,0.0,4,0.67,0.67,1,3,1,0,0
0,1,0,0,1,1,1,5.33,1.5,12.0,0.0,4,0.67,0.67,1,3,1,0,0
0,1,0,0,1,1,1,5.33,1.5,12.0,0.0,4,0.67,0.67,1,3,1,0,0
0,1,0,0,1,1,1,5.33,1.5,12.0,0.0,4,0.67,0.67,1,3,1,0,0
0,1,0,0,1,1,1,5.33,1.5,12.0,0.0,4,0.67,0.67,1,3,1,0,0
0,1,0,0,1,1,1,5.33,1.5,12.0,0.0,4,0.67,0.67,1,3,1,0,0
0,1,0,0,1,1,1,7.74,1.5,17.41,0.0,5,0.67,0.97,2,3,2,0,0
0,1,0,0,1,1,1,7.74,1.5,17.41,0.0,5,0.67,0.97,2,3,2,0,0
0,1,0,0,1,1,1,0.0,0.0,0.0,0.0,1,0.0,0.0,0,1,0,0,0
0,1,0,0,1,1,1,0.0,0.0,0.0,0.0,1,0.0,0.0,0,1,0,0,0
0,1,0,0,1,1,1,7.74,1.5,17.41,0.0,5,0.67,0.97,2,3,2,0,0
0,1,0,0,1,1,1,7.74,1.5,17.41,0.0,5,0.67,0.97,2,3,2,0,0
20,7,0,4,1,1,1,32.91,9.72,3111.11,0.11,64,0.1,172.84,25,39,18,20,0
20,7,0,4,1,1,1,32.91,9.72,3111.11,0.11,64,0.1,172.84,25,39,18,20,0
0,1,0,0,1,1,1,5.33,1.5,12.0,0.0,4,0.67,0.67,1,3,1,0,0
0,1,0,0,1,1,1,5.33,1.5,12.0,0.0,4,0.67,0.67,1,3,1,0,0
0,1,0,0,1,1,1,7.74,1.5,17.41,0.0,5,0.67,0.97,2,3,2,0,0
0,1,0,0,1,1,1,7.74,1.5,17.41,0.0,5,0.67,0.97,2,3,2,0,0
0,1,0,0,1,1,1,7.74,1.5,17.41,0.0,5,0.67,0.97,2,3,2,0,0
0,1,0,0,1,1,1,7.74,1.5,17.41,0.0,5,0.67,0.97,2,3,2,0,0
0,1,0,0,1,1,1,7.74,1.5,17.41,0.0,5,0.67,0.97,2,3,2,0,0
0,1,0,0,1,1,1,7.74,1.5,17.41,0.0,5,0.67,0.97,2,3,2,0,0
0,1,0,0,1,1,1,7.74,1.5,17.41,0.0,5,0.67,0.97,2,3,2,0,0
0,1,0,0,1,1,1,7.74,1.5,17.41,0.0,5,0.67,0.97,2,3,2,0,0
0,1,0,0,1,1,1,5.33,1.5,12.0,0.0,4,0.67,0.67,1,3,1,0,0
0,1,0,0,1,1,1,5.33,1.5,12.0,0.0,4,0.67,0.67,1,3,1,0,0
0,1,0,0,1,1,1,5.33,1.5,12.0,0.0,4,0.67,0.67,1,3,1,0,0
0,1,0,0,1,1,1,5.33,1.5,12.0,0.0,4,0.67,0.67,1,3,1,0,0
0,1,0,0,1,1,1,5.33,1.5,12.0,0.0,4,0.67,0.67,1,3,1,0,0
0,1,0,0,1,1,1,5.33,1.5,12.0,0.0,4,0.67,0.67,1,3,1,0,0
0,1,0,0,1,1,1,5.33,1.5,12.0,0.0,4,0.67,0.67,1,3,1,0,0
0,1,0,0,1,1,1,5.33,1.5,12.0,0.0,4,0.67,0.67,1,3,1,0,0
0,1,0,0,1,1,1,5.33,1.5,12.0,0.0,4,0.67,0.67,1,3,1,0,0
0,1,0,0,1,1,1,5.33,1.5,12.0,0.0,4,0.67,0.67,1,3,1,0,0
0,1,0,0,1,1,1,5.33,1.5,12.0,0.0,4,0.67,0.67,1,3,1,0,0
0,1,0,0,1,1,1,5.33,1.5,12.0,0.0,4,0.67,0.67,1,3,1,0,0
0,1,0,0,1,1,1,5.33,1.5,12.0,0.0,4,0.67,0.67,1,3,1,0,0
0,1,0,0,1,1,1,5.33,1.5,12.0,0.0,4,0.67,0.67,1,3,1,0,0
0,1,0,0,1,1,1,5.33,1.5,12.0,0.0,4,0.67,0.67,1,3,1,0,0
0,1,0,0,1,1,1,5.33,1.5,12.0,0.0,4,0.67,0.67,1,3,1,0,0
0,1,0,0,1,1,1,5.33,1.5,12.0,0.0,4,0.67,0.67,1,3,1,0,0
0,1,0,0,1,1,1,5.33,1.5,12.0,0.0,4,0.67,0.67,1,3,1,0,0
0,1,0,0,1,1,1,5.33,1.5,12.0,0.0,4,0.67,0.67,1,3,1,0,0
0,1,0,0,1,1,1,5.33,1.5,12.0,0.0,4,0.67,0.67,1,3,1,0,0
0,1,0,0,1,1,1,5.33,1.5,12.0,0.0,4,0.67,0.67,1,3,1,0,0
0,1,0,0,1,1,1,5.33,1.5,12.0,0.0,4,0.67,0.67,1,3,1,0,0
0,1,0,0,1,1,1,5.8,2.0,23.22,0.0,5,0.5,1.29,1,4,1,0,0
0,1,0,0,1,1,1,5.8,2.0,23.22,0.0,5,0.5,1.29,1,4,1,0,0
0,1,0,0,1,1,1,5.33,1.5,12.0,0.0,4,0.67,0.67,1,3,1,0,0
0,1,0,0,1,1,1,5.33,1.5,12.0,0.0,4,0.67,0.67,1,3,1,0,0
0,1,0,0,1,1,1,5.33,1.5,12.0,0.0,4,0.67,0.67,1,3,1,0,0
0,1,0,0,1,1,1,5.33,1.5,12.0,0.0,4,0.67,0.67,1,3,1,0,0
0,1,0,0,1,1,1,5.33,1.5,12.0,0.0,4,0.67,0.67,1,3,1,0,0
0,1,0,0,1,1,1,5.33,1.5,12.0,0.0,4,0.67,0.67,1,3,1,0,0
0,1,0,0,1,1,1,5.33,1.5,12.0,0.0,4,0.67,0.67,1,3,1,0,0
0,1,0,0,1,1,1,5.33,1.5,12.0,0.0,4,0.67,0.67,1,3,1,0,0
0,1,0,0,1,1,1,5.33,1.5,12.0,0.0,4,0.67,0.67,1,3,1,0,0
0,1,0,0,1,1,1,5.33,1.5,12.0,0.0,4,0.67,0.67,1,3,1,0,0
0,1,0,0,1,1,1,5.33,1.5,12.0,0.0,4,0.67,0.67,1,3,1,0,0
0,1,0,0,1,1,1,5.33,1.5,12.0,0.0,4,0.67,0.67,1,3,1,0,0
0,1,0,0,1,1,1,7.74,1.5,17.41,0.0,5,0.67,0.97,2,3,2,0,0
0,1,0,0,1,1,1,7.74,1.5,17.41,0.0,5,0.67,0.97,2,3,2,0,0
0,1,0,0,1,1,1,5.33,1.5,12.0,0.0,4,0.67,0.67,1,3,1,0,0
0,1,0,0,1,1,1,5.33,1.5,12.0,0.0,4,0.67,0.67,1,3,1,0,0
0,1,0,0,1,1,1,7.86,2.5,49.13,0.01,7,0.4,2.73,2,5,2,0,0
0,1,0,0,1,1,1,7.86,2.5,49.13,0.01,7,0.4,2.73,2,5,2,0,0
0,1,0,0,1,1,1,0.0,0.0,0.0,0.0,3,0.0,0.0,0,3,0,0,0
0,1,0,0,1,1,1,0.0,0.0,0.0,0.0,3,0.0,0.0,0,3,0,0,0
0,1,0,0,1,1,1,7.74,1.5,17.41,0.0,5,0.67,0.97,2,3,2,0,0
0,1,0,0,1,1,1,7.74,1.5,17.41,0.0,5,0.67,0.97,2,3,2,0,0
0,1,0,0,1,1,1,4.75,1.0,4.75,0.0,3,1.0,0.26,1,2,1,0,0
0,1,0,0,1,1,1,4.75,1.0,4.75,0.0,3,1.0,0.26,1,2,1,0,0
0,1,0,0,1,1,1,7.74,1.5,17.41,0.0,5,0.67,0.97,2,3,2,0,0
0,1,0,0,1,1,1,7.74,1.5,17.41,0.0,5,0.67,0.97,2,3,2,0,0
0,1,0,0,1,1,1,7.74,1.5,17.41,0.0,5,0.67,0.97,2,3,2,0,0
0,1,0,0,1,1,1,7.74,1.5,17.41,0.0,5,0.67,0.97,2,3,2,0,0
0,1,0,0,1,1,1,7.74,1.5,17.41,0.0,5,0.67,0.97,2,3,2,0,0
0,1,0,0,1,1,1,7.74,1.5,17.41,0.0,5,0.67,0.97,2,3,2,0,0
0,1,0,0,1,1,1,7.74,1.5,17.41,0.0,5,0.67,0.97,2,3,2,0,0
0,1,0,0,1,1,1,7.74,1.5,17.41,0.0,5,0.67,0.97,2,3,2,0,0
0,1,0,0,1,1,1,7.74,1.5,17.41,0.0,5,0.67,0.97,2,3,2,0,0
0,1,0,0,1,1,1,7.74,1.5,17.41,0.0,5,0.67,0.97,2,3,2,0,0
0,1,0,0,1,1,1,7.74,1.5,17.41,0.0,5,0.67,0.97,2,3,2,0,0
0,1,0,0,1,1,1,7.74,1.5,17.41,0.0,5,0.67,0.97,2,3,2,0,0
0,1,0,0,1,1,1,7.74,1.5,17.41,0.0,5,0.67,0.97,2,3,2,0,0
0,1,0,0,1,1,1,7.74,1.5,17.41,0.0,5,0.67,0.97,2,3,2,0,0
0,1,0,0,1,1,1,5.33,1.5,12.0,0.0,4,0.67,0.67,1,3,1,0,0
0,1,0,0,1,1,1,5.33,1.5,12.0,0.0,4,0.67,0.67,1,3,1,0,0
13,13,0,0,7,5,1,23.89,9.6,2201.72,0.08,55,0.1,122.32,24,31,10,13,0
13,13,0,0,7,5,1,23.89,9.6,2201.72,0.08,55,0.1,122.32,24,31,10,13,0
0,1,0,0,1,1,1,0.0,0.0,0.0,0.0,3,0.0,0.0,0,3,0,0,0
0,1,0,0,1,1,1,0.0,0.0,0.0,0.0,3,0.0,0.0,0,3,0,0,0
0,1,0,0,1,1,1,0.0,0.0,0.0,0.0,2,0.0,0.0,0,2,0,0,0
0,1,0,0,1,1,1,0.0,0.0,0.0,0.0,2,0.0,0.0,0,2,0,0,0
27,1,8,4,1,1,1,112.99,8.79,8721.35,0.33,175,0.11,484.52,82,93,42,35,0
27,1,8,4,1,1,1,112.99,8.79,8721.35,0.33,175,0.11,484.52,82,93,42,35,0
0,1,0,0,1,1,1,5.33,1.5,12.0,0.0,4,0.67,0.67,1,3,1,0,0
0,1,0,0,1,1,1,5.33,1.5,12.0,0.0,4,0.67,0.67,1,3,1,0,0
0,1,0,0,1,1,1,5.33,1.5,12.0,0.0,4,0.67,0.67,1,3,1,0,0
0,1,0,0,1,1,1,5.33,1.5,12.0,0.0,4,0.67,0.67,1,3,1,0,0
2,1,0,0,1,1,1,7.35,8.0,470.48,0.02,17,0.13,26.14,6,11,3,2,0
2,1,0,0,1,1,1,7.81,9.0,632.78,0.02,19,0.11,35.15,8,11,4,2,0
0,1,0,0,1,1,1,0.0,0.0,0.0,0.0,1,0.0,0.0,0,1,0,0,0
0,1,0,0,1,1,1,0.0,0.0,0.0,0.0,1,0.0,0.0,0,1,0,0,0
0,1,0,0,1,1,1,7.74,1.5,17.41,0.0,5,0.67,0.97,2,3,2,0,0
0,1,0,0,1,1,1,7.74,1.5,17.41,0.0,5,0.67,0.97,2,3,2,0,0
0,1,0,0,1,1,1,7.74,1.5,17.41,0.0,5,0.67,0.97,2,3,2,0,0
0,1,0,0,1,1,1,7.74,1.5,17.41,0.0,5,0.67,0.97,2,3,2,0,0
0,1,0,0,1,1,1,5.33,1.5,12.0,0.0,4,0.67,0.67,1,3,1,0,0
0,1,0,0,1,1,1,5.33,1.5,12.0,0.0,4,0.67,0.67,1,3,1,0,0
0,1,0,0,1,1,1,5.33,1.5,12.0,0.0,4,0.67,0.67,1,3,1,0,0
0,1,0,0,1,1,1,5.33,1.5,12.0,0.0,4,0.67,0.67,1,3,1,0,0
0,1,0,0,1,1,1,5.33,1.5,12.0,0.0,4,0.67,0.67,1,3,1,0,0
0,1,0,0,1,1,1,5.33,1.5,12.0,0.0,4,0.67,0.67,1,3,1,0,0
0,1,0,0,1,1,1,5.33,1.5,12.0,0.0,4,0.67,0.67,1,3,1,0,0
0,1,0,0,1,1,1,5.33,1.5,12.0,0.0,4,0.67,0.67,1,3,1,0,0
0,1,0,0,1,1,1,5.33,1.5,12.0,0.0,4,0.67,0.67,1,3,1,0,0
0,1,0,0,1,1,1,5.33,1.5,12.0,0.0,4,0.67,0.67,1,3,1,0,0
0,1,0,0,1,1,1,5.33,1.5,12.0,0.0,4,0.67,0.67,1,3,1,0,0
0,1,0,0,1,1,1,5.33,1.5,12.0,0.0,4,0.67,0.67,1,3,1,0,0
0,1,0,0,1,1,1,5.33,1.5,12.0,0.0,4,0.67,0.67,1,3,1,0,0
0,1,0,0,1,1,1,5.33,1.5,12.0,0.0,4,0.67,0.67,1,3,1,0,0
0,1,0,0,1,1,1,5.33,1.5,12.0,0.0,4,0.67,0.67,1,3,1,0,0
0,1,0,0,1,1,1,5.33,1.5,12.0,0.0,4,0.67,0.67,1,3,1,0,0
0,1,0,0,1,1,1,5.33,1.5,12.0,0.0,4,0.67,0.67,1,3,1,0,0
0,1,0,0,1,1,1,5.33,1.5,12.0,0.0,4,0.67,0.67,1,3,1,0,0
0,1,0,0,1,1,1,5.33,1.5,12.0,0.0,4,0.67,0.67,1,3,1,0,0
0,1,0,0,1,1,1,5.33,1.5,12.0,0.0,4,0.67,0.67,1,3,1,0,0
0,1,0,0,1,1,1,5.33,1.5,12.0,0.0,4,0.67,0.67,1,3,1,0,0
0,1,0,0,1,1,1,5.33,1.5,12.0,0.0,4,0.67,0.67,1,3,1,0,0
0,1,0,0,1,1,1,7.74,1.5,17.41,0.0,5,0.67,0.97,2,3,2,0,0
0,1,0,0,1,1,1,7.74,1.5,17.41,0.0,5,0.67,0.97,2,3,2,0,0
0,1,0,0,1,1,1,5.33,1.5,12.0,0.0,4,0.67,0.67,1,3,1,0,0
0,1,0,0,1,1,1,5.33,1.5,12.0,0.0,4,0.67,0.67,1,3,1,0,0
0,1,0,0,1,1,1,7.86,2.5,49.13,0.01,7,0.4,2.73,2,5,2,0,0
0,1,0,0,1,1,1,7.86,2.5,49.13,0.01,7,0.4,2.73,2,5,2,0,0
0,1,0,0,1,1,1,0.0,0.0,0.0,0.0,3,0.0,0.0,0,3,0,0,0
0,1,0,0,1,1,1,0.0,0.0,0.0,0.0,3,0.0,0.0,0,3,0,0,0
3,5,0,0,3,1,3,8.96,6.0,322.65,0.02,15,0.17,17.92,6,9,4,3,0
3,5,0,0,3,1,3,8.96,6.0,322.65,0.02,15,0.17,17.92,6,9,4,3,0
0,1,0,0,1,1,1,7.74,1.5,17.41,0.0,5,0.67,0.97,2,3,2,0,0
0,1,0,0,1,1,1,7.74,1.5,17.41,0.0,5,0.67,0.97,2,3,2,0,0
0,1,0,0,1,1,1,7.74,1.5,17.41,0.0,5,0.67,0.97,2,3,2,0,0
0,1,0,0,1,1,1,7.74,1.5,17.41,0.0,5,0.67,0.97,2,3,2,0,0
0,1,0,0,1,1,1,7.74,1.5,17.41,0.0,5,0.67,0.97,2,3,2,0,0
0,1,0,0,1,1,1,7.74,1.5,17.41,0.0,5,0.67,0.97,2,3,2,0,0
0,1,0,0,1,1,1,7.74,1.5,17.41,0.0,5,0.67,0.97,2,3,2,0,0
0,1,0,0,1,1,1,7.74,1.5,17.41,0.0,5,0.67,0.97,2,3,2,0,0
0,1,0,0,1,1,1,7.74,1.5,17.41,0.0,5,0.67,0.97,2,3,2,0,0
0,1,0,0,1,1,1,7.74,1.5,17.41,0.0,5,0.67,0.97,2,3,2,0,0
0,1,0,0,1,1,1,7.74,1.5,17.41,0.0,5,0.67,0.97,2,3,2,0,0
0,1,0,0,1,1,1,7.74,1.5,17.41,0.0,5,0.67,0.97,2,3,2,0,0
0,1,0,0,1,1,1,7.74,1.5,17.41,0.0,5,0.67,0.97,2,3,2,0,0
0,1,0,0,1,1,1,7.74,1.5,17.41,0.0,5,0.67,0.97,2,3,2,0,0
0,1,0,0,1,1,1,5.33,1.5,12.0,0.0,4,0.67,0.67,1,3,1,0,0
0,1,0,0,1,1,1,5.33,1.5,12.0,0.0,4,0.67,0.67,1,3,1,0,0
0,1,0,0,1,1,1,0.0,0.0,0.0,0.0,3,0.0,0.0,0,3,0,0,0
0,1,0,0,1,1,1,0.0,0.0,0.0,0.0,2,0.0,0.0,0,2,0,0,0
0,1,0,0,1,1,1,5.33,1.5,12.0,0.0,4,0.67,0.67,1,3,1,0,0
0,1,0,0,1,1,1,5.33,1.5,12.0,0.0,4,0.67,0.67,1,3,1,0,0
3,3,0,1,2,2,1,8.1,3.33,90.0,0.01,9,0.3,5.0,4,5,3,3,0
3,3,0,1,2,2,1,8.1,3.33,90.0,0.01,9,0.3,5.0,4,5,3,3,0
13,1,1,3,1,1,1,51.96,6.18,1982.32,0.11,70,0.16,110.13,30,40,17,14,0
13,1,1,3,1,1,1,51.96,6.18,1982.32,0.11,70,0.16,110.13,30,40,17,14,0
0,1,0,0,1,1,1,5.33,1.5,12.0,0.0,4,0.67,0.67,1,3,1,0,0
0,1,0,0,1,1,1,7.74,1.5,17.41,0.0,5,0.67,0.97,2,3,2,0,0
2,1,0,0,1,1,1,7.35,8.0,470.48,0.02,17,0.13,26.14,6,11,3,2,0
2,1,0,0,1,1,1,7.81,9.0,632.78,0.02,19,0.11,35.15,8,11,4,2,0
0,1,0,0,1,1,1,0.0,0.0,0.0,0.0,1,0.0,0.0,0,1,0,0,0
0,1,0,0,1,1,1,7.74,1.5,17.41,0.0,5,0.67,0.97,2,3,2,0,0
0,1,0,0,1,1,1,5.33,1.5,12.0,0.0,4,0.67,0.67,1,3,1,0,0
0,1,0,0,1,1,1,7.74,1.5,17.41,0.0,5,0.67,0.97,2,3,2,0,0
0,1,0,0,1,1,1,7.74,1.5,17.41,0.0,5,0.67,0.97,2,3,2,0,0
0,1,0,0,1,1,1,7.74,1.5,17.41,0.0,5,0.67,0.97,2,3,2,0,0
0,1,0,0,1,1,1,7.74,1.5,17.41,0.0,5,0.67,0.97,2,3,2,0,0
0,1,0,0,1,1,1,5.33,1.5,12.0,0.0,4,0.67,0.67,1,3,1,0,0
0,1,0,0,1,1,1,5.33,1.5,12.0,0.0,4,0.67,0.67,1,3,1,0,0
0,1,0,0,1,1,1,5.33,1.5,12.0,0.0,4,0.67,0.67,1,3,1,0,0
0,1,0,0,1,1,1,5.33,1.5,12.0,0.0,4,0.67,0.67,1,3,1,0,0
0,1,0,0,1,1,1,5.33,1.5,12.0,0.0,4,0.67,0.67,1,3,1,0,0
0,1,0,0,1,1,1,5.33,1.5,12.0,0.0,4,0.67,0.67,1,3,1,0,0
0,1,0,0,1,1,1,5.33,1.5,12.0,0.0,4,0.67,0.67,1,3,1,0,0
0,1,0,0,1,1,1,5.33,1.5,12.0,0.0,4,0.67,0.67,1,3,1,0,0
0,1,0,0,1,1,1,5.33,1.5,12.0,0.0,4,0.67,0.67,1,3,1,0,0
0,1,0,0,1,1,1,5.8,2.0,23.22,0.0,5,0.5,1.29,1,4,1,0,0
0,1,0,0,1,1,1,5.33,1.5,12.0,0.0,4,0.67,0.67,1,3,1,0,0
0,1,0,0,1,1,1,5.33,1.5,12.0,0.0,4,0.67,0.67,1,3,1,0,0
0,1,0,0,1,1,1,5.33,1.5,12.0,0.0,4,0.67,0.67,1,3,1,0,0
0,1,0,0,1,1,1,5.33,1.5,12.0,0.0,4,0.67,0.67,1,3,1,0,0
0,1,0,0,1,1,1,5.33,1.5,12.0,0.0,4,0.67,0.67,1,3,1,0,0
0,1,0,0,1,1,1,5.33,1.5,12.0,0.0,4,0.67,0.67,1,3,1,0,0
7,3,0,0,2,2,1,16.76,8.13,1106.31,0.05,31,0.12,61.46,10,21,8,7,0
7,3,0,0,2,2,1,16.76,8.13,1106.31,0.05,31,0.12,61.46,10,21,8,7,0
0,1,0,0,1,1,1,7.74,1.5,17.41,0.0,5,0.67,0.97,2,3,2,0,0
0,1,0,0,1,1,1,5.33,1.5,12.0,0.0,4,0.67,0.67,1,3,1,0,0
0,1,0,0,1,1,1,7.86,2.5,49.13,0.01,7,0.4,2.73,2,5,2,0,0
0,1,0,0,1,1,1,0.0,0.0,0.0,0.0,3,0.0,0.0,0,3,0,0,0
0,1,0,0,1,1,1,7.74,1.5,17.41,0.0,5,0.67,0.97,2,3,2,0,0
0,1,0,0,1,1,1,4.75,1.0,4.75,0.0,3,1.0,0.26,1,2,1,0,0
0,1,0,0,1,1,1,7.74,1.5,17.41,0.0,5,0.67,0.97,2,3,2,0,0
0,1,0,0,1,1,1,7.74,1.5,17.41,0.0,5,0.67,0.97,2,3,2,0,0
0,1,0,0,1,1,1,7.74,1.5,17.41,0.0,5,0.67,0.97,2,3,2,0,0
0,1,0,0,1,1,1,7.74,1.5,17.41,0.0,5,0.67,0.97,2,3,2,0,0
0,1,0,0,1,1,1,7.74,1.5,17.41,0.0,5,0.67,0.97,2,3,2,0,0
0,1,0,0,1,1,1,7.74,1.5,17.41,0.0,5,0.67,0.97,2,3,2,0,0
0,1,0,0,1,1,1,5.33,1.5,12.0,0.0,4,0.67,0.67,1,3,1,0,0
1,1,0,1,1,1,1,0.0,0.0,0.0,0.0,1,0.0,0.0,0,1,0,1,0
1,1,0,1,1,1,1,0.0,0.0,0.0,0.0,1,0.0,0.0,0,1,0,1,0
3,1,1,0,1,1,1,16.21,2.25,82.12,0.01,13,0.44,4.56,6,7,4,4,0
3,1,1,0,1,1,1,16.21,2.25,82.12,0.01,13,0.44,4.56,6,7,4,4,0
0,1,0,0,1,1,1,5.33,1.5,12.0,0.0,4,0.67,0.67,1,3,1,0,0
0,1,0,0,1,1,1,5.33,1.5,12.0,0.0,4,0.67,0.67,1,3,1,0,0
0,1,0,0,1,1,1,7.74,1.5,17.41,0.0,5,0.67,0.97,2,3,2,0,0
0,1,0,0,1,1,1,7.74,1.5,17.41,0.0,5,0.67,0.97,2,3,2,0,0
0,1,0,0,1,1,1,5.33,1.5,12.0,0.0,4,0.67,0.67,1,3,1,0,0
0,1,0,0,1,1,1,5.33,1.5,12.0,0.0,4,0.67,0.67,1,3,1,0,0
0,1,0,0,1,1,1,5.33,1.5,12.0,0.0,4,0.67,0.67,1,3,1,0,0
0,1,0,0,1,1,1,5.33,1.5,12.0,0.0,4,0.67,0.67,1,3,1,0,0
0,1,0,0,1,1,1,5.33,1.5,12.0,0.0,4,0.67,0.67,1,3,1,0,0
0,1,0,0,1,1,1,5.33,1.5,12.0,0.0,4,0.67,0.67,1,3,1,0,0
1,1,0,1,1,1,1,0.0,0.0,0.0,0.0,1,0.0,0.0,0,1,0,1,0
1,1,0,1,1,1,1,0.0,0.0,0.0,0.0,1,0.0,0.0,0,1,0,1,0
7,3,4,0,2,1,1,23.44,6.33,940.26,0.05,38,0.16,52.24,19,19,9,11,0
7,3,4,0,2,1,1,23.44,6.33,940.26,0.05,38,0.16,52.24,19,19,9,11,0
9,7,0,0,4,2,1,10.57,12.86,1747.72,0.05,32,0.08,97.1,15,17,7,9,0
9,7,0,0,4,2,1,10.57,12.86,1747.72,0.05,32,0.08,97.1,15,17,7,9,0
0,1,0,0,1,1,1,0.0,0.0,0.0,0.0,3,0.0,0.0,0,3,0,0,0
0,1,0,0,1,1,1,0.0,0.0,0.0,0.0,2,0.0,0.0,0,2,0,0,0
0,1,0,0,1,1,1,5.33,1.5,12.0,0.0,4,0.67,0.67,1,3,1,0,0
0,1,0,0,1,1,1,5.33,1.5,12.0,0.0,4,0.67,0.67,1,3,1,0,0
18,3,2,0,2,1,1,94.97,4.71,2110.57,0.15,88,0.21,117.25,44,44,28,20,0
18,3,2,0,2,1,1,94.97,4.71,2110.57,0.15,88,0.21,117.25,44,44,28,20,0
2,1,0,0,1,1,1,7.35,8.0,470.48,0.02,17,0.13,26.14,6,11,3,2,0
2,1,0,0,1,1,1,7.81,9.0,632.78,0.02,19,0.11,35.15,8,11,4,2,0
0,1,0,0,1,1,1,0.0,0.0,0.0,0.0,1,0.0,0.0,0,1,0,0,0
0,1,0,0,1,1,1,7.74,1.5,17.41,0.0,5,0.67,0.97,2,3,2,0,0
0,1,0,0,1,1,1,7.74,1.5,17.41,0.0,5,0.67,0.97,2,3,2,0,0
0,1,0,0,1,1,1,7.74,1.5,17.41,0.0,5,0.67,0.97,2,3,2,0,0
0,1,0,0,1,1,1,7.74,1.5,17.41,0.0,5,0.67,0.97,2,3,2,0,0
0,1,0,0,1,1,1,7.74,1.5,17.41,0.0,5,0.67,0.97,2,3,2,0,0
0,1,0,0,1,1,1,7.74,1.5,17.41,0.0,5,0.67,0.97,2,3,2,0,0
0,1,0,0,1,1,1,7.74,1.5,17.41,0.0,5,0.67,0.97,2,3,2,0,0
0,1,0,0,1,1,1,7.74,1.5,17.41,0.0,5,0.67,0.97,2,3,2,0,0
0,1,0,0,1,1,1,5.33,1.5,12.0,0.0,4,0.67,0.67,1,3,1,0,0
0,1,0,0,1,1,1,5.33,1.5,12.0,0.0,4,0.67,0.67,1,3,1,0,0
0,1,0,0,1,1,1,5.33,1.5,12.0,0.0,4,0.67,0.67,1,3,1,0,0
0,1,0,0,1,1,1,5.33,1.5,12.0,0.0,4,0.67,0.67,1,3,1,0,0
0,1,0,0,1,1,1,5.33,1.5,12.0,0.0,4,0.67,0.67,1,3,1,0,0
0,1,0,0,1,1,1,5.33,1.5,12.0,0.0,4,0.67,0.67,1,3,1,0,0
0,1,0,0,1,1,1,5.33,1.5,12.0,0.0,4,0.67,0.67,1,3,1,0,0
0,1,0,0,1,1,1,5.33,1.5,12.0,0.0,4,0.67,0.67,1,3,1,0,0
0,1,0,0,1,1,1,5.33,1.5,12.0,0.0,4,0.67,0.67,1,3,1,0,0
0,1,0,0,1,1,1,5.33,1.5,12.0,0.0,4,0.67,0.67,1,3,1,0,0
0,1,0,0,1,1,1,5.33,1.5,12.0,0.0,4,0.67,0.67,1,3,1,0,0
0,1,0,0,1,1,1,5.33,1.5,12.0,0.0,4,0.67,0.67,1,3,1,0,0
0,1,0,0,1,1,1,5.33,1.5,12.0,0.0,4,0.67,0.67,1,3,1,0,0
0,1,0,0,1,1,1,5.33,1.5,12.0,0.0,4,0.67,0.67,1,3,1,0,0
0,1,0,0,1,1,1,5.33,1.5,12.0,0.0,4,0.67,0.67,1,3,1,0,0
0,1,0,0,1,1,1,5.33,1.5,12.0,0.0,4,0.67,0.67,1,3,1,0,0
0,1,0,0,1,1,1,5.33,1.5,12.0,0.0,4,0.67,0.67,1,3,1,0,0
0,1,0,0,1,1,1,5.33,1.5,12.0,0.0,4,0.67,0.67,1,3,1,0,0
0,1,0,0,1,1,1,5.33,1.5,12.0,0.0,4,0.67,0.67,1,3,1,0,0
0,1,0,0,1,1,1,7.74,1.5,17.41,0.0,5,0.67,0.97,2,3,2,0,0
0,1,0,0,1,1,1,5.33,1.5,12.0,0.0,4,0.67,0.67,1,3,1,0,0
0,1,0,0,1,1,1,7.86,2.5,49.13,0.01,7,0.4,2.73,2,5,2,0,0
0,1,0,0,1,1,1,0.0,0.0,0.0,0.0,3,0.0,0.0,0,3,0,0,0
0,1,0,0,1,1,1,7.74,1.5,17.41,0.0,5,0.67,0.97,2,3,2,0,0
0,1,0,0,1,1,1,7.74,1.5,17.41,0.0,5,0.67,0.97,2,3,2,0,0
0,1,0,0,1,1,1,7.74,1.5,17.41,0.0,5,0.67,0.97,2,3,2,0,0
0,1,0,0,1,1,1,7.74,1.5,17.41,0.0,5,0.67,0.97,2,3,2,0,0
0,1,0,0,1,1,1,7.74,1.5,17.41,0.0,5,0.67,0.97,2,3,2,0,0
0,1,0,0,1,1,1,7.74,1.5,17.41,0.0,5,0.67,0.97,2,3,2,0,0
0,1,0,0,1,1,1,7.74,1.5,17.41,0.0,5,0.67,0.97,2,3,2,0,0
0,1,0,0,1,1,1,5.33,1.5,12.0,0.0,4,0.67,0.67,1,3,1,0,0
0,1,0,0,1,1,1,0.0,0.0,0.0,0.0,3,0.0,0.0,0,3,0,0,0
0,1,0,0,1,1,1,0.0,0.0,0.0,0.0,2,0.0,0.0,0,2,0,0,0
0,1,0,0,1,1,1,5.33,1.5,12.0,0.0,4,0.67,0.67,1,3,1,0,0
0,1,0,0,1,1,1,5.33,1.5,12.0,0.0,4,0.67,0.67,1,3,1,0,0
1,1,0,1,1,1,1,0.0,0.0,0.0,0.0,1,0.0,0.0,0,1,0,1,0
13,1,3,0,1,1,1,84.28,3.33,936.48,0.09,63,0.3,52.03,30,33,18,16,0
2,1,0,0,1,1,1,7.35,8.0,470.48,0.02,17,0.13,26.14,6,11,3,2,0
2,1,0,0,1,1,1,7.81,9.0,632.78,0.02,19,0.11,35.15,8,11,4,2,0
0,1,0,0,1,1,1,0.0,0.0,0.0,0.0,1,0.0,0.0,0,1,0,0,0
0,1,0,0,1,1,1,7.74,1.5,17.41,0.0,5,0.67,0.97,2,3,2,0,0
0,1,0,0,1,1,1,7.74,1.5,17.41,0.0,5,0.67,0.97,2,3,2,0,0
0,1,0,0,1,1,1,5.33,1.5,12.0,0.0,4,0.67,0.67,1,3,1,0,0
0,1,0,0,1,1,1,5.33,1.5,12.0,0.0,4,0.67,0.67,1,3,1,0,0
0,1,0,0,1,1,1,5.33,1.5,12.0,0.0,4,0.67,0.67,1,3,1,0,0
0,1,0,0,1,1,1,5.33,1.5,12.0,0.0,4,0.67,0.67,1,3,1,0,0
0,1,0,0,1,1,1,5.33,1.5,12.0,0.0,4,0.67,0.67,1,3,1,0,0
0,1,0,0,1,1,1,5.33,1.5,12.0,0.0,4,0.67,0.67,1,3,1,0,0
0,1,0,0,1,1,1,5.33,1.5,12.0,0.0,4,0.67,0.67,1,3,1,0,0
0,1,0,0,1,1,1,5.33,1.5,12.0,0.0,4,0.67,0.67,1,3,1,0,0
0,1,0,0,1,1,1,5.33,1.5,12.0,0.0,4,0.67,0.67,1,3,1,0,0
0,1,0,0,1,1,1,5.33,1.5,12.0,0.0,4,0.67,0.67,1,3,1,0,0
0,1,0,0,1,1,1,5.33,1.5,12.0,0.0,4,0.67,0.67,1,3,1,0,0
0,1,0,0,1,1,1,7.74,1.5,17.41,0.0,5,0.67,0.97,2,3,2,0,0
0,1,0,0,1,1,1,5.33,1.5,12.0,0.0,4,0.67,0.67,1,3,1,0,0
0,1,0,0,1,1,1,7.86,2.5,49.13,0.01,7,0.4,2.73,2,5,2,0,0
0,1,0,0,1,1,1,0.0,0.0,0.0,0.0,3,0.0,0.0,0,3,0,0,0
0,1,0,0,1,1,1,7.74,1.5,17.41,0.0,5,0.67,0.97,2,3,2,0,0
0,1,0,0,1,1,1,7.74,1.5,17.41,0.0,5,0.67,0.97,2,3,2,0,0
3,1,0,0,1,1,1,11.16,3.12,108.97,0.01,11,0.32,6.05,5,6,4,3,0
0,1,0,0,1,1,1,7.74,1.5,17.41,0.0,5,0.67,0.97,2,3,2,0,0
0,1,0,0,1,1,1,7.74,1.5,17.41,0.0,5,0.67,0.97,2,3,2,0,0
0,1,0,0,1,1,1,7.74,1.5,17.41,0.0,5,0.67,0.97,2,3,2,0,0
0,1,0,0,1,1,1,7.74,1.5,17.41,0.0,5,0.67,0.97,2,3,2,0,0
0,1,0,0,1,1,1,7.74,1.5,17.41,0.0,5,0.67,0.97,2,3,2,0,0
0,1,0,0,1,1,1,5.33,1.5,12.0,0.0,4,0.67,0.67,1,3,1,0,0
4,1,0,0,1,1,1,10.24,7.0,501.89,0.02,20,0.14,27.88,7,13,4,4,0
4,3,0,0,2,2,1,21.5,7.15,1099.18,0.05,35,0.14,61.07,13,22,10,4,0
8,3,0,0,2,2,1,23.46,10.29,2485.24,0.08,52,0.1,138.07,19,33,12,8,0
54,13,1,8,7,6,6,25.11,40.0,40181.42,0.33,184,0.03,2232.3,80,104,22,55,0
0,1,0,0,1,1,1,8.3,6.67,369.01,0.02,16,0.15,20.5,5,11,3,0,0
23,5,0,1,3,2,1,19.78,20.04,7940.87,0.13,80,0.05,441.16,33,47,14,23,0
0,1,0,0,1,1,1,8.6,7.5,483.97,0.02,18,0.13,26.89,5,13,3,0,0
19,5,0,3,3,3,1,19.07,10.91,2270.01,0.07,46,0.09,126.11,20,26,11,19,0
12,3,0,2,2,2,1,14.73,8.94,1176.94,0.04,31,0.11,65.39,13,18,8,12,0
12,9,0,0,5,3,3,17.46,16.55,4779.2,0.1,63,0.06,265.51,28,35,11,12,0
4,1,0,0,1,1,1,9.47,2.67,67.38,0.01,9,0.38,3.74,4,5,3,4,0
13,5,0,0,3,3,1,16.4,7.07,820.29,0.04,29,0.14,45.57,11,18,7,13,0
13,5,0,0,3,3,1,17.24,7.5,969.51,0.04,31,0.13,53.86,12,19,8,13,0
4,3,0,0,2,2,1,11.99,6.67,533.03,0.03,21,0.15,29.61,10,11,6,4,0
0,1,0,0,1,1,1,6.55,3.0,58.95,0.01,7,0.33,3.28,1,6,1,0,0
0,3,0,0,2,2,1,6.69,7.5,376.42,0.02,14,0.13,20.91,5,9,3,0,0
0,1,0,0,1,1,1,7.86,2.5,49.13,0.01,7,0.4,2.73,2,5,2,0,0
0,3,0,0,2,2,1,9.32,5.0,233.02,0.02,13,0.2,12.95,5,8,4,0,0
6,1,0,0,1,1,1,17.51,5.0,437.85,0.03,23,0.2,24.32,10,13,7,6,0
0,3,0,0,2,2,1,7.75,2.0,31.02,0.01,6,0.5,1.72,2,4,2,0,0
0,3,0,0,2,2,1,7.86,2.5,49.13,0.01,7,0.4,2.73,2,5,2,0,0
11,7,0,0,4,2,3,12.35,16.0,3162.47,0.07,45,0.06,175.69,16,29,7,11,0
3,3,0,0,2,2,1,14.28,4.0,228.44,0.02,15,0.25,12.69,6,9,6,3,0
0,1,0,0,1,1,1,0.0,0.0,0.0,0.0,1,0.0,0.0,0,1,0,0,0
2,1,0,0,1,1,1,13.5,2.0,54.0,0.01,9,0.5,3.0,4,5,4,2,0
0,1,0,0,1,1,1,7.75,2.0,31.02,0.01,6,0.5,1.72,2,4,2,0,0
0,1,0,0,1,1,1,7.75,2.0,31.02,0.01,6,0.5,1.72,2,4,2,0,0
0,1,0,0,1,1,1,7.75,2.0,31.02,0.01,6,0.5,1.72,2,4,2,0,0
0,1,0,0,1,1,1,7.74,1.5,17.41,0.0,5,0.67,0.97,2,3,2,0,0
1,1,0,0,1,1,1,7.74,1.5,17.41,0.0,5,0.67,0.97,2,3,2,1,0
0,1,0,0,1,1,1,5.8,2.0,23.22,0.0,5,0.5,1.29,1,4,1,0,0
2,1,0,0,1,1,1,7.75,2.0,31.02,0.01,6,0.5,1.72,2,4,2,2,0
1,1,0,1,1,1,1,0.0,0.0,0.0,0.0,1,0.0,0.0,0,1,0,1,0
2,1,0,0,1,1,1,7.75,2.0,31.02,0.01,6,0.5,1.72,2,4,2,2,0
0,1,0,0,1,1,1,9.31,2.5,58.16,0.01,9,0.4,3.23,1,8,1,0,0
2,1,0,1,1,1,1,5.33,1.5,12.0,0.0,4,0.67,0.67,1,3,1,2,0
0,1,0,0,1,1,1,7.75,2.0,31.02,0.01,6,0.5,1.72,2,4,2,0,0
0,1,0,0,1,1,1,10.68,4.67,232.53,0.02,15,0.21,12.92,4,11,3,0,0
7,5,0,0,3,2,1,11.89,13.13,2048.55,0.05,35,0.08,113.81,15,20,8,7,0
5,3,0,0,2,2,1,17.22,4.08,287.09,0.02,19,0.24,15.95,7,12,6,5,0
4,3,0,0,2,2,1,11.18,5.63,353.85,0.02,17,0.18,19.66,5,12,4,4,0
0,1,0,0,1,1,1,0.0,0.0,0.0,0.0,0,0.0,0.0,0,0,0,0,0
0,1,0,0,1,1,1,5.33,1.5,12.0,0.0,4,0.67,0.67,1,3,1,0,0
0,1,0,0,1,1,1,0.0,0.0,0.0,0.0,0,0.0,0.0,0,0,0,0,0
0,1,0,0,1,1,1,5.33,1.5,12.0,0.0,4,0.67,0.67,1,3,1,0,0
0,1,0,0,1,1,1,0.0,0.0,0.0,0.0,0,0.0,0.0,0,0,0,0,0
0,1,0,0,1,1,1,5.33,1.5,12.0,0.0,4,0.67,0.67,1,3,1,0,0
0,1,0,0,1,1,1,0.0,0.0,0.0,0.0,1,0.0,0.0,0,1,0,0,0
0,1,0,0,1,1,1,0.0,0.0,0.0,0.0,0,0.0,0.0,0,0,0,0,0
0,1,0,0,1,1,1,5.33,1.5,12.0,0.0,4,0.67,0.67,1,3,1,0,0
0,1,0,0,1,1,1,5.33,1.5,12.0,0.0,4,0.67,0.67,1,3,1,0,0
0,1,0,0,1,1,1,5.33,1.5,12.0,0.0,4,0.67,0.67,1,3,1,0,0
0,1,0,0,1,1,1,5.33,1.5,12.0,0.0,4,0.67,0.67,1,3,1,0,0
0,1,0,0,1,1,1,5.33,1.5,12.0,0.0,4,0.67,0.67,1,3,1,0,0
0,1,0,0,1,1,1,9.51,3.0,85.59,0.01,9,0.33,4.75,3,6,3,0,0
0,1,0,0,1,1,1,5.33,1.5,12.0,0.0,4,0.67,0.67,1,3,1,0,0
0,1,0,0,1,1,1,5.33,1.5,12.0,0.0,4,0.67,0.67,1,3,1,0,0
0,1,0,0,1,1,1,5.33,1.5,12.0,0.0,4,0.67,0.67,1,3,1,0,0
0,1,0,0,1,1,1,6.2,2.5,38.77,0.01,6,0.4,2.15,1,5,1,0,0
0,1,0,0,1,1,1,5.33,1.5,12.0,0.0,4,0.67,0.67,1,3,1,0,0
0,1,0,0,1,1,1,0.0,0.0,0.0,0.0,1,0.0,0.0,0,1,0,0,0
0,1,0,0,1,1,1,0.0,0.0,0.0,0.0,1,0.0,0.0,0,1,0,0,0
0,1,0,0,1,1,1,5.33,1.5,12.0,0.0,4,0.67,0.67,1,3,1,0,0
0,1,0,0,1,1,1,0.0,0.0,0.0,0.0,3,0.0,0.0,0,3,0,0,0
0,1,0,0,1,1,1,0.0,0.0,0.0,0.0,2,0.0,0.0,0,2,0,0,0
0,1,0,0,1,1,1,5.33,1.5,12.0,0.0,4,0.67,0.67,1,3,1,0,0
0,1,0,0,1,1,1,0.0,0.0,0.0,0.0,1,0.0,0.0,0,1,0,0,0
0,1,0,0,1,1,1,0.0,0.0,0.0,0.0,0,0.0,0.0,0,0,0,0,0
0,1,0,0,1,1,1,5.33,1.5,12.0,0.0,4,0.67,0.67,1,3,1,0,0
0,1,0,0,1,1,1,7.74,1.5,17.41,0.0,5,0.67,0.97,2,3,2,0,0
0,1,0,0,1,1,1,5.33,1.5,12.0,0.0,4,0.67,0.67,1,3,1,0,0
0,1,0,0,1,1,1,5.33,1.5,12.0,0.0,4,0.67,0.67,1,3,1,0,0
0,1,0,0,1,1,1,5.33,1.5,12.0,0.0,4,0.67,0.67,1,3,1,0,0
0,1,0,0,1,1,1,7.74,1.5,17.41,0.0,5,0.67,0.97,2,3,2,0,0
0,1,0,0,1,1,1,5.33,1.5,12.0,0.0,4,0.67,0.67,1,3,1,0,0
0,1,0,0,1,1,1,7.74,1.5,17.41,0.0,5,0.67,0.97,2,3,2,0,0
5,1,0,1,1,1,1,26.94,2.0,107.78,0.02,17,0.5,5.99,8,9,6,5,0
3,1,0,0,1,1,1,9.51,3.0,85.59,0.01,9,0.33,4.75,3,6,3,3,0
5,3,0,0,2,2,1,15.36,3.5,188.21,0.02,15,0.29,10.46,5,10,5,5,0
4,3,0,0,2,2,1,10.88,5.6,341.29,0.02,17,0.18,18.96,8,9,5,4,0
0,1,0,0,1,1,1,7.74,1.5,17.41,0.0,5,0.67,0.97,2,3,2,0,0
2,1,0,0,1,1,1,7.35,8.0,470.48,0.02,17,0.13,26.14,6,11,3,2,0
0,1,0,0,1,1,1,12.68,2.5,79.25,0.01,10,0.4,4.4,4,6,4,0,0
0,1,0,0,1,1,1,7.74,1.5,17.41,0.0,5,0.67,0.97,2,3,2,0,0
0,1,0,0,1,1,1,7.75,2.0,31.02,0.01,6,0.5,1.72,2,4,2,0,0
0,1,0,0,1,1,1,7.75,2.0,31.02,0.01,6,0.5,1.72,2,4,2,0,0
0,1,0,0,1,1,1,7.75,2.0,31.02,0.01,6,0.5,1.72,2,4,2,0,0
0,1,0,0,1,1,1,7.75,2.0,31.02,0.01,6,0.5,1.72,2,4,2,0,0
2,1,0,0,1,1,1,7.81,9.0,632.78,0.02,19,0.11,35.15,8,11,4,2,0
0,1,0,0,1,1,1,11.86,3.5,145.3,0.01,12,0.29,8.07,4,8,4,0,0
0,1,0,0,1,1,1,0.0,0.0,0.0,0.0,0,0.0,0.0,0,0,0,0,0
0,1,0,0,1,1,1,0.0,0.0,0.0,0.0,0,0.0,0.0,0,0,0,0,0
0,1,0,0,1,1,1,0.0,0.0,0.0,0.0,0,0.0,0.0,0,0,0,0,0
0,1,0,0,1,1,1,0.0,0.0,0.0,0.0,1,0.0,0.0,0,1,0,0,0
0,1,0,0,1,1,1,5.33,1.5,12.0,0.0,4,0.67,0.67,1,3,1,0,0
0,1,0,0,1,1,1,7.74,1.5,17.41,0.0,5,0.67,0.97,2,3,2,0,0
0,1,0,0,1,1,1,7.33,4.5,148.5,0.01,11,0.22,8.25,3,8,2,0,0
0,1,0,0,1,1,1,5.33,1.5,12.0,0.0,4,0.67,0.67,1,3,1,0,0
0,1,0,0,1,1,1,5.33,1.5,12.0,0.0,4,0.67,0.67,1,3,1,0,0
0,1,0,0,1,1,1,5.33,1.5,12.0,0.0,4,0.67,0.67,1,3,1,0,0
8,3,0,0,2,1,1,15.07,9.75,1432.72,0.05,34,0.1,79.6,13,21,8,8,0
0,1,0,0,1,1,1,7.74,1.5,17.41,0.0,5,0.67,0.97,2,3,2,0,0
0,1,0,0,1,1,1,16.5,2.0,66.0,0.01,11,0.5,3.67,4,7,4,0,0
0,1,0,0,1,1,1,5.33,1.5,12.0,0.0,4,0.67,0.67,1,3,1,0,0
0,1,0,0,1,1,1,16.5,2.0,66.0,0.01,11,0.5,3.67,4,7,4,0,0
0,1,0,0,1,1,1,5.33,1.5,12.0,0.0,4,0.67,0.67,1,3,1,0,0
0,1,0,0,1,1,1,5.33,1.5,12.0,0.0,4,0.67,0.67,1,3,1,0,0
0,1,0,0,1,1,1,16.5,2.0,66.0,0.01,11,0.5,3.67,4,7,4,0,0
0,1,0,0,1,1,1,5.33,1.5,12.0,0.0,4,0.67,0.67,1,3,1,0,0
0,1,0,0,1,1,1,7.74,1.5,17.41,0.0,5,0.67,0.97,2,3,2,0,0
0,1,0,0,1,1,1,7.74,1.5,17.41,0.0,5,0.67,0.97,2,3,2,0,0
0,1,0,0,1,1,1,16.84,1.5,37.9,0.01,9,0.67,2.11,4,5,4,0,0
0,1,0,0,1,1,1,7.74,1.5,17.41,0.0,5,0.67,0.97,2,3,2,0,0
0,1,0,0,1,1,1,16.84,1.5,37.9,0.01,9,0.67,2.11,4,5,4,0,0
0,1,0,0,1,1,1,7.74,1.5,17.41,0.0,5,0.67,0.97,2,3,2,0,0
0,1,0,0,1,1,1,5.33,1.5,12.0,0.0,4,0.67,0.67,1,3,1,0,0
0,1,0,0,1,1,1,5.33,1.5,12.0,0.0,4,0.67,0.67,1,3,1,0,0
0,1,0,0,1,1,1,7.74,1.5,17.41,0.0,5,0.67,0.97,2,3,2,0,0
0,1,0,0,1,1,1,9.6,2.5,60.0,0.01,8,0.4,3.33,3,5,3,0,0
0,1,0,0,1,1,1,7.75,2.0,31.02,0.01,6,0.5,1.72,2,4,2,0,0
0,1,0,0,1,1,1,6.86,3.5,84.0,0.01,8,0.29,4.67,1,7,1,0,0
0,1,0,0,1,1,1,7.86,2.5,49.13,0.01,7,0.4,2.73,2,5,2,0,0
0,1,0,0,1,1,1,7.75,2.0,31.02,0.01,6,0.5,1.72,2,4,2,0,0
0,1,0,0,1,1,1,8.3,6.0,298.97,0.02,15,0.17,16.61,3,12,2,0,0
0,1,0,0,1,1,1,8.3,6.0,298.97,0.02,15,0.17,16.61,3,12,2,0,0
0,1,0,0,1,1,1,8.3,6.0,298.97,0.02,15,0.17,16.61,3,12,2,0,0
0,1,0,0,1,1,1,5.33,1.5,12.0,0.0,4,0.67,0.67,1,3,1,0,0
0,1,0,0,1,1,1,5.33,1.5,12.0,0.0,4,0.67,0.67,1,3,1,0,0
0,1,0,0,1,1,1,5.33,1.5,12.0,0.0,4,0.67,0.67,1,3,1,0,0
0,1,0,0,1,1,1,5.33,1.5,12.0,0.0,4,0.67,0.67,1,3,1,0,0
0,1,0,0,1,1,1,5.33,1.5,12.0,0.0,4,0.67,0.67,1,3,1,0,0
0,1,0,0,1,1,1,0.0,0.0,0.0,0.0,0,0.0,0.0,0,0,0,0,0
0,1,0,0,1,1,1,5.33,1.5,12.0,0.0,4,0.67,0.67,1,3,1,0,0
0,1,0,0,1,1,1,5.33,1.5,12.0,0.0,4,0.67,0.67,1,3,1,0,0
0,1,0,0,1,1,1,5.33,1.5,12.0,0.0,4,0.67,0.67,1,3,1,0,0
0,1,0,0,1,1,1,5.33,1.5,12.0,0.0,4,0.67,0.67,1,3,1,0,0
0,1,0,0,1,1,1,5.33,1.5,12.0,0.0,4,0.67,0.67,1,3,1,0,0
0,1,0,0,1,1,1,5.33,1.5,12.0,0.0,4,0.67,0.67,1,3,1,0,0
0,1,0,0,1,1,1,5.33,1.5,12.0,0.0,4,0.67,0.67,1,3,1,0,0
0,1,0,0,1,1,1,5.33,1.5,12.0,0.0,4,0.67,0.67,1,3,1,0,0
0,1,0,0,1,1,1,5.33,1.5,12.0,0.0,4,0.67,0.67,1,3,1,0,0
0,1,0,0,1,1,1,5.33,1.5,12.0,0.0,4,0.67,0.67,1,3,1,0,0
0,1,0,0,1,1,1,5.33,1.5,12.0,0.0,4,0.67,0.67,1,3,1,0,0
0,1,0,0,1,1,1,5.33,1.5,12.0,0.0,4,0.67,0.67,1,3,1,0,0
0,1,0,0,1,1,1,5.33,1.5,12.0,0.0,4,0.67,0.67,1,3,1,0,0
0,1,0,0,1,1,1,5.33,1.5,12.0,0.0,4,0.67,0.67,1,3,1,0,0
0,1,0,0,1,1,1,5.33,1.5,12.0,0.0,4,0.67,0.67,1,3,1,0,0
0,1,0,0,1,1,1,5.33,1.5,12.0,0.0,4,0.67,0.67,1,3,1,0,0
0,1,0,0,1,1,1,5.33,1.5,12.0,0.0,4,0.67,0.67,1,3,1,0,0
0,1,0,0,1,1,1,5.33,1.5,12.0,0.0,4,0.67,0.67,1,3,1,0,0
0,1,0,0,1,1,1,5.33,1.5,12.0,0.0,4,0.67,0.67,1,3,1,0,0
0,1,0,0,1,1,1,5.33,1.5,12.0,0.0,4,0.67,0.67,1,3,1,0,0
0,1,0,0,1,1,1,5.33,1.5,12.0,0.0,4,0.67,0.67,1,3,1,0,0
0,1,0,0,1,1,1,5.33,1.5,12.0,0.0,4,0.67,0.67,1,3,1,0,0
0,1,0,0,1,1,1,6.2,2.5,38.77,0.01,6,0.4,2.15,1,5,1,0,0
0,1,0,0,1,1,1,5.33,1.5,12.0,0.0,4,0.67,0.67,1,3,1,0,0
0,1,0,0,1,1,1,5.8,2.0,23.22,0.0,5,0.5,1.29,1,4,1,0,0
0,1,0,0,1,1,1,5.33,1.5,12.0,0.0,4,0.67,0.67,1,3,1,0,0
0,1,0,0,1,1,1,5.33,1.5,12.0,0.0,4,0.67,0.67,1,3,1,0,0
0,1,0,0,1,1,1,5.33,1.5,12.0,0.0,4,0.67,0.67,1,3,1,0,0
0,1,0,0,1,1,1,5.33,1.5,12.0,0.0,4,0.67,0.67,1,3,1,0,0
0,1,0,0,1,1,1,5.33,1.5,12.0,0.0,4,0.67,0.67,1,3,1,0,0
0,1,0,0,1,1,1,5.33,1.5,12.0,0.0,4,0.67,0.67,1,3,1,0,0
0,1,0,0,1,1,1,5.33,1.5,12.0,0.0,4,0.67,0.67,1,3,1,0,0
0,1,0,0,1,1,1,5.33,1.5,12.0,0.0,4,0.67,0.67,1,3,1,0,0
0,1,0,0,1,1,1,5.33,1.5,12.0,0.0,4,0.67,0.67,1,3,1,0,0
0,1,0,0,1,1,1,5.33,1.5,12.0,0.0,4,0.67,0.67,1,3,1,0,0
0,1,0,0,1,1,1,5.33,1.5,12.0,0.0,4,0.67,0.67,1,3,1,0,0
0,1,0,0,1,1,1,5.33,1.5,12.0,0.0,4,0.67,0.67,1,3,1,0,0
0,1,0,0,1,1,1,5.33,1.5,12.0,0.0,4,0.67,0.67,1,3,1,0,0
0,1,0,0,1,1,1,5.33,1.5,12.0,0.0,4,0.67,0.67,1,3,1,0,0
0,1,0,0,1,1,1,5.33,1.5,12.0,0.0,4,0.67,0.67,1,3,1,0,0
0,1,0,0,1,1,1,7.75,2.0,31.02,0.01,6,0.5,1.72,2,4,2,0,0
0,1,0,0,1,1,1,7.75,2.0,31.02,0.01,6,0.5,1.72,2,4,2,0,0
0,1,0,0,1,1,1,5.33,1.5,12.0,0.0,4,0.67,0.67,1,3,1,0,0
0,1,0,0,1,1,1,7.75,2.0,31.02,0.01,6,0.5,1.72,2,4,2,0,0
0,1,0,0,1,1,1,7.75,2.0,31.02,0.01,6,0.5,1.72,2,4,2,0,0
0,1,0,0,1,1,1,7.86,2.5,49.13,0.01,7,0.4,2.73,2,5,2,0,0
0,1,0,0,1,1,1,5.33,1.5,12.0,0.0,4,0.67,0.67,1,3,1,0,0
0,3,0,0,2,1,1,7.75,2.0,31.02,0.01,6,0.5,1.72,2,4,2,0,0
0,1,0,0,1,1,1,5.8,2.0,23.22,0.0,5,0.5,1.29,1,4,1,0,0
0,3,0,0,2,1,1,7.75,2.0,31.02,0.01,6,0.5,1.72,2,4,2,0,0
0,1,0,0,1,1,1,5.33,1.5,12.0,0.0,4,0.67,0.67,1,3,1,0,0
0,1,0,0,1,1,1,12.18,3.0,109.62,0.01,11,0.33,6.09,4,7,4,0,0
0,1,0,0,1,1,1,7.75,2.0,31.02,0.01,6,0.5,1.72,2,4,2,0,0
0,1,0,0,1,1,1,7.75,2.0,31.02,0.01,6,0.5,1.72,2,4,2,0,0
0,1,0,0,1,1,1,7.75,2.0,31.02,0.01,6,0.5,1.72,2,4,2,0,0
0,1,0,0,1,1,1,0.0,0.0,0.0,0.0,0,0.0,0.0,0,0,0,0,0
0,1,0,0,1,1,1,5.33,1.5,12.0,0.0,4,0.67,0.67,1,3,1,0,0
0,1,0,0,1,1,1,5.8,2.0,23.22,0.0,5,0.5,1.29,1,4,1,0,0
0,1,0,0,1,1,1,7.75,2.0,31.02,0.01,6,0.5,1.72,2,4,2,0,0
2,1,0,0,1,1,1,8.98,2.5,56.15,0.01,8,0.4,3.12,2,6,2,2,0
2,1,0,0,1,1,1,5.33,1.5,12.0,0.0,4,0.67,0.67,1,3,1,2,0
0,1,0,0,1,1,1,5.33,1.5,12.0,0.0,4,0.67,0.67,1,3,1,0,0
2,1,0,0,1,1,1,5.33,1.5,12.0,0.0,4,0.67,0.67,1,3,1,2,0
2,1,0,0,1,1,1,5.33,1.5,12.0,0.0,4,0.67,0.67,1,3,1,2,0
3,1,0,0,1,1,1,12.0,2.5,75.0,0.01,10,0.4,4.17,3,7,3,3,0
0,1,0,0,1,1,1,7.86,2.5,49.13,0.01,7,0.4,2.73,2,5,2,0,0
0,1,0,0,1,1,1,6.55,3.0,58.95,0.01,7,0.33,3.28,1,6,1,0,0
0,1,0,0,1,1,1,6.55,3.0,58.95,0.01,7,0.33,3.28,1,6,1,0,0
2,1,0,0,1,1,1,8.98,2.5,56.15,0.01,8,0.4,3.12,2,6,2,2,0
2,1,0,0,1,1,1,5.33,1.5,12.0,0.0,4,0.67,0.67,1,3,1,2,0
0,1,0,0,1,1,1,5.33,1.5,12.0,0.0,4,0.67,0.67,1,3,1,0,0
2,1,0,0,1,1,1,5.33,1.5,12.0,0.0,4,0.67,0.67,1,3,1,2,0
2,1,0,0,1,1,1,5.33,1.5,12.0,0.0,4,0.67,0.67,1,3,1,2,0
0,1,0,0,1,1,1,5.33,1.5,12.0,0.0,4,0.67,0.67,1,3,1,0,0
0,1,0,0,1,1,1,5.33,1.5,12.0,0.0,4,0.67,0.67,1,3,1,0,0
0,1,0,0,1,1,1,7.86,2.5,49.13,0.01,7,0.4,2.73,2,5,2,0,0
0,1,0,0,1,1,1,0.0,0.0,0.0,0.0,3,0.0,0.0,0,3,0,0,0
0,1,0,0,1,1,1,7.75,2.0,31.02,0.01,6,0.5,1.72,2,4,2,0,0
0,1,0,0,1,1,1,9.0,3.0,81.0,0.01,9,0.33,4.5,2,7,2,0,0
0,1,0,0,1,1,1,8.3,6.0,298.97,0.02,15,0.17,16.61,3,12,2,0,0
0,1,0,0,1,1,1,7.74,1.5,17.41,0.0,5,0.67,0.97,2,3,2,0,0
0,1,0,0,1,1,1,6.89,3.0,62.04,0.01,8,0.33,3.45,3,5,2,0,0
0,1,0,0,1,1,1,7.74,1.5,17.41,0.0,5,0.67,0.97,2,3,2,0,0
0,1,0,0,1,1,1,6.89,3.0,62.04,0.01,8,0.33,3.45,3,5,2,0,0
0,1,0,0,1,1,1,6.89,3.0,62.04,0.01,8,0.33,3.45,3,5,2,0,0
0,1,0,0,1,1,1,6.89,3.0,62.04,0.01,8,0.33,3.45,3,5,2,0,0
0,1,0,0,1,1,1,6.89,3.0,62.04,0.01,8,0.33,3.45,3,5,2,0,0
0,1,0,0,1,1,1,7.74,1.5,17.41,0.0,5,0.67,0.97,2,3,2,0,0
0,1,0,0,1,1,1,7.74,1.5,17.41,0.0,5,0.67,0.97,2,3,2,0,0
0,1,0,0,1,1,1,4.75,1.0,4.75,0.0,3,1.0,0.26,1,2,1,0,0
0,1,0,0,1,1,1,7.74,1.5,17.41,0.0,5,0.67,0.97,2,3,2,0,0
0,1,0,0,1,1,1,7.74,1.5,17.41,0.0,5,0.67,0.97,2,3,2,0,0
0,1,0,0,1,1,1,7.74,1.5,17.41,0.0,5,0.67,0.97,2,3,2,0,0
0,1,0,0,1,1,1,6.89,3.0,62.04,0.01,8,0.33,3.45,3,5,2,0,0
0,1,0,0,1,1,1,6.89,3.0,62.04,0.01,8,0.33,3.45,3,5,2,0,0
0,1,0,0,1,1,1,7.74,1.5,17.41,0.0,5,0.67,0.97,2,3,2,0,0
0,1,0,0,1,1,1,7.74,1.5,17.41,0.0,5,0.67,0.97,2,3,2,0,0
0,1,0,0,1,1,1,7.74,1.5,17.41,0.0,5,0.67,0.97,2,3,2,0,0
0,1,0,0,1,1,1,7.74,1.5,17.41,0.0,5,0.67,0.97,2,3,2,0,0
0,1,0,0,1,1,1,7.74,1.5,17.41,0.0,5,0.67,0.97,2,3,2,0,0
0,1,0,0,1,1,1,7.74,1.5,17.41,0.0,5,0.67,0.97,2,3,2,0,0
0,1,0,0,1,1,1,9.47,2.67,67.38,0.01,9,0.38,3.74,4,5,3,0,0
0,1,0,0,1,1,1,7.74,1.5,17.41,0.0,5,0.67,0.97,2,3,2,0,0
0,1,0,0,1,1,1,7.74,1.5,17.41,0.0,5,0.67,0.97,2,3,2,0,0
0,1,0,0,1,1,1,7.74,1.5,17.41,0.0,5,0.67,0.97,2,3,2,0,0
0,1,0,0,1,1,1,7.74,1.5,17.41,0.0,5,0.67,0.97,2,3,2,0,0
0,1,0,0,1,1,1,7.74,1.5,17.41,0.0,5,0.67,0.97,2,3,2,0,0
0,1,0,0,1,1,1,7.74,1.5,17.41,0.0,5,0.67,0.97,2,3,2,0,0
0,1,0,0,1,1,1,7.74,1.5,17.41,0.0,5,0.67,0.97,2,3,2,0,0
0,1,0,0,1,1,1,7.74,1.5,17.41,0.0,5,0.67,0.97,2,3,2,0,0
0,1,0,0,1,1,1,7.74,1.5,17.41,0.0,5,0.67,0.97,2,3,2,0,0
0,1,0,0,1,1,1,6.89,3.0,62.04,0.01,8,0.33,3.45,3,5,2,0,0
0,1,0,0,1,1,1,6.89,3.0,62.04,0.01,8,0.33,3.45,3,5,2,0,0
0,1,0,0,1,1,1,9.51,3.0,85.59,0.01,9,0.33,4.75,3,6,3,0,0
0,1,0,0,1,1,1,9.51,3.0,85.59,0.01,9,0.33,4.75,3,6,3,0,0
0,1,0,0,1,1,1,9.51,3.0,85.59,0.01,9,0.33,4.75,3,6,3,0,0
0,1,0,0,1,1,1,9.51,3.0,85.59,0.01,9,0.33,4.75,3,6,3,0,0
4,3,0,0,2,2,1,13.67,6.0,492.27,0.03,21,0.17,27.35,6,15,5,4,0
0,1,0,0,1,1,1,7.74,1.5,17.41,0.0,5,0.67,0.97,2,3,2,0,0
0,1,0,0,1,1,1,5.33,1.5,12.0,0.0,4,0.67,0.67,1,3,1,0,0
0,1,0,0,1,1,1,5.8,2.0,23.22,0.0,5,0.5,1.29,1,4,1,0,0
3,3,0,0,2,2,1,9.6,2.5,60.0,0.01,8,0.4,3.33,3,5,3,3,0
3,3,0,0,2,2,1,9.6,2.5,60.0,0.01,8,0.4,3.33,3,5,3,3,0
0,1,0,0,1,1,1,5.33,1.5,12.0,0.0,4,0.67,0.67,1,3,1,0,0
0,1,0,0,1,1,1,7.74,1.5,17.41,0.0,5,0.67,0.97,2,3,2,0,0
1,1,0,0,1,1,1,0.0,0.0,0.0,0.0,1,0.0,0.0,0,1,0,1,0
1,1,0,0,1,1,1,0.0,0.0,0.0,0.0,1,0.0,0.0,0,1,0,1,0
2,1,0,0,1,1,1,7.35,8.0,470.48,0.02,17,0.13,26.14,6,11,3,2,0
2,1,0,0,1,1,1,7.81,9.0,632.78,0.02,19,0.11,35.15,8,11,4,2,0
0,1,0,0,1,1,1,7.74,1.5,17.41,0.0,5,0.67,0.97,2,3,2,0,0
0,1,0,0,1,1,1,7.74,1.5,17.41,0.0,5,0.67,0.97,2,3,2,0,0
0,1,0,0,1,1,1,7.74,1.5,17.41,0.0,5,0.67,0.97,2,3,2,0,0
0,1,0,0,1,1,1,7.74,1.5,17.41,0.0,5,0.67,0.97,2,3,2,0,0
0,1,0,0,1,1,1,7.86,2.5,49.13,0.01,7,0.4,2.73,2,5,2,0,0
0,1,0,0,1,1,1,7.86,2.5,49.13,0.01,7,0.4,2.73,2,5,2,0,0
0,1,0,0,1,1,1,5.33,1.5,12.0,0.0,4,0.67,0.67,1,3,1,0,0
0,1,0,0,1,1,1,5.33,1.5,12.0,0.0,4,0.67,0.67,1,3,1,0,0
0,1,0,0,1,1,1,5.33,1.5,12.0,0.0,4,0.67,0.67,1,3,1,0,0
0,1,0,0,1,1,1,5.33,1.5,12.0,0.0,4,0.67,0.67,1,3,1,0,0
0,1,0,0,1,1,1,5.33,1.5,12.0,0.0,4,0.67,0.67,1,3,1,0,0
0,1,0,0,1,1,1,5.33,1.5,12.0,0.0,4,0.67,0.67,1,3,1,0,0
0,1,0,0,1,1,1,5.33,1.5,12.0,0.0,4,0.67,0.67,1,3,1,0,0
0,1,0,0,1,1,1,6.2,2.5,38.77,0.01,6,0.4,2.15,1,5,1,0,0
0,1,0,0,1,1,1,6.2,2.5,38.77,0.01,6,0.4,2.15,1,5,1,0,0
0,1,0,0,1,1,1,5.33,1.5,12.0,0.0,4,0.67,0.67,1,3,1,0,0
0,1,0,0,1,1,1,5.33,1.5,12.0,0.0,4,0.67,0.67,1,3,1,0,0
0,1,0,0,1,1,1,5.33,1.5,12.0,0.0,4,0.67,0.67,1,3,1,0,0
0,1,0,0,1,1,1,5.33,1.5,12.0,0.0,4,0.67,0.67,1,3,1,0,0
0,1,0,0,1,1,1,5.33,1.5,12.0,0.0,4,0.67,0.67,1,3,1,0,0
0,1,0,0,1,1,1,5.33,1.5,12.0,0.0,4,0.67,0.67,1,3,1,0,0
0,1,0,0,1,1,1,0.0,0.0,0.0,0.0,3,0.0,0.0,0,3,0,0,0
0,1,0,0,1,1,1,0.0,0.0,0.0,0.0,2,0.0,0.0,0,2,0,0,0
0,1,0,0,1,1,1,5.33,1.5,12.0,0.0,4,0.67,0.67,1,3,1,0,0
0,1,0,0,1,1,1,5.33,1.5,12.0,0.0,4,0.67,0.67,1,3,1,0,0
0,1,0,0,1,1,1,0.0,0.0,0.0,0.0,1,0.0,0.0,0,1,0,0,0
2,1,0,0,1,1,1,7.35,8.0,470.48,0.02,17,0.13,26.14,6,11,3,2,0
2,1,0,0,1,1,1,7.81,9.0,632.78,0.02,19,0.11,35.15,8,11,4,2,0
0,1,0,0,1,1,1,7.74,1.5,17.41,0.0,5,0.67,0.97,2,3,2,0,0
0,1,0,0,1,1,1,7.74,1.5,17.41,0.0,5,0.67,0.97,2,3,2,0,0
0,1,0,0,1,1,1,5.33,1.5,12.0,0.0,4,0.67,0.67,1,3,1,0,0
0,1,0,0,1,1,1,5.33,1.5,12.0,0.0,4,0.67,0.67,1,3,1,0,0
0,1,0,0,1,1,1,5.33,1.5,12.0,0.0,4,0.67,0.67,1,3,1,0,0
0,1,0,0,1,1,1,5.33,1.5,12.0,0.0,4,0.67,0.67,1,3,1,0,0
0,1,0,0,1,1,1,5.33,1.5,12.0,0.0,4,0.67,0.67,1,3,1,0,0
0,1,0,0,1,1,1,5.33,1.5,12.0,0.0,4,0.67,0.67,1,3,1,0,0
0,1,0,0,1,1,1,5.33,1.5,12.0,0.0,4,0.67,0.67,1,3,1,0,0
0,1,0,0,1,1,1,5.33,1.5,12.0,0.0,4,0.67,0.67,1,3,1,0,0
0,1,0,0,1,1,1,5.33,1.5,12.0,0.0,4,0.67,0.67,1,3,1,0,0
0,1,0,0,1,1,1,5.33,1.5,12.0,0.0,4,0.67,0.67,1,3,1,0,0
0,1,0,0,1,1,1,5.33,1.5,12.0,0.0,4,0.67,0.67,1,3,1,0,0
0,1,0,0,1,1,1,7.74,1.5,17.41,0.0,5,0.67,0.97,2,3,2,0,0
0,1,0,0,1,1,1,5.33,1.5,12.0,0.0,4,0.67,0.67,1,3,1,0,0
0,1,0,0,1,1,1,7.86,2.5,49.13,0.01,7,0.4,2.73,2,5,2,0,0
0,1,0,0,1,1,1,0.0,0.0,0.0,0.0,3,0.0,0.0,0,3,0,0,0
0,1,0,0,1,1,1,7.74,1.5,17.41,0.0,5,0.67,0.97,2,3,2,0,0
0,1,0,0,1,1,1,7.74,1.5,17.41,0.0,5,0.67,0.97,2,3,2,0,0
0,1,0,0,1,1,1,7.74,1.5,17.41,0.0,5,0.67,0.97,2,3,2,0,0
0,1,0,0,1,1,1,7.74,1.5,17.41,0.0,5,0.67,0.97,2,3,2,0,0
0,1,0,0,1,1,1,7.74,1.5,17.41,0.0,5,0.67,0.97,2,3,2,0,0
0,1,0,0,1,1,1,7.74,1.5,17.41,0.0,5,0.67,0.97,2,3,2,0,0
0,1,0,0,1,1,1,7.74,1.5,17.41,0.0,5,0.67,0.97,2,3,2,0,0
0,1,0,0,1,1,1,5.33,1.5,12.0,0.0,4,0.67,0.67,1,3,1,0,0
3,3,0,0,2,2,1,8.1,3.33,90.0,0.01,9,0.3,5.0,4,5,3,3,0
3,3,0,0,2,2,1,8.1,3.33,90.0,0.01,9,0.3,5.0,4,5,3,3,0
0,1,0,0,1,1,1,0.0,0.0,0.0,0.0,3,0.0,0.0,0,3,0,0,0
0,1,0,0,1,1,1,0.0,0.0,0.0,0.0,2,0.0,0.0,0,2,0,0,0
0,1,0,0,1,1,1,5.33,1.5,12.0,0.0,4,0.67,0.67,1,3,1,0,0
0,1,0,0,1,1,1,5.33,1.5,12.0,0.0,4,0.67,0.67,1,3,1,0,0
0,1,0,0,1,1,1,0.0,0.0,0.0,0.0,1,0.0,0.0,0,1,0,0,0
35,7,0,3,1,1,1,47.96,20.64,20429.39,0.33,190,0.05,1134.97,86,104,25,35,0
35,7,0,3,1,1,1,47.96,20.64,20429.39,0.33,190,0.05,1134.97,86,104,25,35,0
4,1,0,0,1,1,1,21.67,1.8,70.2,0.01,13,0.56,3.9,6,7,5,4,0
4,1,0,0,1,1,1,21.67,1.8,70.2,0.01,13,0.56,3.9,6,7,5,4,0
2,1,0,0,1,1,1,7.35,8.0,470.48,0.02,17,0.13,26.14,6,11,3,2,0
2,1,0,0,1,1,1,7.81,9.0,632.78,0.02,19,0.11,35.15,8,11,4,2,0
0,1,0,0,1,1,1,7.74,1.5,17.41,0.0,5,0.67,0.97,2,3,2,0,0
0,1,0,0,1,1,1,7.74,1.5,17.41,0.0,5,0.67,0.97,2,3,2,0,0
0,1,0,0,1,1,1,5.33,1.5,12.0,0.0,4,0.67,0.67,1,3,1,0,0
0,1,0,0,1,1,1,5.33,1.5,12.0,0.0,4,0.67,0.67,1,3,1,0,0
0,1,0,0,1,1,1,5.33,1.5,12.0,0.0,4,0.67,0.67,1,3,1,0,0
0,1,0,0,1,1,1,5.33,1.5,12.0,0.0,4,0.67,0.67,1,3,1,0,0
0,1,0,0,1,1,1,5.33,1.5,12.0,0.0,4,0.67,0.67,1,3,1,0,0
0,1,0,0,1,1,1,5.33,1.5,12.0,0.0,4,0.67,0.67,1,3,1,0,0
0,1,0,0,1,1,1,5.33,1.5,12.0,0.0,4,0.67,0.67,1,3,1,0,0
0,1,0,0,1,1,1,5.33,1.5,12.0,0.0,4,0.67,0.67,1,3,1,0,0
0,1,0,0,1,1,1,5.33,1.5,12.0,0.0,4,0.67,0.67,1,3,1,0,0
0,1,0,0,1,1,1,5.33,1.5,12.0,0.0,4,0.67,0.67,1,3,1,0,0
0,1,0,0,1,1,1,5.33,1.5,12.0,0.0,4,0.67,0.67,1,3,1,0,0
0,1,0,0,1,1,1,7.74,1.5,17.41,0.0,5,0.67,0.97,2,3,2,0,0
0,1,0,0,1,1,1,5.33,1.5,12.0,0.0,4,0.67,0.67,1,3,1,0,0
0,1,0,0,1,1,1,7.86,2.5,49.13,0.01,7,0.4,2.73,2,5,2,0,0
0,1,0,0,1,1,1,0.0,0.0,0.0,0.0,3,0.0,0.0,0,3,0,0,0
0,1,0,0,1,1,1,7.74,1.5,17.41,0.0,5,0.67,0.97,2,3,2,0,0
0,1,0,0,1,1,1,7.74,1.5,17.41,0.0,5,0.67,0.97,2,3,2,0,0
0,1,0,0,1,1,1,7.74,1.5,17.41,0.0,5,0.67,0.97,2,3,2,0,0
0,1,0,0,1,1,1,7.74,1.5,17.41,0.0,5,0.67,0.97,2,3,2,0,0
0,1,0,0,1,1,1,7.74,1.5,17.41,0.0,5,0.67,0.97,2,3,2,0,0
0,1,0,0,1,1,1,7.74,1.5,17.41,0.0,5,0.67,0.97,2,3,2,0,0
0,1,0,0,1,1,1,7.74,1.5,17.41,0.0,5,0.67,0.97,2,3,2,0,0
0,1,0,0,1,1,1,5.33,1.5,12.0,0.0,4,0.67,0.67,1,3,1,0,0
15,3,0,3,2,2,1,61.81,7.65,3614.76,0.16,106,0.13,200.82,52,54,17,15,0
15,3,0,3,2,2,1,61.81,7.65,3614.76,0.16,106,0.13,200.82,52,54,17,15,0
9,1,0,3,1,1,1,57.63,3.12,562.77,0.06,41,0.32,31.26,20,21,16,9,0
9,1,0,3,1,1,1,57.63,3.12,562.77,0.06,41,0.32,31.26,20,21,16,9,0
0,1,0,0,1,1,1,5.33,1.5,12.0,0.0,4,0.67,0.67,1,3,1,0,0
0,1,0,0,1,1,1,5.33,1.5,12.0,0.0,4,0.67,0.67,1,3,1,0,0
0,1,0,0,1,1,1,5.33,1.5,12.0,0.0,4,0.67,0.67,1,3,1,0,0
0,1,0,0,1,1,1,5.33,1.5,12.0,0.0,4,0.67,0.67,1,3,1,0,0
0,1,0,0,1,1,1,7.74,1.5,17.41,0.0,5,0.67,0.97,2,3,2,0,0
0,1,0,0,1,1,1,7.74,1.5,17.41,0.0,5,0.67,0.97,2,3,2,0,0
0,1,0,0,1,1,1,7.74,1.5,17.41,0.0,5,0.67,0.97,2,3,2,0,0
0,1,0,0,1,1,1,7.74,1.5,17.41,0.0,5,0.67,0.97,2,3,2,0,0
0,1,0,0,1,1,1,5.33,1.5,12.0,0.0,4,0.67,0.67,1,3,1,0,0
0,1,0,0,1,1,1,5.33,1.5,12.0,0.0,4,0.67,0.67,1,3,1,0,0
4,3,0,0,2,1,1,11.52,3.75,161.94,0.01,13,0.27,9.0,5,8,4,4,0
4,3,0,0,2,1,1,11.52,3.75,161.94,0.01,13,0.27,9.0,5,8,4,4,0
2,1,0,0,1,1,1,9.83,2.0,39.3,0.01,7,0.5,2.18,3,4,3,2,0
2,1,0,0,1,1,1,9.83,2.0,39.3,0.01,7,0.5,2.18,3,4,3,2,0
0,1,0,0,1,1,1,0.0,0.0,0.0,0.0,1,0.0,0.0,0,1,0,0,0
0,1,0,0,1,1,1,0.0,0.0,0.0,0.0,1,0.0,0.0,0,1,0,0,0
0,1,0,0,1,1,1,5.33,1.5,12.0,0.0,4,0.67,0.67,1,3,1,0,0
0,1,0,0,1,1,1,5.33,1.5,12.0,0.0,4,0.67,0.67,1,3,1,0,0
0,1,0,0,1,1,1,7.74,1.5,17.41,0.0,5,0.67,0.97,2,3,2,0,0
0,1,0,0,1,1,1,7.74,1.5,17.41,0.0,5,0.67,0.97,2,3,2,0,0
0,1,0,0,1,1,1,5.33,1.5,12.0,0.0,4,0.67,0.67,1,3,1,0,0
0,1,0,0,1,1,1,5.33,1.5,12.0,0.0,4,0.67,0.67,1,3,1,0,0
0,1,0,0,1,1,1,7.74,1.5,17.41,0.0,5,0.67,0.97,2,3,2,0,0
0,1,0,0,1,1,1,7.74,1.5,17.41,0.0,5,0.67,0.97,2,3,2,0,0
0,1,0,0,1,1,1,5.33,1.5,12.0,0.0,4,0.67,0.67,1,3,1,0,0
0,1,0,0,1,1,1,5.33,1.5,12.0,0.0,4,0.67,0.67,1,3,1,0,0
0,1,0,0,1,1,1,7.74,1.5,17.41,0.0,5,0.67,0.97,2,3,2,0,0
0,1,0,0,1,1,1,7.74,1.5,17.41,0.0,5,0.67,0.97,2,3,2,0,0
0,1,0,0,1,1,1,5.33,1.5,12.0,0.0,4,0.67,0.67,1,3,1,0,0
0,1,0,0,1,1,1,5.33,1.5,12.0,0.0,4,0.67,0.67,1,3,1,0,0
0,1,0,0,1,1,1,7.74,1.5,17.41,0.0,5,0.67,0.97,2,3,2,0,0
0,1,0,0,1,1,1,7.74,1.5,17.41,0.0,5,0.67,0.97,2,3,2,0,0
0,1,0,0,1,1,1,0.0,0.0,0.0,0.0,3,0.0,0.0,0,3,0,0,0
0,1,0,0,1,1,1,0.0,0.0,0.0,0.0,2,0.0,0.0,0,2,0,0,0
0,1,0,0,1,1,1,5.33,1.5,12.0,0.0,4,0.67,0.67,1,3,1,0,0
0,1,0,0,1,1,1,5.33,1.5,12.0,0.0,4,0.67,0.67,1,3,1,0,0
0,1,0,0,1,1,1,5.33,1.5,12.0,0.0,4,0.67,0.67,1,3,1,0,0
0,1,0,0,1,1,1,7.74,1.5,17.41,0.0,5,0.67,0.97,2,3,2,0,0
0,1,0,0,1,1,1,0.0,0.0,0.0,0.0,1,0.0,0.0,0,1,0,0,0
0,1,0,0,1,1,1,5.33,1.5,12.0,0.0,4,0.67,0.67,1,3,1,0,0
0,1,0,0,1,1,1,5.33,1.5,12.0,0.0,4,0.67,0.67,1,3,1,0,0
0,1,0,0,1,1,1,5.33,1.5,12.0,0.0,4,0.67,0.67,1,3,1,0,0
0,1,0,0,1,1,1,5.33,1.5,12.0,0.0,4,0.67,0.67,1,3,1,0,0
0,1,0,0,1,1,1,7.74,1.5,17.41,0.0,5,0.67,0.97,2,3,2,0,0
0,1,0,0,1,1,1,7.74,1.5,17.41,0.0,5,0.67,0.97,2,3,2,0,0
0,1,0,0,1,1,1,7.74,1.5,17.41,0.0,5,0.67,0.97,2,3,2,0,0
0,1,0,0,1,1,1,7.74,1.5,17.41,0.0,5,0.67,0.97,2,3,2,0,0
2,1,0,0,1,1,1,7.35,8.0,470.48,0.02,17,0.13,26.14,6,11,3,2,0
2,1,0,0,1,1,1,7.81,9.0,632.78,0.02,19,0.11,35.15,8,11,4,2,0
0,1,0,0,1,1,1,5.33,1.5,12.0,0.0,4,0.67,0.67,1,3,1,0,0
0,1,0,0,1,1,1,7.74,1.5,17.41,0.0,5,0.67,0.97,2,3,2,0,0
0,1,0,0,1,1,1,7.74,1.5,17.41,0.0,5,0.67,0.97,2,3,2,0,0
0,1,0,0,1,1,1,5.33,1.5,12.0,0.0,4,0.67,0.67,1,3,1,0,0
0,1,0,0,1,1,1,5.33,1.5,12.0,0.0,4,0.67,0.67,1,3,1,0,0
0,1,0,0,1,1,1,5.33,1.5,12.0,0.0,4,0.67,0.67,1,3,1,0,0
0,1,0,0,1,1,1,5.33,1.5,12.0,0.0,4,0.67,0.67,1,3,1,0,0
0,1,0,0,1,1,1,5.33,1.5,12.0,0.0,4,0.67,0.67,1,3,1,0,0
0,1,0,0,1,1,1,5.33,1.5,12.0,0.0,4,0.67,0.67,1,3,1,0,0
0,1,0,0,1,1,1,5.8,2.0,23.22,0.0,5,0.5,1.29,1,4,1,0,0
0,1,0,0,1,1,1,5.33,1.5,12.0,0.0,4,0.67,0.67,1,3,1,0,0
0,1,0,0,1,1,1,5.33,1.5,12.0,0.0,4,0.67,0.67,1,3,1,0,0
0,1,0,0,1,1,1,5.33,1.5,12.0,0.0,4,0.67,0.67,1,3,1,0,0
0,1,0,0,1,1,1,5.33,1.5,12.0,0.0,4,0.67,0.67,1,3,1,0,0
4,3,0,0,2,1,1,11.52,3.75,161.94,0.01,13,0.27,9.0,5,8,4,4,0
4,3,0,0,2,1,1,11.52,3.75,161.94,0.01,13,0.27,9.0,5,8,4,4,0
0,1,0,0,1,1,1,5.33,1.5,12.0,0.0,4,0.67,0.67,1,3,1,0,0
0,1,0,0,1,1,1,5.33,1.5,12.0,0.0,4,0.67,0.67,1,3,1,0,0
0,1,0,0,1,1,1,5.33,1.5,12.0,0.0,4,0.67,0.67,1,3,1,0,0
6,1,0,0,1,1,1,25.32,3.14,250.07,0.03,23,0.32,13.89,11,12,7,6,0
6,1,0,0,1,1,1,25.32,3.14,250.07,0.03,23,0.32,13.89,11,12,7,6,0
0,1,0,0,1,1,1,7.74,1.5,17.41,0.0,5,0.67,0.97,2,3,2,0,0
0,1,0,0,1,1,1,5.33,1.5,12.0,0.0,4,0.67,0.67,1,3,1,0,0
0,1,0,0,1,1,1,0.0,0.0,0.0,0.0,1,0.0,0.0,0,1,0,0,0
0,1,0,0,1,1,1,0.0,0.0,0.0,0.0,1,0.0,0.0,0,1,0,0,0
0,1,0,0,1,1,1,7.86,2.5,49.13,0.01,7,0.4,2.73,2,5,2,0,0
0,1,0,0,1,1,1,0.0,0.0,0.0,0.0,3,0.0,0.0,0,3,0,0,0
0,1,0,0,1,1,1,5.33,1.5,12.0,0.0,4,0.67,0.67,1,3,1,0,0
0,1,0,0,1,1,1,5.33,1.5,12.0,0.0,4,0.67,0.67,1,3,1,0,0
0,1,0,0,1,1,1,7.74,1.5,17.41,0.0,5,0.67,0.97,2,3,2,0,0
0,1,0,0,1,1,1,7.74,1.5,17.41,0.0,5,0.67,0.97,2,3,2,0,0
0,1,0,0,1,1,1,7.74,1.5,17.41,0.0,5,0.67,0.97,2,3,2,0,0
0,1,0,0,1,1,1,4.75,1.0,4.75,0.0,3,1.0,0.26,1,2,1,0,0
0,1,0,0,1,1,1,7.74,1.5,17.41,0.0,5,0.67,0.97,2,3,2,0,0
0,1,0,0,1,1,1,7.74,1.5,17.41,0.0,5,0.67,0.97,2,3,2,0,0
0,1,0,0,1,1,1,7.74,1.5,17.41,0.0,5,0.67,0.97,2,3,2,0,0
0,1,0,0,1,1,1,7.74,1.5,17.41,0.0,5,0.67,0.97,2,3,2,0,0
0,1,0,0,1,1,1,7.74,1.5,17.41,0.0,5,0.67,0.97,2,3,2,0,0
0,1,0,0,1,1,1,5.33,1.5,12.0,0.0,4,0.67,0.67,1,3,1,0,0
0,1,0,0,1,1,1,5.33,1.5,12.0,0.0,4,0.67,0.67,1,3,1,0,0
0,1,0,0,1,1,1,7.74,1.5,17.41,0.0,5,0.67,0.97,2,3,2,0,0
0,1,0,0,1,1,1,7.74,1.5,17.41,0.0,5,0.67,0.97,2,3,2,0,0
0,1,0,0,1,1,1,5.33,1.5,12.0,0.0,4,0.67,0.67,1,3,1,0,0
0,1,0,0,1,1,1,5.33,1.5,12.0,0.0,4,0.67,0.67,1,3,1,0,0
0,1,0,0,1,1,1,7.74,1.5,17.41,0.0,5,0.67,0.97,2,3,2,0,0
0,1,0,0,1,1,1,7.74,1.5,17.41,0.0,5,0.67,0.97,2,3,2,0,0
0,1,0,0,1,1,1,5.33,1.5,12.0,0.0,4,0.67,0.67,1,3,1,0,0
0,1,0,0,1,1,1,5.33,1.5,12.0,0.0,4,0.67,0.67,1,3,1,0,0
0,1,0,0,1,1,1,7.74,1.5,17.41,0.0,5,0.67,0.97,2,3,2,0,0
0,1,0,0,1,1,1,7.74,1.5,17.41,0.0,5,0.67,0.97,2,3,2,0,0
0,1,0,0,1,1,1,7.74,1.5,17.41,0.0,5,0.67,0.97,2,3,2,0,0
0,1,0,0,1,1,1,5.33,1.5,12.0,0.0,4,0.67,0.67,1,3,1,0,0
0,3,0,0,1,1,1,0.0,0.0,0.0,0.0,0,0.0,0.0,0,0,0,0,0
4,1,0,0,1,1,1,10.24,7.0,501.89,0.02,20,0.14,27.88,7,13,4,4,0
4,3,0,0,2,2,1,21.5,7.15,1099.18,0.05,35,0.14,61.07,13,22,10,4,0
8,3,0,0,2,2,1,23.46,10.29,2485.24,0.08,52,0.1,138.07,19,33,12,8,0
54,13,1,8,7,6,6,25.11,40.0,40181.42,0.33,184,0.03,2232.3,80,104,22,55,0
0,1,0,0,1,1,1,8.3,6.67,369.01,0.02,16,0.15,20.5,5,11,3,0,0
23,5,0,1,3,2,1,19.78,20.04,7940.87,0.13,80,0.05,441.16,33,47,14,23,0
0,1,0,0,1,1,1,8.6,7.5,483.97,0.02,18,0.13,26.89,5,13,3,0,0
19,5,0,3,3,3,1,19.07,10.91,2270.01,0.07,46,0.09,126.11,20,26,11,19,0
12,3,0,2,2,2,1,14.73,8.94,1176.94,0.04,31,0.11,65.39,13,18,8,12,0
12,9,0,0,5,3,3,17.46,16.55,4779.2,0.1,63,0.06,265.51,28,35,11,12,0
4,1,0,0,1,1,1,9.47,2.67,67.38,0.01,9,0.38,3.74,4,5,3,4,0
13,5,0,0,3,3,1,16.4,7.07,820.29,0.04,29,0.14,45.57,11,18,7,13,0
13,5,0,0,3,3,1,17.24,7.5,969.51,0.04,31,0.13,53.86,12,19,8,13,0
4,3,0,0,2,2,1,11.99,6.67,533.03,0.03,21,0.15,29.61,10,11,6,4,0
0,1,0,0,1,1,1,6.55,3.0,58.95,0.01,7,0.33,3.28,1,6,1,0,0
0,3,0,0,2,2,1,6.69,7.5,376.42,0.02,14,0.13,20.91,5,9,3,0,0
0,1,0,0,1,1,1,7.86,2.5,49.13,0.01,7,0.4,2.73,2,5,2,0,0
0,3,0,0,2,2,1,9.32,5.0,233.02,0.02,13,0.2,12.95,5,8,4,0,0
6,1,0,0,1,1,1,17.51,5.0,437.85,0.03,23,0.2,24.32,10,13,7,6,0
0,3,0,0,2,2,1,7.75,2.0,31.02,0.01,6,0.5,1.72,2,4,2,0,0
0,3,0,0,2,2,1,7.86,2.5,49.13,0.01,7,0.4,2.73,2,5,2,0,0
11,7,0,0,4,2,3,12.35,16.0,3162.47,0.07,45,0.06,175.69,16,29,7,11,0
3,3,0,0,2,2,1,14.28,4.0,228.44,0.02,15,0.25,12.69,6,9,6,3,0
0,1,0,0,1,1,1,0.0,0.0,0.0,0.0,1,0.0,0.0,0,1,0,0,0
2,1,0,0,1,1,1,13.5,2.0,54.0,0.01,9,0.5,3.0,4,5,4,2,0
0,1,0,0,1,1,1,7.75,2.0,31.02,0.01,6,0.5,1.72,2,4,2,0,0
0,1,0,0,1,1,1,7.75,2.0,31.02,0.01,6,0.5,1.72,2,4,2,0,0
0,1,0,0,1,1,1,7.75,2.0,31.02,0.01,6,0.5,1.72,2,4,2,0,0
0,1,0,0,1,1,1,7.74,1.5,17.41,0.0,5,0.67,0.97,2,3,2,0,0
1,1,0,0,1,1,1,7.74,1.5,17.41,0.0,5,0.67,0.97,2,3,2,1,0
0,1,0,0,1,1,1,5.8,2.0,23.22,0.0,5,0.5,1.29,1,4,1,0,0
2,1,0,0,1,1,1,7.75,2.0,31.02,0.01,6,0.5,1.72,2,4,2,2,0
1,1,0,1,1,1,1,0.0,0.0,0.0,0.0,1,0.0,0.0,0,1,0,1,0
2,1,0,0,1,1,1,7.75,2.0,31.02,0.01,6,0.5,1.72,2,4,2,2,0
0,1,0,0,1,1,1,9.31,2.5,58.16,0.01,9,0.4,3.23,1,8,1,0,0
3,3,0,0,2,1,1,7.61,5.0,190.2,0.01,12,0.2,10.57,5,7,3,3,0
0,1,0,0,1,1,1,7.75,2.0,31.02,0.01,6,0.5,1.72,2,4,2,0,0
0,1,0,0,1,1,1,10.68,4.67,232.53,0.02,15,0.21,12.92,4,11,3,0,0
7,5,0,0,3,2,1,11.89,13.13,2048.55,0.05,35,0.08,113.81,15,20,8,7,0
5,3,0,0,2,2,1,17.22,4.08,287.09,0.02,19,0.24,15.95,7,12,6,5,0
4,3,0,0,2,2,1,11.18,5.63,353.85,0.02,17,0.18,19.66,5,12,4,4,0
0,1,0,0,1,1,1,0.0,0.0,0.0,0.0,0,0.0,0.0,0,0,0,0,0
0,1,0,0,1,1,1,6.2,2.5,38.77,0.01,6,0.4,2.15,1,5,1,0,0
0,1,0,0,1,1,1,11.86,3.5,145.3,0.01,12,0.29,8.07,4,8,4,0,0
0,1,0,0,1,1,1,0.0,0.0,0.0,0.0,0,0.0,0.0,0,0,0,0,0
0,1,0,0,1,1,1,0.0,0.0,0.0,0.0,0,0.0,0.0,0,0,0,0,0
0,1,0,0,1,1,1,0.0,0.0,0.0,0.0,0,0.0,0.0,0,0,0,0,0
3,1,0,0,1,1,1,9.51,3.0,85.59,0.01,9,0.33,4.75,3,6,3,3,0
5,3,0,0,2,2,1,15.36,3.5,188.21,0.02,15,0.29,10.46,5,10,5,5,0
4,3,0,0,2,2,1,10.88,5.6,341.29,0.02,17,0.18,18.96,8,9,5,4,0
0,1,0,0,1,1,1,7.74,1.5,17.41,0.0,5,0.67,0.97,2,3,2,0,0
0,1,0,0,1,1,1,12.68,2.5,79.25,0.01,10,0.4,4.4,4,6,4,0,0
0,1,0,0,1,1,1,7.74,1.5,17.41,0.0,5,0.67,0.97,2,3,2,0,0
0,1,0,0,1,1,1,7.75,2.0,31.02,0.01,6,0.5,1.72,2,4,2,0,0
0,1,0,0,1,1,1,7.75,2.0,31.02,0.01,6,0.5,1.72,2,4,2,0,0
0,1,0,0,1,1,1,5.33,1.5,12.0,0.0,4,0.67,0.67,1,3,1,0,0
0,1,0,0,1,1,1,5.33,1.5,12.0,0.0,4,0.67,0.67,1,3,1,0,0
0,1,0,0,1,1,1,7.75,2.0,31.02,0.01,6,0.5,1.72,2,4,2,0,0
0,1,0,0,1,1,1,7.75,2.0,31.02,0.01,6,0.5,1.72,2,4,2,0,0
0,1,0,0,1,1,1,11.23,2.0,44.92,0.01,8,0.5,2.5,3,5,3,0,0
0,1,0,0,1,1,1,7.33,4.5,148.5,0.01,11,0.22,8.25,3,8,2,0,0
8,3,0,0,2,1,1,15.07,9.75,1432.72,0.05,34,0.1,79.6,13,21,8,8,0
0,1,0,0,1,1,1,9.6,2.5,60.0,0.01,8,0.4,3.33,3,5,3,0,0
0,1,0,0,1,1,1,7.75,2.0,31.02,0.01,6,0.5,1.72,2,4,2,0,0
0,1,0,0,1,1,1,6.86,3.5,84.0,0.01,8,0.29,4.67,1,7,1,0,0
0,1,0,0,1,1,1,7.75,2.0,31.02,0.01,6,0.5,1.72,2,4,2,0,0
0,1,0,0,1,1,1,8.3,6.0,298.97,0.02,15,0.17,16.61,3,12,2,0,0
0,1,0,0,1,1,1,8.3,6.0,298.97,0.02,15,0.17,16.61,3,12,2,0,0
0,1,0,0,1,1,1,8.3,6.0,298.97,0.02,15,0.17,16.61,3,12,2,0,0
0,1,0,0,1,1,1,7.75,2.0,31.02,0.01,6,0.5,1.72,2,4,2,0,0
0,1,0,0,1,1,1,7.75,2.0,31.02,0.01,6,0.5,1.72,2,4,2,0,0
0,1,0,0,1,1,1,7.75,2.0,31.02,0.01,6,0.5,1.72,2,4,2,0,0
0,1,0,0,1,1,1,7.75,2.0,31.02,0.01,6,0.5,1.72,2,4,2,0,0
0,3,0,0,2,1,1,7.75,2.0,31.02,0.01,6,0.5,1.72,2,4,2,0,0
0,1,0,0,1,1,1,5.8,2.0,23.22,0.0,5,0.5,1.29,1,4,1,0,0
0,3,0,0,2,1,1,7.75,2.0,31.02,0.01,6,0.5,1.72,2,4,2,0,0
0,1,0,0,1,1,1,12.18,3.0,109.62,0.01,11,0.33,6.09,4,7,4,0,0
0,1,0,0,1,1,1,7.75,2.0,31.02,0.01,6,0.5,1.72,2,4,2,0,0
0,1,0,0,1,1,1,7.75,2.0,31.02,0.01,6,0.5,1.72,2,4,2,0,0
0,1,0,0,1,1,1,7.75,2.0,31.02,0.01,6,0.5,1.72,2,4,2,0,0
0,1,0,0,1,1,1,5.8,2.0,23.22,0.0,5,0.5,1.29,1,4,1,0,0
0,1,0,0,1,1,1,7.75,2.0,31.02,0.01,6,0.5,1.72,2,4,2,0,0
2,1,0,0,1,1,1,8.98,2.5,56.15,0.01,8,0.4,3.12,2,6,2,2,0
2,1,0,0,1,1,1,5.33,1.5,12.0,0.0,4,0.67,0.67,1,3,1,2,0
0,1,0,0,1,1,1,5.33,1.5,12.0,0.0,4,0.67,0.67,1,3,1,0,0
2,1,0,0,1,1,1,5.33,1.5,12.0,0.0,4,0.67,0.67,1,3,1,2,0
2,1,0,0,1,1,1,5.33,1.5,12.0,0.0,4,0.67,0.67,1,3,1,2,0
3,1,0,0,1,1,1,12.0,2.5,75.0,0.01,10,0.4,4.17,3,7,3,3,0
0,1,0,0,1,1,1,7.86,2.5,49.13,0.01,7,0.4,2.73,2,5,2,0,0
0,1,0,0,1,1,1,6.55,3.0,58.95,0.01,7,0.33,3.28,1,6,1,0,0
0,1,0,0,1,1,1,6.55,3.0,58.95,0.01,7,0.33,3.28,1,6,1,0,0
2,1,0,0,1,1,1,8.98,2.5,56.15,0.01,8,0.4,3.12,2,6,2,2,0
2,1,0,0,1,1,1,5.33,1.5,12.0,0.0,4,0.67,0.67,1,3,1,2,0
0,1,0,0,1,1,1,5.33,1.5,12.0,0.0,4,0.67,0.67,1,3,1,0,0
2,1,0,0,1,1,1,5.33,1.5,12.0,0.0,4,0.67,0.67,1,3,1,2,0
2,1,0,0,1,1,1,5.33,1.5,12.0,0.0,4,0.67,0.67,1,3,1,2,0
0,1,0,0,1,1,1,5.33,1.5,12.0,0.0,4,0.67,0.67,1,3,1,0,0
0,1,0,0,1,1,1,5.33,1.5,12.0,0.0,4,0.67,0.67,1,3,1,0,0
0,1,0,0,1,1,1,7.75,2.0,31.02,0.01,6,0.5,1.72,2,4,2,0,0
3,3,0,0,2,2,1,12.8,4.2,225.85,0.02,15,0.24,12.55,6,9,5,3,0
0,1,0,0,1,1,1,9.0,3.0,81.0,0.01,9,0.33,4.5,2,7,2,0,0
0,1,0,0,1,1,1,8.3,6.0,298.97,0.02,15,0.17,16.61,3,12,2,0,0
0,1,0,0,1,1,1,9.51,3.0,85.59,0.01,9,0.33,4.75,3,6,3,0,0
0,1,0,0,1,1,1,9.51,3.0,85.59,0.01,9,0.33,4.75,3,6,3,0,0
0,1,0,0,1,1,1,9.51,3.0,85.59,0.01,9,0.33,4.75,3,6,3,0,0
0,1,0,0,1,1,1,9.51,3.0,85.59,0.01,9,0.33,4.75,3,6,3,0,0
4,3,0,0,2,2,1,13.67,6.0,492.27,0.03,21,0.17,27.35,6,15,5,4,0
2,1,0,0,1,1,1,5.33,1.5,12.0,0.0,4,0.67,0.67,1,3,1,2,0
2,1,0,0,1,1,1,5.33,1.5,12.0,0.0,4,0.67,0.67,1,3,1,2,0
0,1,0,0,1,1,1,0.0,0.0,0.0,0.0,3,0.0,0.0,0,3,0,0,0
0,1,0,0,1,1,1,0.0,0.0,0.0,0.0,3,0.0,0.0,0,3,0,0,0
0,1,0,0,1,1,1,0.0,0.0,0.0,0.0,2,0.0,0.0,0,2,0,0,0
0,1,0,0,1,1,1,0.0,0.0,0.0,0.0,2,0.0,0.0,0,2,0,0,0
0,1,0,0,1,1,1,5.33,1.5,12.0,0.0,4,0.67,0.67,1,3,1,0,0
0,1,0,0,1,1,1,5.33,1.5,12.0,0.0,4,0.67,0.67,1,3,1,0,0
0,1,0,0,1,1,1,5.33,1.5,12.0,0.0,4,0.67,0.67,1,3,1,0,0
0,1,0,0,1,1,1,5.33,1.5,12.0,0.0,4,0.67,0.67,1,3,1,0,0
0,1,0,0,1,1,1,5.33,1.5,12.0,0.0,4,0.67,0.67,1,3,1,0,0
0,1,0,0,1,1,1,5.33,1.5,12.0,0.0,4,0.67,0.67,1,3,1,0,0
0,1,0,0,1,1,1,7.74,1.5,17.41,0.0,5,0.67,0.97,2,3,2,0,0
0,1,0,0,1,1,1,7.74,1.5,17.41,0.0,5,0.67,0.97,2,3,2,0,0
0,1,0,0,1,1,1,0.0,0.0,0.0,0.0,1,0.0,0.0,0,1,0,0,0
0,1,0,0,1,1,1,0.0,0.0,0.0,0.0,1,0.0,0.0,0,1,0,0,0
7,3,0,0,2,1,1,14.16,8.0,906.4,0.04,29,0.13,50.36,14,15,7,7,0
7,3,0,0,2,1,1,14.16,8.0,906.4,0.04,29,0.13,50.36,14,15,7,7,0
2,1,0,0,1,1,1,7.35,8.0,470.48,0.02,17,0.13,26.14,6,11,3,2,0
2,1,0,0,1,1,1,7.81,9.0,632.78,0.02,19,0.11,35.15,8,11,4,2,0
0,1,0,0,1,1,1,0.0,0.0,0.0,0.0,1,0.0,0.0,0,1,0,0,0
0,1,0,0,1,1,1,0.0,0.0,0.0,0.0,1,0.0,0.0,0,1,0,0,0
0,1,0,0,1,1,1,0.0,0.0,0.0,0.0,0,0.0,0.0,0,0,0,0,0
0,1,0,0,1,1,1,0.0,0.0,0.0,0.0,0,0.0,0.0,0,0,0,0,0
0,1,0,0,1,1,1,7.74,1.5,17.41,0.0,5,0.67,0.97,2,3,2,0,0
0,1,0,0,1,1,1,7.74,1.5,17.41,0.0,5,0.67,0.97,2,3,2,0,0
0,1,0,0,1,1,1,7.86,2.5,49.13,0.01,7,0.4,2.73,2,5,2,0,0
0,1,0,0,1,1,1,7.86,2.5,49.13,0.01,7,0.4,2.73,2,5,2,0,0
0,1,0,0,1,1,1,7.74,1.5,17.41,0.0,5,0.67,0.97,2,3,2,0,0
0,1,0,0,1,1,1,7.74,1.5,17.41,0.0,5,0.67,0.97,2,3,2,0,0
0,1,0,0,1,1,1,7.74,1.5,17.41,0.0,5,0.67,0.97,2,3,2,0,0
0,1,0,0,1,1,1,7.74,1.5,17.41,0.0,5,0.67,0.97,2,3,2,0,0
0,1,0,0,1,1,1,16.5,2.0,66.0,0.01,11,0.5,3.67,4,7,4,0,0
0,1,0,0,1,1,1,16.5,2.0,66.0,0.01,11,0.5,3.67,4,7,4,0,0
0,1,0,0,1,1,1,5.33,1.5,12.0,0.0,4,0.67,0.67,1,3,1,0,0
0,1,0,0,1,1,1,5.33,1.5,12.0,0.0,4,0.67,0.67,1,3,1,0,0
0,1,0,0,1,1,1,16.5,2.0,66.0,0.01,11,0.5,3.67,4,7,4,0,0
0,1,0,0,1,1,1,16.5,2.0,66.0,0.01,11,0.5,3.67,4,7,4,0,0
0,1,0,0,1,1,1,5.33,1.5,12.0,0.0,4,0.67,0.67,1,3,1,0,0
0,1,0,0,1,1,1,5.33,1.5,12.0,0.0,4,0.67,0.67,1,3,1,0,0
0,1,0,0,1,1,1,5.33,1.5,12.0,0.0,4,0.67,0.67,1,3,1,0,0
0,1,0,0,1,1,1,5.33,1.5,12.0,0.0,4,0.67,0.67,1,3,1,0,0
0,1,0,0,1,1,1,16.5,2.0,66.0,0.01,11,0.5,3.67,4,7,4,0,0
0,1,0,0,1,1,1,16.5,2.0,66.0,0.01,11,0.5,3.67,4,7,4,0,0
0,1,0,0,1,1,1,5.33,1.5,12.0,0.0,4,0.67,0.67,1,3,1,0,0
0,1,0,0,1,1,1,5.33,1.5,12.0,0.0,4,0.67,0.67,1,3,1,0,0
0,1,0,0,1,1,1,7.74,1.5,17.41,0.0,5,0.67,0.97,2,3,2,0,0
0,1,0,0,1,1,1,7.74,1.5,17.41,0.0,5,0.67,0.97,2,3,2,0,0
0,1,0,0,1,1,1,7.74,1.5,17.41,0.0,5,0.67,0.97,2,3,2,0,0
0,1,0,0,1,1,1,7.74,1.5,17.41,0.0,5,0.67,0.97,2,3,2,0,0
0,1,0,0,1,1,1,16.84,1.5,37.9,0.01,9,0.67,2.11,4,5,4,0,0
0,1,0,0,1,1,1,16.84,1.5,37.9,0.01,9,0.67,2.11,4,5,4,0,0
0,1,0,0,1,1,1,7.74,1.5,17.41,0.0,5,0.67,0.97,2,3,2,0,0
0,1,0,0,1,1,1,7.74,1.5,17.41,0.0,5,0.67,0.97,2,3,2,0,0
0,1,0,0,1,1,1,16.84,1.5,37.9,0.01,9,0.67,2.11,4,5,4,0,0
0,1,0,0,1,1,1,16.84,1.5,37.9,0.01,9,0.67,2.11,4,5,4,0,0
0,1,0,0,1,1,1,7.74,1.5,17.41,0.0,5,0.67,0.97,2,3,2,0,0
0,1,0,0,1,1,1,7.74,1.5,17.41,0.0,5,0.67,0.97,2,3,2,0,0
0,1,0,0,1,1,1,7.74,1.5,17.41,0.0,5,0.67,0.97,2,3,2,0,0
0,1,0,0,1,1,1,7.74,1.5,17.41,0.0,5,0.67,0.97,2,3,2,0,0
0,1,0,0,1,1,1,7.74,1.5,17.41,0.0,5,0.67,0.97,2,3,2,0,0
0,1,0,0,1,1,1,7.74,1.5,17.41,0.0,5,0.67,0.97,2,3,2,0,0
0,1,0,0,1,1,1,5.33,1.5,12.0,0.0,4,0.67,0.67,1,3,1,0,0
0,1,0,0,1,1,1,5.33,1.5,12.0,0.0,4,0.67,0.67,1,3,1,0,0
0,1,0,0,1,1,1,5.33,1.5,12.0,0.0,4,0.67,0.67,1,3,1,0,0
0,1,0,0,1,1,1,5.33,1.5,12.0,0.0,4,0.67,0.67,1,3,1,0,0
0,1,0,0,1,1,1,5.33,1.5,12.0,0.0,4,0.67,0.67,1,3,1,0,0
0,1,0,0,1,1,1,5.33,1.5,12.0,0.0,4,0.67,0.67,1,3,1,0,0
0,1,0,0,1,1,1,5.33,1.5,12.0,0.0,4,0.67,0.67,1,3,1,0,0
0,1,0,0,1,1,1,5.33,1.5,12.0,0.0,4,0.67,0.67,1,3,1,0,0
0,1,0,0,1,1,1,5.33,1.5,12.0,0.0,4,0.67,0.67,1,3,1,0,0
0,1,0,0,1,1,1,5.33,1.5,12.0,0.0,4,0.67,0.67,1,3,1,0,0
0,1,0,0,1,1,1,5.33,1.5,12.0,0.0,4,0.67,0.67,1,3,1,0,0
0,1,0,0,1,1,1,5.33,1.5,12.0,0.0,4,0.67,0.67,1,3,1,0,0
0,1,0,0,1,1,1,5.33,1.5,12.0,0.0,4,0.67,0.67,1,3,1,0,0
0,1,0,0,1,1,1,5.33,1.5,12.0,0.0,4,0.67,0.67,1,3,1,0,0
0,1,0,0,1,1,1,5.33,1.5,12.0,0.0,4,0.67,0.67,1,3,1,0,0
0,1,0,0,1,1,1,5.33,1.5,12.0,0.0,4,0.67,0.67,1,3,1,0,0
0,1,0,0,1,1,1,5.33,1.5,12.0,0.0,4,0.67,0.67,1,3,1,0,0
0,1,0,0,1,1,1,5.33,1.5,12.0,0.0,4,0.67,0.67,1,3,1,0,0
0,1,0,0,1,1,1,5.33,1.5,12.0,0.0,4,0.67,0.67,1,3,1,0,0
0,1,0,0,1,1,1,5.33,1.5,12.0,0.0,4,0.67,0.67,1,3,1,0,0
0,1,0,0,1,1,1,5.33,1.5,12.0,0.0,4,0.67,0.67,1,3,1,0,0
0,1,0,0,1,1,1,5.33,1.5,12.0,0.0,4,0.67,0.67,1,3,1,0,0
0,1,0,0,1,1,1,5.33,1.5,12.0,0.0,4,0.67,0.67,1,3,1,0,0
0,1,0,0,1,1,1,5.33,1.5,12.0,0.0,4,0.67,0.67,1,3,1,0,0
0,1,0,0,1,1,1,5.33,1.5,12.0,0.0,4,0.67,0.67,1,3,1,0,0
0,1,0,0,1,1,1,5.33,1.5,12.0,0.0,4,0.67,0.67,1,3,1,0,0
0,1,0,0,1,1,1,5.33,1.5,12.0,0.0,4,0.67,0.67,1,3,1,0,0
0,1,0,0,1,1,1,5.33,1.5,12.0,0.0,4,0.67,0.67,1,3,1,0,0
0,1,0,0,1,1,1,5.33,1.5,12.0,0.0,4,0.67,0.67,1,3,1,0,0
0,1,0,0,1,1,1,5.33,1.5,12.0,0.0,4,0.67,0.67,1,3,1,0,0
0,1,0,0,1,1,1,5.33,1.5,12.0,0.0,4,0.67,0.67,1,3,1,0,0
0,1,0,0,1,1,1,5.33,1.5,12.0,0.0,4,0.67,0.67,1,3,1,0,0
0,1,0,0,1,1,1,5.33,1.5,12.0,0.0,4,0.67,0.67,1,3,1,0,0
0,1,0,0,1,1,1,5.33,1.5,12.0,0.0,4,0.67,0.67,1,3,1,0,0
0,1,0,0,1,1,1,5.33,1.5,12.0,0.0,4,0.67,0.67,1,3,1,0,0
0,1,0,0,1,1,1,5.33,1.5,12.0,0.0,4,0.67,0.67,1,3,1,0,0
0,1,0,0,1,1,1,5.33,1.5,12.0,0.0,4,0.67,0.67,1,3,1,0,0
0,1,0,0,1,1,1,5.33,1.5,12.0,0.0,4,0.67,0.67,1,3,1,0,0
0,1,0,0,1,1,1,5.33,1.5,12.0,0.0,4,0.67,0.67,1,3,1,0,0
0,1,0,0,1,1,1,5.33,1.5,12.0,0.0,4,0.67,0.67,1,3,1,0,0
0,1,0,0,1,1,1,5.33,1.5,12.0,0.0,4,0.67,0.67,1,3,1,0,0
0,1,0,0,1,1,1,5.33,1.5,12.0,0.0,4,0.67,0.67,1,3,1,0,0
0,1,0,0,1,1,1,7.74,1.5,17.41,0.0,5,0.67,0.97,2,3,2,0,0
0,1,0,0,1,1,1,7.74,1.5,17.41,0.0,5,0.67,0.97,2,3,2,0,0
0,1,0,0,1,1,1,5.33,1.5,12.0,0.0,4,0.67,0.67,1,3,1,0,0
0,1,0,0,1,1,1,5.33,1.5,12.0,0.0,4,0.67,0.67,1,3,1,0,0
0,1,0,0,1,1,1,7.86,2.5,49.13,0.01,7,0.4,2.73,2,5,2,0,0
0,1,0,0,1,1,1,7.86,2.5,49.13,0.01,7,0.4,2.73,2,5,2,0,0
0,1,0,0,1,1,1,0.0,0.0,0.0,0.0,3,0.0,0.0,0,3,0,0,0
0,1,0,0,1,1,1,0.0,0.0,0.0,0.0,3,0.0,0.0,0,3,0,0,0
0,1,0,0,1,1,1,7.74,1.5,17.41,0.0,5,0.67,0.97,2,3,2,0,0
0,1,0,0,1,1,1,7.74,1.5,17.41,0.0,5,0.67,0.97,2,3,2,0,0
0,1,0,0,1,1,1,7.74,1.5,17.41,0.0,5,0.67,0.97,2,3,2,0,0
0,1,0,0,1,1,1,7.74,1.5,17.41,0.0,5,0.67,0.97,2,3,2,0,0
0,1,0,0,1,1,1,7.74,1.5,17.41,0.0,5,0.67,0.97,2,3,2,0,0
0,1,0,0,1,1,1,7.74,1.5,17.41,0.0,5,0.67,0.97,2,3,2,0,0
0,1,0,0,1,1,1,7.74,1.5,17.41,0.0,5,0.67,0.97,2,3,2,0,0
0,1,0,0,1,1,1,7.74,1.5,17.41,0.0,5,0.67,0.97,2,3,2,0,0
0,1,0,0,1,1,1,7.74,1.5,17.41,0.0,5,0.67,0.97,2,3,2,0,0
0,1,0,0,1,1,1,7.74,1.5,17.41,0.0,5,0.67,0.97,2,3,2,0,0
0,1,0,0,1,1,1,7.74,1.5,17.41,0.0,5,0.67,0.97,2,3,2,0,0
0,1,0,0,1,1,1,7.74,1.5,17.41,0.0,5,0.67,0.97,2,3,2,0,0
0,1,0,0,1,1,1,7.74,1.5,17.41,0.0,5,0.67,0.97,2,3,2,0,0
0,1,0,0,1,1,1,7.74,1.5,17.41,0.0,5,0.67,0.97,2,3,2,0,0
0,1,0,0,1,1,1,7.74,1.5,17.41,0.0,5,0.67,0.97,2,3,2,0,0
0,1,0,0,1,1,1,7.74,1.5,17.41,0.0,5,0.67,0.97,2,3,2,0,0
0,1,0,0,1,1,1,7.74,1.5,17.41,0.0,5,0.67,0.97,2,3,2,0,0
0,1,0,0,1,1,1,7.74,1.5,17.41,0.0,5,0.67,0.97,2,3,2,0,0
0,1,0,0,1,1,1,7.74,1.5,17.41,0.0,5,0.67,0.97,2,3,2,0,0
0,1,0,0,1,1,1,7.74,1.5,17.41,0.0,5,0.67,0.97,2,3,2,0,0
0,1,0,0,1,1,1,5.33,1.5,12.0,0.0,4,0.67,0.67,1,3,1,0,0
0,1,0,0,1,1,1,5.33,1.5,12.0,0.0,4,0.67,0.67,1,3,1,0,0
21,21,0,2,11,11,1,41.42,9.23,3529.05,0.13,90,0.11,196.06,40,50,13,21,0
11,1,6,3,1,1,1,114.74,2.53,732.29,0.1,65,0.4,40.68,32,33,19,17,0
0,1,0,0,1,1,1,0.0,0.0,0.0,0.0,3,0.0,0.0,0,3,0,0,0
0,1,0,0,1,1,1,0.0,0.0,0.0,0.0,2,0.0,0.0,0,2,0,0,0
0,1,0,0,1,1,1,5.33,1.5,12.0,0.0,4,0.67,0.67,1,3,1,0,0
0,1,0,0,1,1,1,5.33,1.5,12.0,0.0,4,0.67,0.67,1,3,1,0,0
0,1,0,0,1,1,1,0.0,0.0,0.0,0.0,1,0.0,0.0,0,1,0,0,0
9,5,0,2,3,2,1,17.13,6.0,616.79,0.03,27,0.17,34.27,12,15,7,9,0
28,9,4,10,5,1,1,132.18,6.24,5141.49,0.27,151,0.16,285.64,79,72,38,32,0
0,1,0,0,1,1,1,7.74,1.5,17.41,0.0,5,0.67,0.97,2,3,2,0,0
2,1,0,0,1,1,1,7.35,8.0,470.48,0.02,17,0.13,26.14,6,11,3,2,0
2,1,0,0,1,1,1,7.81,9.0,632.78,0.02,19,0.11,35.15,8,11,4,2,0
0,1,0,0,1,1,1,7.74,1.5,17.41,0.0,5,0.67,0.97,2,3,2,0,0
0,1,0,0,1,1,1,7.74,1.5,17.41,0.0,5,0.67,0.97,2,3,2,0,0
0,1,0,0,1,1,1,5.33,1.5,12.0,0.0,4,0.67,0.67,1,3,1,0,0
0,1,0,0,1,1,1,5.33,1.5,12.0,0.0,4,0.67,0.67,1,3,1,0,0
0,1,0,0,1,1,1,5.33,1.5,12.0,0.0,4,0.67,0.67,1,3,1,0,0
0,1,0,0,1,1,1,5.33,1.5,12.0,0.0,4,0.67,0.67,1,3,1,0,0
0,1,0,0,1,1,1,5.33,1.5,12.0,0.0,4,0.67,0.67,1,3,1,0,0
0,1,0,0,1,1,1,5.33,1.5,12.0,0.0,4,0.67,0.67,1,3,1,0,0
0,1,0,0,1,1,1,5.33,1.5,12.0,0.0,4,0.67,0.67,1,3,1,0,0
0,1,0,0,1,1,1,5.33,1.5,12.0,0.0,4,0.67,0.67,1,3,1,0,0
0,1,0,0,1,1,1,5.33,1.5,12.0,0.0,4,0.67,0.67,1,3,1,0,0
0,1,0,0,1,1,1,5.33,1.5,12.0,0.0,4,0.67,0.67,1,3,1,0,0
0,1,0,0,1,1,1,5.33,1.5,12.0,0.0,4,0.67,0.67,1,3,1,0,0
0,1,0,0,1,1,1,5.33,1.5,12.0,0.0,4,0.67,0.67,1,3,1,0,0
0,1,0,0,1,1,1,5.33,1.5,12.0,0.0,4,0.67,0.67,1,3,1,0,0
0,1,0,0,1,1,1,5.33,1.5,12.0,0.0,4,0.67,0.67,1,3,1,0,0
0,1,0,0,1,1,1,5.33,1.5,12.0,0.0,4,0.67,0.67,1,3,1,0,0
0,1,0,0,1,1,1,5.33,1.5,12.0,0.0,4,0.67,0.67,1,3,1,0,0
0,1,0,0,1,1,1,5.33,1.5,12.0,0.0,4,0.67,0.67,1,3,1,0,0
0,1,0,0,1,1,1,7.74,1.5,17.41,0.0,5,0.67,0.97,2,3,2,0,0
0,1,0,0,1,1,1,5.33,1.5,12.0,0.0,4,0.67,0.67,1,3,1,0,0
0,1,0,0,1,1,1,7.86,2.5,49.13,0.01,7,0.4,2.73,2,5,2,0,0
0,1,0,0,1,1,1,0.0,0.0,0.0,0.0,3,0.0,0.0,0,3,0,0,0
0,1,0,0,1,1,1,7.74,1.5,17.41,0.0,5,0.67,0.97,2,3,2,0,0
0,1,0,0,1,1,1,7.74,1.5,17.41,0.0,5,0.67,0.97,2,3,2,0,0
0,1,0,0,1,1,1,7.74,1.5,17.41,0.0,5,0.67,0.97,2,3,2,0,0
0,1,0,0,1,1,1,7.74,1.5,17.41,0.0,5,0.67,0.97,2,3,2,0,0
0,1,0,0,1,1,1,7.74,1.5,17.41,0.0,5,0.67,0.97,2,3,2,0,0
0,1,0,0,1,1,1,7.74,1.5,17.41,0.0,5,0.67,0.97,2,3,2,0,0
0,1,0,0,1,1,1,7.74,1.5,17.41,0.0,5,0.67,0.97,2,3,2,0,0
0,1,0,0,1,1,1,7.74,1.5,17.41,0.0,5,0.67,0.97,2,3,2,0,0
0,1,0,0,1,1,1,7.74,1.5,17.41,0.0,5,0.67,0.97,2,3,2,0,0
0,1,0,0,1,1,1,5.33,1.5,12.0,0.0,4,0.67,0.67,1,3,1,0,0
2,1,1,0,1,1,1,11.23,2.0,44.92,0.01,8,0.5,2.5,3,5,3,3,0
5,3,1,0,2,1,1,5.2,7.5,292.5,0.01,13,0.13,16.25,5,8,2,6,0
9,1,0,0,1,1,1,39.65,5.25,1092.78,0.07,49,0.19,60.71,18,31,12,9,0
0,1,0,0,1,1,1,5.33,1.5,12.0,0.0,4,0.67,0.67,1,3,1,0,0
0,1,0,0,1,1,1,5.8,2.0,23.22,0.0,5,0.5,1.29,1,4,1,0,0
0,1,0,0,1,1,1,5.8,2.0,23.22,0.0,5,0.5,1.29,1,4,1,0,0
0,1,0,0,1,1,1,7.74,1.5,17.41,0.0,5,0.67,0.97,2,3,2,0,0
0,1,0,0,1,1,1,7.74,1.5,17.41,0.0,5,0.67,0.97,2,3,2,0,0
0,1,0,0,1,1,1,5.33,1.5,12.0,0.0,4,0.67,0.67,1,3,1,0,0
0,1,0,0,1,1,1,5.33,1.5,12.0,0.0,4,0.67,0.67,1,3,1,0,0
3,1,0,0,1,1,1,11.23,2.0,44.92,0.01,8,0.5,2.5,3,5,3,3,0
3,1,0,0,1,1,1,11.23,2.0,44.92,0.01,8,0.5,2.5,3,5,3,3,0
5,1,0,0,1,1,1,24.33,1.5,54.74,0.01,13,0.67,3.04,4,9,4,5,0
5,1,0,0,1,1,1,24.33,1.5,54.74,0.01,13,0.67,3.04,4,9,4,5,0
6,1,0,0,1,1,1,23.25,3.0,209.28,0.02,21,0.33,11.63,9,12,6,6,0
6,1,0,0,1,1,1,23.25,3.0,209.28,0.02,21,0.33,11.63,9,12,6,6,0
2,1,0,0,1,1,1,7.35,8.0,470.48,0.02,17,0.13,26.14,6,11,3,2,0
2,1,0,0,1,1,1,7.81,9.0,632.78,0.02,19,0.11,35.15,8,11,4,2,0
0,1,0,0,1,1,1,7.74,1.5,17.41,0.0,5,0.67,0.97,2,3,2,0,0
0,1,0,0,1,1,1,7.74,1.5,17.41,0.0,5,0.67,0.97,2,3,2,0,0
0,1,0,0,1,1,1,7.74,1.5,17.41,0.0,5,0.67,0.97,2,3,2,0,0
0,1,0,0,1,1,1,7.74,1.5,17.41,0.0,5,0.67,0.97,2,3,2,0,0
0,1,0,0,1,1,1,7.74,1.5,17.41,0.0,5,0.67,0.97,2,3,2,0,0
0,1,0,0,1,1,1,7.74,1.5,17.41,0.0,5,0.67,0.97,2,3,2,0,0
0,1,0,0,1,1,1,5.33,1.5,12.0,0.0,4,0.67,0.67,1,3,1,0,0
0,1,0,0,1,1,1,5.33,1.5,12.0,0.0,4,0.67,0.67,1,3,1,0,0
0,1,0,0,1,1,1,5.33,1.5,12.0,0.0,4,0.67,0.67,1,3,1,0,0
0,1,0,0,1,1,1,5.33,1.5,12.0,0.0,4,0.67,0.67,1,3,1,0,0
0,1,0,0,1,1,1,5.33,1.5,12.0,0.0,4,0.67,0.67,1,3,1,0,0
0,1,0,0,1,1,1,5.33,1.5,12.0,0.0,4,0.67,0.67,1,3,1,0,0
0,1,0,0,1,1,1,5.33,1.5,12.0,0.0,4,0.67,0.67,1,3,1,0,0
0,1,0,0,1,1,1,5.33,1.5,12.0,0.0,4,0.67,0.67,1,3,1,0,0
9,5,0,0,3,2,1,8.55,13.0,1444.74,0.04,31,0.08,80.26,13,18,4,9,0
9,5,0,0,3,2,1,8.55,13.0,1444.74,0.04,31,0.08,80.26,13,18,4,9,0
5,5,0,0,3,3,1,15.64,5.5,473.22,0.03,24,0.18,26.29,11,13,6,5,0
6,1,1,0,1,1,1,34.58,2.89,288.63,0.03,27,0.35,16.04,13,14,9,7,0
0,1,0,0,1,1,1,5.33,1.5,12.0,0.0,4,0.67,0.67,1,3,1,0,0
2,1,0,0,1,1,1,7.74,1.5,17.41,0.0,5,0.67,0.97,2,3,2,2,0
0,1,0,0,1,1,1,7.74,1.5,17.41,0.0,5,0.67,0.97,2,3,2,0,0
8,7,0,0,4,3,1,19.43,5.14,513.83,0.03,27,0.19,28.55,12,15,7,8,0
8,7,0,0,4,3,1,19.43,5.14,513.83,0.03,27,0.19,28.55,12,15,7,8,0
17,3,1,0,2,1,1,56.84,6.73,2575.02,0.13,74,0.15,143.06,35,39,26,18,0
17,3,1,0,2,1,1,56.84,6.73,2575.02,0.13,74,0.15,143.06,35,39,26,18,0
0,1,0,0,1,1,1,7.74,1.5,17.41,0.0,5,0.67,0.97,2,3,2,0,0
2,1,0,0,1,1,1,7.35,8.0,470.48,0.02,17,0.13,26.14,6,11,3,2,0
2,1,0,0,1,1,1,7.81,9.0,632.78,0.02,19,0.11,35.15,8,11,4,2,0
0,1,0,0,1,1,1,7.74,1.5,17.41,0.0,5,0.67,0.97,2,3,2,0,0
0,1,0,0,1,1,1,7.74,1.5,17.41,0.0,5,0.67,0.97,2,3,2,0,0
40,11,0,8,1,1,1,66.0,15.92,16724.89,0.35,172,0.06,929.16,78,94,49,40,0
40,11,0,8,1,1,1,64.51,16.04,16601.02,0.34,170,0.06,922.28,77,93,48,40,0
36,17,0,7,9,8,1,40.47,20.0,16189.25,0.27,142,0.05,899.4,64,78,32,36,0
36,17,0,7,9,8,1,40.47,20.0,16189.25,0.27,142,0.05,899.4,64,78,32,36,0
25,11,0,5,1,1,1,32.32,12.94,5412.52,0.14,87,0.08,300.7,40,47,17,25,0
25,11,0,5,1,1,1,32.32,12.94,5412.52,0.14,87,0.08,300.7,40,47,17,25,0
0,1,0,0,1,1,1,0.0,0.0,0.0,0.0,3,0.0,0.0,0,3,0,0,0
0,1,0,0,1,1,1,0.0,0.0,0.0,0.0,2,0.0,0.0,0,2,0,0,0
0,1,0,0,1,1,1,5.33,1.5,12.0,0.0,4,0.67,0.67,1,3,1,0,0
0,1,0,0,1,1,1,5.33,1.5,12.0,0.0,4,0.67,0.67,1,3,1,0,0
0,1,0,0,1,1,1,5.33,1.5,12.0,0.0,4,0.67,0.67,1,3,1,0,0
0,1,0,0,1,1,1,7.74,1.5,17.41,0.0,5,0.67,0.97,2,3,2,0,0
0,1,0,0,1,1,1,5.33,1.5,12.0,0.0,4,0.67,0.67,1,3,1,0,0
0,1,0,0,1,1,1,5.33,1.5,12.0,0.0,4,0.67,0.67,1,3,1,0,0
0,1,0,0,1,1,1,7.74,1.5,17.41,0.0,5,0.67,0.97,2,3,2,0,0
0,1,0,0,1,1,1,7.74,1.5,17.41,0.0,5,0.67,0.97,2,3,2,0,0
0,1,0,0,1,1,1,0.0,0.0,0.0,0.0,1,0.0,0.0,0,1,0,0,0
0,1,0,0,1,1,1,7.74,1.5,17.41,0.0,5,0.67,0.97,2,3,2,0,0
9,3,0,2,2,1,1,33.0,4.85,774.95,0.05,37,0.21,43.05,18,19,13,9,0
9,3,0,2,2,1,1,33.0,4.85,774.95,0.05,37,0.21,43.05,18,19,13,9,0
2,1,0,0,1,1,1,7.35,8.0,470.48,0.02,17,0.13,26.14,6,11,3,2,0
2,1,0,0,1,1,1,7.81,9.0,632.78,0.02,19,0.11,35.15,8,11,4,2,0
0,1,0,0,1,1,1,5.33,1.5,12.0,0.0,4,0.67,0.67,1,3,1,0,0
0,1,0,0,1,1,1,7.74,1.5,17.41,0.0,5,0.67,0.97,2,3,2,0,0
0,1,0,0,1,1,1,7.74,1.5,17.41,0.0,5,0.67,0.97,2,3,2,0,0
0,1,0,0,1,1,1,7.86,2.5,49.13,0.01,7,0.4,2.73,2,5,2,0,0
0,1,0,0,1,1,1,7.86,2.5,49.13,0.01,7,0.4,2.73,2,5,2,0,0
0,1,0,0,1,1,1,7.74,1.5,17.41,0.0,5,0.67,0.97,2,3,2,0,0
0,1,0,0,1,1,1,5.33,1.5,12.0,0.0,4,0.67,0.67,1,3,1,0,0
0,1,0,0,1,1,1,5.33,1.5,12.0,0.0,4,0.67,0.67,1,3,1,0,0
0,1,0,0,1,1,1,5.33,1.5,12.0,0.0,4,0.67,0.67,1,3,1,0,0
0,1,0,0,1,1,1,5.33,1.5,12.0,0.0,4,0.67,0.67,1,3,1,0,0
0,1,0,0,1,1,1,5.33,1.5,12.0,0.0,4,0.67,0.67,1,3,1,0,0
0,1,0,0,1,1,1,5.33,1.5,12.0,0.0,4,0.67,0.67,1,3,1,0,0
0,1,0,0,1,1,1,5.33,1.5,12.0,0.0,4,0.67,0.67,1,3,1,0,0
0,1,0,0,1,1,1,5.33,1.5,12.0,0.0,4,0.67,0.67,1,3,1,0,0
0,1,0,0,1,1,1,5.33,1.5,12.0,0.0,4,0.67,0.67,1,3,1,0,0
0,1,0,0,1,1,1,5.33,1.5,12.0,0.0,4,0.67,0.67,1,3,1,0,0
0,1,0,0,1,1,1,5.33,1.5,12.0,0.0,4,0.67,0.67,1,3,1,0,0
0,1,0,0,1,1,1,5.8,2.0,23.22,0.0,5,0.5,1.29,1,4,1,0,0
0,1,0,0,1,1,1,5.33,1.5,12.0,0.0,4,0.67,0.67,1,3,1,0,0
0,1,0,0,1,1,1,5.33,1.5,12.0,0.0,4,0.67,0.67,1,3,1,0,0
0,1,0,0,1,1,1,5.33,1.5,12.0,0.0,4,0.67,0.67,1,3,1,0,0
0,1,0,0,1,1,1,5.33,1.5,12.0,0.0,4,0.67,0.67,1,3,1,0,0
0,1,0,0,1,1,1,5.33,1.5,12.0,0.0,4,0.67,0.67,1,3,1,0,0
0,1,0,0,1,1,1,5.33,1.5,12.0,0.0,4,0.67,0.67,1,3,1,0,0
0,1,0,0,1,1,1,5.33,1.5,12.0,0.0,4,0.67,0.67,1,3,1,0,0
0,1,0,0,1,1,1,5.33,1.5,12.0,0.0,4,0.67,0.67,1,3,1,0,0
0,1,0,0,1,1,1,5.33,1.5,12.0,0.0,4,0.67,0.67,1,3,1,0,0
0,1,0,0,1,1,1,5.33,1.5,12.0,0.0,4,0.67,0.67,1,3,1,0,0
0,1,0,0,1,1,1,7.74,1.5,17.41,0.0,5,0.67,0.97,2,3,2,0,0
0,1,0,0,1,1,1,5.33,1.5,12.0,0.0,4,0.67,0.67,1,3,1,0,0
0,1,0,0,1,1,1,7.86,2.5,49.13,0.01,7,0.4,2.73,2,5,2,0,0
0,1,0,0,1,1,1,0.0,0.0,0.0,0.0,3,0.0,0.0,0,3,0,0,0
17,5,0,3,1,1,1,30.3,8.07,1971.68,0.08,52,0.12,109.54,22,30,15,17,0
17,5,0,3,1,1,1,30.3,8.07,1971.68,0.08,52,0.12,109.54,22,30,15,17,0
0,1,0,0,1,1,1,7.74,1.5,17.41,0.0,5,0.67,0.97,2,3,2,0,0
0,1,0,0,1,1,1,4.75,1.0,4.75,0.0,3,1.0,0.26,1,2,1,0,0
0,1,0,0,1,1,1,7.74,1.5,17.41,0.0,5,0.67,0.97,2,3,2,0,0
0,1,0,0,1,1,1,7.74,1.5,17.41,0.0,5,0.67,0.97,2,3,2,0,0
0,1,0,0,1,1,1,7.74,1.5,17.41,0.0,5,0.67,0.97,2,3,2,0,0
0,1,0,0,1,1,1,7.74,1.5,17.41,0.0,5,0.67,0.97,2,3,2,0,0
0,1,0,0,1,1,1,7.74,1.5,17.41,0.0,5,0.67,0.97,2,3,2,0,0
0,1,0,0,1,1,1,7.74,1.5,17.41,0.0,5,0.67,0.97,2,3,2,0,0
0,1,0,0,1,1,1,5.33,1.5,12.0,0.0,4,0.67,0.67,1,3,1,0,0
6,7,0,0,4,3,1,14.76,4.5,298.97,0.02,20,0.22,16.61,9,11,5,6,0
6,7,0,0,4,3,1,14.76,4.5,298.97,0.02,20,0.22,16.61,9,11,5,6,0
4,1,0,0,1,1,1,16.21,2.25,82.12,0.01,13,0.44,4.56,6,7,4,4,0
4,1,0,0,1,1,1,16.21,2.25,82.12,0.01,13,0.44,4.56,6,7,4,4,0
0,1,0,0,1,1,1,5.33,1.5,12.0,0.0,4,0.67,0.67,1,3,1,0,0
0,1,0,0,1,1,1,5.33,1.5,12.0,0.0,4,0.67,0.67,1,3,1,0,0
16,15,12,1,8,4,4,19.61,21.53,9092.65,0.14,83,0.05,505.15,34,49,15,28,0
16,15,12,1,8,4,4,18.69,23.33,10173.08,0.15,85,0.04,565.17,35,50,15,28,0
3,3,2,0,2,1,1,8.42,7.5,473.37,0.02,19,0.13,26.3,10,9,4,5,0
3,3,2,0,2,1,1,8.42,7.5,473.37,0.02,19,0.13,26.3,10,9,4,5,0
12,5,3,3,3,1,1,14.97,14.7,3235.15,0.07,48,0.07,179.73,21,27,10,15,0
12,5,3,3,3,1,1,16.68,13.36,2978.82,0.07,48,0.07,165.49,21,27,11,15,0
8,5,8,1,3,2,1,23.2,14.23,4699.28,0.11,73,0.07,261.07,37,36,13,16,0
8,5,8,1,3,2,1,23.2,14.23,4699.28,0.11,73,0.07,261.07,37,36,13,16,0
12,5,5,0,3,1,1,12.95,14.44,2698.5,0.06,44,0.07,149.92,21,23,8,17,0
12,5,5,0,3,1,1,14.82,12.83,2440.45,0.06,44,0.08,135.58,21,23,9,17,0
9,3,2,0,2,1,1,12.13,11.0,1467.81,0.04,32,0.09,81.55,11,21,6,11,0
9,3,2,0,2,1,1,12.13,11.0,1467.81,0.04,32,0.09,81.55,11,21,6,11,0
9,3,2,0,2,1,1,12.13,11.0,1467.81,0.04,32,0.09,81.55,11,21,6,11,0
9,3,2,0,2,1,1,12.13,11.0,1467.81,0.04,32,0.09,81.55,11,21,6,11,0
9,3,2,0,2,1,1,12.13,11.0,1467.81,0.04,32,0.09,81.55,11,21,6,11,0
9,3,2,0,2,1,1,12.13,11.0,1467.81,0.04,32,0.09,81.55,11,21,6,11,0
9,3,2,0,2,1,1,12.13,11.0,1467.81,0.04,32,0.09,81.55,11,21,6,11,0
9,3,2,0,2,1,1,12.13,11.0,1467.81,0.04,32,0.09,81.55,11,21,6,11,0
9,3,2,0,2,1,1,12.13,11.0,1467.81,0.04,32,0.09,81.55,11,21,6,11,0
9,3,2,0,2,1,1,12.13,11.0,1467.81,0.04,32,0.09,81.55,11,21,6,11,0
9,3,2,0,2,1,1,12.13,11.0,1467.81,0.04,32,0.09,81.55,11,21,6,11,0
9,3,2,0,2,1,1,12.13,11.0,1467.81,0.04,32,0.09,81.55,11,21,6,11,0
9,3,2,0,2,1,1,12.13,11.0,1467.81,0.04,32,0.09,81.55,11,21,6,11,0
9,3,2,0,2,1,1,12.13,11.0,1467.81,0.04,32,0.09,81.55,11,21,6,11,0
9,3,2,0,2,1,1,12.13,11.0,1467.81,0.04,32,0.09,81.55,11,21,6,11,0
9,3,2,0,2,1,1,12.13,11.0,1467.81,0.04,32,0.09,81.55,11,21,6,11,0
9,3,2,0,2,1,1,12.13,11.0,1467.81,0.04,32,0.09,81.55,11,21,6,11,0
9,3,2,0,2,1,1,12.13,11.0,1467.81,0.04,32,0.09,81.55,11,21,6,11,0
9,3,2,0,2,1,1,12.13,11.0,1467.81,0.04,32,0.09,81.55,11,21,6,11,0
9,3,2,0,2,1,1,12.13,11.0,1467.81,0.04,32,0.09,81.55,11,21,6,11,0
43,23,9,6,17,15,7,34.14,30.0,30723.65,0.34,172,0.03,1706.87,64,108,32,52,0
43,23,9,6,17,15,7,34.14,30.0,30723.65,0.34,172,0.03,1706.87,64,108,32,52,0
43,23,9,6,17,15,7,34.14,30.0,30723.65,0.34,172,0.03,1706.87,64,108,32,52,0
43,23,9,6,17,15,7,34.14,30.0,30723.65,0.34,172,0.03,1706.87,64,108,32,52,0
43,23,9,6,17,15,7,34.14,30.0,30723.65,0.34,172,0.03,1706.87,64,108,32,52,0
43,23,9,6,17,15,7,34.14,30.0,30723.65,0.34,172,0.03,1706.87,64,108,32,52,0
43,23,9,6,17,15,7,34.14,30.0,30723.65,0.34,172,0.03,1706.87,64,108,32,52,0
43,23,9,6,17,15,7,34.14,30.0,30723.65,0.34,172,0.03,1706.87,64,108,32,52,0
43,23,9,6,17,15,7,34.14,30.0,30723.65,0.34,172,0.03,1706.87,64,108,32,52,0
43,23,9,6,17,15,7,34.14,30.0,30723.65,0.34,172,0.03,1706.87,64,108,32,52,0
43,23,9,6,17,15,7,34.14,30.0,30723.65,0.34,172,0.03,1706.87,64,108,32,52,0
43,23,9,6,17,15,7,34.14,30.0,30723.65,0.34,172,0.03,1706.87,64,108,32,52,0
43,23,9,6,17,15,7,34.14,30.0,30723.65,0.34,172,0.03,1706.87,64,108,32,52,0
43,23,9,6,17,15,7,34.14,30.0,30723.65,0.34,172,0.03,1706.87,64,108,32,52,0
43,23,9,6,17,15,7,34.14,30.0,30723.65,0.34,172,0.03,1706.87,64,108,32,52,0
43,23,9,6,17,15,7,34.14,30.0,30723.65,0.34,172,0.03,1706.87,64,108,32,52,0
43,23,9,6,17,15,7,34.14,30.0,30723.65,0.34,172,0.03,1706.87,64,108,32,52,0
43,23,9,6,17,15,7,34.14,30.0,30723.65,0.34,172,0.03,1706.87,64,108,32,52,0
43,23,9,6,17,15,7,34.14,30.0,30723.65,0.34,172,0.03,1706.87,64,108,32,52,0
43,23,9,6,17,15,7,34.14,30.0,30723.65,0.34,172,0.03,1706.87,64,108,32,52,0
36,1,2,4,1,1,1,96.51,10.29,10209.86,0.33,192,0.1,567.21,72,120,28,38,0
36,1,2,4,1,1,1,96.51,10.29,10209.86,0.33,192,0.1,567.21,72,120,28,38,0
36,1,2,4,1,1,1,96.51,10.29,10209.86,0.33,192,0.1,567.21,72,120,28,38,0
36,1,2,4,1,1,1,96.51,10.29,10209.86,0.33,192,0.1,567.21,72,120,28,38,0
36,1,2,4,1,1,1,96.51,10.29,10209.86,0.33,192,0.1,567.21,72,120,28,38,0
36,1,2,4,1,1,1,96.51,10.29,10209.86,0.33,192,0.1,567.21,72,120,28,38,0
36,1,2,4,1,1,1,96.51,10.29,10209.86,0.33,192,0.1,567.21,72,120,28,38,0
36,1,2,4,1,1,1,96.51,10.29,10209.86,0.33,192,0.1,567.21,72,120,28,38,0
36,1,2,4,1,1,1,96.51,10.29,10209.86,0.33,192,0.1,567.21,72,120,28,38,0
36,1,2,4,1,1,1,96.51,10.29,10209.86,0.33,192,0.1,567.21,72,120,28,38,0
36,1,2,4,1,1,1,96.51,10.29,10209.86,0.33,192,0.1,567.21,72,120,28,38,0
36,1,2,4,1,1,1,96.51,10.29,10209.86,0.33,192,0.1,567.21,72,120,28,38,0
36,1,2,4,1,1,1,96.51,10.29,10209.86,0.33,192,0.1,567.21,72,120,28,38,0
36,1,2,4,1,1,1,96.51,10.29,10209.86,0.33,192,0.1,567.21,72,120,28,38,0
36,1,2,4,1,1,1,96.51,10.29,10209.86,0.33,192,0.1,567.21,72,120,28,38,0
36,1,2,4,1,1,1,96.51,10.29,10209.86,0.33,192,0.1,567.21,72,120,28,38,0
36,1,2,4,1,1,1,96.51,10.29,10209.86,0.33,192,0.1,567.21,72,120,28,38,0
36,1,2,4,1,1,1,96.51,10.29,10209.86,0.33,192,0.1,567.21,72,120,28,38,0
36,1,2,4,1,1,1,96.51,10.29,10209.86,0.33,192,0.1,567.21,72,120,28,38,0
36,1,2,4,1,1,1,96.51,10.29,10209.86,0.33,192,0.1,567.21,72,120,28,38,0
2,1,3,0,1,1,1,10.75,6.0,387.18,0.02,18,0.17,21.51,6,12,4,5,0
2,1,3,0,1,1,1,10.75,6.0,387.18,0.02,18,0.17,21.51,6,12,4,5,0
2,1,3,0,1,1,1,10.75,6.0,387.18,0.02,18,0.17,21.51,6,12,4,5,0
2,1,3,0,1,1,1,10.75,6.0,387.18,0.02,18,0.17,21.51,6,12,4,5,0
2,1,3,0,1,1,1,10.75,6.0,387.18,0.02,18,0.17,21.51,6,12,4,5,0
2,1,3,0,1,1,1,10.75,6.0,387.18,0.02,18,0.17,21.51,6,12,4,5,0
2,1,3,0,1,1,1,10.75,6.0,387.18,0.02,18,0.17,21.51,6,12,4,5,0
2,1,3,0,1,1,1,10.75,6.0,387.18,0.02,18,0.17,21.51,6,12,4,5,0
2,1,3,0,1,1,1,10.75,6.0,387.18,0.02,18,0.17,21.51,6,12,4,5,0
2,1,3,0,1,1,1,10.75,6.0,387.18,0.02,18,0.17,21.51,6,12,4,5,0
2,1,3,0,1,1,1,10.75,6.0,387.18,0.02,18,0.17,21.51,6,12,4,5,0
2,1,3,0,1,1,1,10.75,6.0,387.18,0.02,18,0.17,21.51,6,12,4,5,0
2,1,3,0,1,1,1,10.75,6.0,387.18,0.02,18,0.17,21.51,6,12,4,5,0
2,1,3,0,1,1,1,10.75,6.0,387.18,0.02,18,0.17,21.51,6,12,4,5,0
2,1,3,0,1,1,1,10.75,6.0,387.18,0.02,18,0.17,21.51,6,12,4,5,0
2,1,3,0,1,1,1,10.75,6.0,387.18,0.02,18,0.17,21.51,6,12,4,5,0
2,1,3,0,1,1,1,10.75,6.0,387.18,0.02,18,0.17,21.51,6,12,4,5,0
2,1,3,0,1,1,1,10.75,6.0,387.18,0.02,18,0.17,21.51,6,12,4,5,0
2,1,3,0,1,1,1,10.75,6.0,387.18,0.02,18,0.17,21.51,6,12,4,5,0
2,1,3,0,1,1,1,10.75,6.0,387.18,0.02,18,0.17,21.51,6,12,4,5,0
48,17,32,3,13,10,4,34.8,34.72,41961.57,0.4,212,0.03,2331.2,75,137,27,80,0
48,17,32,3,13,10,4,49.82,25.34,31983.69,0.42,212,0.04,1776.87,75,137,37,80,0
48,17,32,3,13,10,4,34.8,34.72,41961.57,0.4,212,0.03,2331.2,75,137,27,80,0
48,17,32,3,13,10,4,49.82,25.34,31983.69,0.42,212,0.04,1776.87,75,137,37,80,0
48,17,32,3,13,10,4,34.8,34.72,41961.57,0.4,212,0.03,2331.2,75,137,27,80,0
48,17,32,3,13,10,4,49.82,25.34,31983.69,0.42,212,0.04,1776.87,75,137,37,80,0
48,17,32,3,13,10,4,34.8,34.72,41961.57,0.4,212,0.03,2331.2,75,137,27,80,0
48,17,32,3,13,10,4,34.8,34.72,41961.57,0.4,212,0.03,2331.2,75,137,27,80,0
48,17,32,3,13,10,4,34.8,34.72,41961.57,0.4,212,0.03,2331.2,75,137,27,80,0
48,17,32,3,13,10,4,49.82,25.34,31983.69,0.42,212,0.04,1776.87,75,137,37,80,0
48,17,32,3,13,10,4,49.82,25.34,31983.69,0.42,212,0.04,1776.87,75,137,37,80,0
48,17,32,3,13,10,4,49.82,25.34,31983.69,0.42,212,0.04,1776.87,75,137,37,80,0
48,17,32,3,13,10,4,34.8,34.72,41961.57,0.4,212,0.03,2331.2,75,137,27,80,0
48,17,32,3,13,10,4,34.8,34.72,41961.57,0.4,212,0.03,2331.2,75,137,27,80,0
48,17,32,3,13,10,4,49.82,25.34,31983.69,0.42,212,0.04,1776.87,75,137,37,80,0
48,17,32,3,13,10,4,34.8,34.72,41961.57,0.4,212,0.03,2331.2,75,137,27,80,0
48,17,32,3,13,10,4,49.82,25.34,31983.69,0.42,212,0.04,1776.87,75,137,37,80,0
48,17,32,3,13,10,4,34.8,34.72,41961.57,0.4,212,0.03,2331.2,75,137,27,80,0
48,17,32,3,13,10,4,49.82,25.34,31983.69,0.42,212,0.04,1776.87,75,137,37,80,0
39,5,2,4,3,2,3,55.48,19.5,21096.95,0.36,197,0.05,1172.05,96,101,32,41,0
39,5,2,4,3,2,3,55.48,19.5,21096.95,0.36,197,0.05,1172.05,96,101,32,41,0
39,5,2,4,3,2,3,55.48,19.5,21096.95,0.36,197,0.05,1172.05,96,101,32,41,0
27,11,0,2,7,1,3,24.84,20.65,10590.46,0.17,100,0.05,588.36,39,61,17,27,0
27,11,0,2,7,1,3,24.84,20.65,10590.46,0.17,100,0.05,588.36,39,61,17,27,0
31,11,0,3,7,1,3,27.23,23.81,15434.85,0.22,121,0.04,857.49,50,71,21,31,0
31,11,0,3,7,1,3,27.23,23.81,15434.85,0.22,121,0.04,857.49,50,71,21,31,0
0,1,0,0,1,1,1,0.0,0.0,0.0,0.0,3,0.0,0.0,0,3,0,0,0
0,1,0,0,1,1,1,0.0,0.0,0.0,0.0,2,0.0,0.0,0,2,0,0,0
0,1,0,0,1,1,1,5.33,1.5,12.0,0.0,4,0.67,0.67,1,3,1,0,0
0,1,0,0,1,1,1,5.33,1.5,12.0,0.0,4,0.67,0.67,1,3,1,0,0
0,1,0,0,1,1,1,7.74,1.5,17.41,0.0,5,0.67,0.97,2,3,2,0,0
0,1,0,0,1,1,1,7.74,1.5,17.41,0.0,5,0.67,0.97,2,3,2,0,0
1,1,0,0,1,1,1,0.0,0.0,0.0,0.0,1,0.0,0.0,0,1,0,1,0
1,1,0,0,1,1,1,0.0,0.0,0.0,0.0,1,0.0,0.0,0,1,0,1,0
3,1,0,0,1,1,1,13.2,2.5,82.5,0.01,11,0.4,4.58,5,6,4,3,0
3,1,0,0,1,1,1,13.2,2.5,82.5,0.01,11,0.4,4.58,5,6,4,3,0
3,1,0,0,1,1,1,13.2,2.5,82.5,0.01,11,0.4,4.58,5,6,4,3,0
3,1,0,0,1,1,1,13.2,2.5,82.5,0.01,11,0.4,4.58,5,6,4,3,0
1,1,0,0,1,1,1,0.0,0.0,0.0,0.0,1,0.0,0.0,0,1,0,1,0
40,31,3,0,16,1,7,42.94,41.35,73428.57,0.59,310,0.02,4079.37,148,162,34,43,0
11,1,0,0,1,1,1,56.4,3.33,626.61,0.06,41,0.3,34.81,20,21,18,11,0
11,1,0,0,1,1,1,51.18,4.08,853.31,0.07,45,0.24,47.41,21,24,18,11,0
11,1,0,0,1,1,1,51.18,4.08,853.31,0.07,45,0.24,47.41,21,24,18,11,0
1,1,0,0,1,1,1,0.0,0.0,0.0,0.0,1,0.0,0.0,0,1,0,1,0
7,1,0,0,1,1,1,25.18,7.5,1416.52,0.06,43,0.13,78.7,20,23,12,7,0
8,1,0,0,1,1,1,74.67,1.5,168.0,0.04,28,0.67,9.33,13,15,13,8,0
8,1,0,0,1,1,1,74.67,1.5,168.0,0.04,28,0.67,9.33,13,15,13,8,0
8,3,0,0,2,1,1,32.36,3.5,396.55,0.04,29,0.29,22.03,14,15,10,8,0
5,3,0,0,2,1,1,10.41,6.4,426.29,0.02,18,0.16,23.68,8,10,5,5,0
5,3,0,0,2,1,1,10.41,6.4,426.29,0.02,18,0.16,23.68,8,10,5,5,0
5,3,0,0,2,1,1,10.41,6.4,426.29,0.02,18,0.16,23.68,8,10,5,5,0
0,1,0,0,1,1,1,5.33,1.5,12.0,0.0,4,0.67,0.67,1,3,1,0,0
0,1,0,0,1,1,1,7.74,1.5,17.41,0.0,5,0.67,0.97,2,3,2,0,0
0,1,0,0,1,1,1,5.33,1.5,12.0,0.0,4,0.67,0.67,1,3,1,0,0
0,1,0,0,1,1,1,5.33,1.5,12.0,0.0,4,0.67,0.67,1,3,1,0,0
0,1,0,0,1,1,1,5.33,1.5,12.0,0.0,4,0.67,0.67,1,3,1,0,0
0,1,0,0,1,1,1,5.33,1.5,12.0,0.0,4,0.67,0.67,1,3,1,0,0
0,1,0,0,1,1,1,5.33,1.5,12.0,0.0,4,0.67,0.67,1,3,1,0,0
0,1,0,0,1,1,1,5.33,1.5,12.0,0.0,4,0.67,0.67,1,3,1,0,0
0,1,0,0,1,1,1,5.33,1.5,12.0,0.0,4,0.67,0.67,1,3,1,0,0
0,1,0,0,1,1,1,5.33,1.5,12.0,0.0,4,0.67,0.67,1,3,1,0,0
0,1,0,0,1,1,1,7.75,2.0,31.02,0.01,6,0.5,1.72,2,4,2,0,0
0,1,0,0,1,1,1,7.74,1.5,17.41,0.0,5,0.67,0.97,2,3,2,0,0
0,1,0,0,1,1,1,7.74,1.5,17.41,0.0,5,0.67,0.97,2,3,2,0,0
0,1,0,0,1,1,1,5.33,1.5,12.0,0.0,4,0.67,0.67,1,3,1,0,0
3,3,0,0,2,2,1,7.75,2.0,31.02,0.01,6,0.5,1.72,2,4,2,3,0
0,1,0,0,1,1,1,0.0,0.0,0.0,0.0,1,0.0,0.0,0,1,0,0,0
0,1,0,0,1,1,1,0.0,0.0,0.0,0.0,0,0.0,0.0,0,0,0,0,0
0,1,0,0,1,1,1,5.33,1.5,12.0,0.0,4,0.67,0.67,1,3,1,0,0
0,1,0,0,1,1,1,5.33,1.5,12.0,0.0,4,0.67,0.67,1,3,1,0,0
0,1,0,0,1,1,1,5.33,1.5,12.0,0.0,4,0.67,0.67,1,3,1,0,0
0,1,0,0,1,1,1,5.33,1.5,12.0,0.0,4,0.67,0.67,1,3,1,0,0
0,1,0,0,1,1,1,5.33,1.5,12.0,0.0,4,0.67,0.67,1,3,1,0,0
0,1,0,0,1,1,1,9.51,3.0,85.59,0.01,9,0.33,4.75,3,6,3,0,0
0,1,0,0,1,1,1,5.33,1.5,12.0,0.0,4,0.67,0.67,1,3,1,0,0
0,1,0,0,1,1,1,5.33,1.5,12.0,0.0,4,0.67,0.67,1,3,1,0,0
0,1,0,0,1,1,1,5.33,1.5,12.0,0.0,4,0.67,0.67,1,3,1,0,0
0,1,0,0,1,1,1,0.0,0.0,0.0,0.0,1,0.0,0.0,0,1,0,0,0
0,1,0,0,1,1,1,0.0,0.0,0.0,0.0,1,0.0,0.0,0,1,0,0,0
0,1,0,0,1,1,1,0.0,0.0,0.0,0.0,3,0.0,0.0,0,3,0,0,0
0,1,0,0,1,1,1,0.0,0.0,0.0,0.0,2,0.0,0.0,0,2,0,0,0
0,1,0,0,1,1,1,5.33,1.5,12.0,0.0,4,0.67,0.67,1,3,1,0,0
0,1,0,0,1,1,1,5.33,1.5,12.0,0.0,4,0.67,0.67,1,3,1,0,0
0,1,0,0,1,1,1,5.33,1.5,12.0,0.0,4,0.67,0.67,1,3,1,0,0
0,1,0,0,1,1,1,7.74,1.5,17.41,0.0,5,0.67,0.97,2,3,2,0,0
0,1,0,0,1,1,1,0.0,0.0,0.0,0.0,1,0.0,0.0,0,1,0,0,0
7,1,0,0,1,1,1,44.81,2.0,179.25,0.03,25,0.5,9.96,12,13,9,7,0
2,1,0,0,1,1,1,7.35,8.0,470.48,0.02,17,0.13,26.14,6,11,3,2,0
2,1,0,0,1,1,1,7.81,9.0,632.78,0.02,19,0.11,35.15,8,11,4,2,0
0,1,0,0,1,1,1,7.74,1.5,17.41,0.0,5,0.67,0.97,2,3,2,0,0
0,1,0,0,1,1,1,16.5,2.0,66.0,0.01,11,0.5,3.67,4,7,4,0,0
0,1,0,0,1,1,1,5.33,1.5,12.0,0.0,4,0.67,0.67,1,3,1,0,0
0,1,0,0,1,1,1,16.5,2.0,66.0,0.01,11,0.5,3.67,4,7,4,0,0
0,1,0,0,1,1,1,5.33,1.5,12.0,0.0,4,0.67,0.67,1,3,1,0,0
0,1,0,0,1,1,1,5.33,1.5,12.0,0.0,4,0.67,0.67,1,3,1,0,0
0,1,0,0,1,1,1,16.5,2.0,66.0,0.01,11,0.5,3.67,4,7,4,0,0
0,1,0,0,1,1,1,5.33,1.5,12.0,0.0,4,0.67,0.67,1,3,1,0,0
0,1,0,0,1,1,1,7.74,1.5,17.41,0.0,5,0.67,0.97,2,3,2,0,0
0,1,0,0,1,1,1,7.74,1.5,17.41,0.0,5,0.67,0.97,2,3,2,0,0
0,1,0,0,1,1,1,16.84,1.5,37.9,0.01,9,0.67,2.11,4,5,4,0,0
0,1,0,0,1,1,1,7.74,1.5,17.41,0.0,5,0.67,0.97,2,3,2,0,0
0,1,0,0,1,1,1,16.84,1.5,37.9,0.01,9,0.67,2.11,4,5,4,0,0
0,1,0,0,1,1,1,7.74,1.5,17.41,0.0,5,0.67,0.97,2,3,2,0,0
0,1,0,0,1,1,1,7.74,1.5,17.41,0.0,5,0.67,0.97,2,3,2,0,0
0,1,0,0,1,1,1,7.86,2.5,49.13,0.01,7,0.4,2.73,2,5,2,0,0
0,1,0,0,1,1,1,5.33,1.5,12.0,0.0,4,0.67,0.67,1,3,1,0,0
0,1,0,0,1,1,1,5.33,1.5,12.0,0.0,4,0.67,0.67,1,3,1,0,0
0,1,0,0,1,1,1,5.33,1.5,12.0,0.0,4,0.67,0.67,1,3,1,0,0
0,1,0,0,1,1,1,5.33,1.5,12.0,0.0,4,0.67,0.67,1,3,1,0,0
0,1,0,0,1,1,1,5.33,1.5,12.0,0.0,4,0.67,0.67,1,3,1,0,0
0,1,0,0,1,1,1,5.33,1.5,12.0,0.0,4,0.67,0.67,1,3,1,0,0
0,1,0,0,1,1,1,5.33,1.5,12.0,0.0,4,0.67,0.67,1,3,1,0,0
0,1,0,0,1,1,1,5.33,1.5,12.0,0.0,4,0.67,0.67,1,3,1,0,0
0,1,0,0,1,1,1,5.33,1.5,12.0,0.0,4,0.67,0.67,1,3,1,0,0
0,1,0,0,1,1,1,5.33,1.5,12.0,0.0,4,0.67,0.67,1,3,1,0,0
0,1,0,0,1,1,1,6.2,2.5,38.77,0.01,6,0.4,2.15,1,5,1,0,0
0,1,0,0,1,1,1,5.33,1.5,12.0,0.0,4,0.67,0.67,1,3,1,0,0
0,1,0,0,1,1,1,5.33,1.5,12.0,0.0,4,0.67,0.67,1,3,1,0,0
0,1,0,0,1,1,1,5.33,1.5,12.0,0.0,4,0.67,0.67,1,3,1,0,0
0,1,0,0,1,1,1,5.33,1.5,12.0,0.0,4,0.67,0.67,1,3,1,0,0
0,1,0,0,1,1,1,5.33,1.5,12.0,0.0,4,0.67,0.67,1,3,1,0,0
0,1,0,0,1,1,1,5.33,1.5,12.0,0.0,4,0.67,0.67,1,3,1,0,0
0,1,0,0,1,1,1,5.33,1.5,12.0,0.0,4,0.67,0.67,1,3,1,0,0
0,1,0,0,1,1,1,5.33,1.5,12.0,0.0,4,0.67,0.67,1,3,1,0,0
0,1,0,0,1,1,1,5.33,1.5,12.0,0.0,4,0.67,0.67,1,3,1,0,0
0,1,0,0,1,1,1,5.33,1.5,12.0,0.0,4,0.67,0.67,1,3,1,0,0
0,1,0,0,1,1,1,7.86,2.5,49.13,0.01,7,0.4,2.73,2,5,2,0,0
0,1,0,0,1,1,1,5.33,1.5,12.0,0.0,4,0.67,0.67,1,3,1,0,0
0,1,0,0,1,1,1,7.86,2.5,49.13,0.01,7,0.4,2.73,2,5,2,0,0
0,1,0,0,1,1,1,0.0,0.0,0.0,0.0,3,0.0,0.0,0,3,0,0,0
0,1,0,0,1,1,1,7.74,1.5,17.41,0.0,5,0.67,0.97,2,3,2,0,0
0,1,0,0,1,1,1,7.74,1.5,17.41,0.0,5,0.67,0.97,2,3,2,0,0
0,1,0,0,1,1,1,7.74,1.5,17.41,0.0,5,0.67,0.97,2,3,2,0,0
0,1,0,0,1,1,1,7.74,1.5,17.41,0.0,5,0.67,0.97,2,3,2,0,0
0,1,0,0,1,1,1,7.74,1.5,17.41,0.0,5,0.67,0.97,2,3,2,0,0
0,1,0,0,1,1,1,7.74,1.5,17.41,0.0,5,0.67,0.97,2,3,2,0,0
0,1,0,0,1,1,1,7.74,1.5,17.41,0.0,5,0.67,0.97,2,3,2,0,0
0,1,0,0,1,1,1,5.8,2.0,23.22,0.0,5,0.5,1.29,1,4,1,0,0
5,5,0,0,3,2,1,11.52,3.75,161.94,0.01,13,0.27,9.0,5,8,4,5,0
0,1,0,0,1,1,1,0.0,0.0,0.0,0.0,1,0.0,0.0,0,1,0,0,0
0,1,0,0,1,1,1,0.0,0.0,0.0,0.0,0,0.0,0.0,0,0,0,0,0
0,1,0,0,1,1,1,5.33,1.5,12.0,0.0,4,0.67,0.67,1,3,1,0,0
0,1,0,0,1,1,1,5.33,1.5,12.0,0.0,4,0.67,0.67,1,3,1,0,0
0,1,0,0,1,1,1,5.33,1.5,12.0,0.0,4,0.67,0.67,1,3,1,0,0
0,1,0,0,1,1,1,5.33,1.5,12.0,0.0,4,0.67,0.67,1,3,1,0,0
0,1,0,0,1,1,1,5.33,1.5,12.0,0.0,4,0.67,0.67,1,3,1,0,0
0,1,0,0,1,1,1,9.51,3.0,85.59,0.01,9,0.33,4.75,3,6,3,0,0
0,1,0,0,1,1,1,5.33,1.5,12.0,0.0,4,0.67,0.67,1,3,1,0,0
0,1,0,0,1,1,1,5.33,1.5,12.0,0.0,4,0.67,0.67,1,3,1,0,0
0,1,0,0,1,1,1,5.33,1.5,12.0,0.0,4,0.67,0.67,1,3,1,0,0
0,1,0,0,1,1,1,0.0,0.0,0.0,0.0,1,0.0,0.0,0,1,0,0,0
0,1,0,0,1,1,1,0.0,0.0,0.0,0.0,1,0.0,0.0,0,1,0,0,0
0,1,0,0,1,1,1,0.0,0.0,0.0,0.0,3,0.0,0.0,0,3,0,0,0
0,1,0,0,1,1,1,0.0,0.0,0.0,0.0,2,0.0,0.0,0,2,0,0,0
0,1,0,0,1,1,1,5.33,1.5,12.0,0.0,4,0.67,0.67,1,3,1,0,0
0,1,0,0,1,1,1,5.33,1.5,12.0,0.0,4,0.67,0.67,1,3,1,0,0
0,1,0,0,1,1,1,5.33,1.5,12.0,0.0,4,0.67,0.67,1,3,1,0,0
0,1,0,0,1,1,1,7.74,1.5,17.41,0.0,5,0.67,0.97,2,3,2,0,0
0,1,0,0,1,1,1,0.0,0.0,0.0,0.0,1,0.0,0.0,0,1,0,0,0
8,1,2,1,1,1,1,62.55,3.0,562.94,0.06,45,0.33,31.27,21,24,14,10,0
0,1,0,0,1,1,1,7.74,1.5,17.41,0.0,5,0.67,0.97,2,3,2,0,0
0,1,0,0,1,1,1,16.5,2.0,66.0,0.01,11,0.5,3.67,4,7,4,0,0
0,1,0,0,1,1,1,5.33,1.5,12.0,0.0,4,0.67,0.67,1,3,1,0,0
0,1,0,0,1,1,1,16.5,2.0,66.0,0.01,11,0.5,3.67,4,7,4,0,0
0,1,0,0,1,1,1,5.33,1.5,12.0,0.0,4,0.67,0.67,1,3,1,0,0
0,1,0,0,1,1,1,5.33,1.5,12.0,0.0,4,0.67,0.67,1,3,1,0,0
0,1,0,0,1,1,1,16.5,2.0,66.0,0.01,11,0.5,3.67,4,7,4,0,0
0,1,0,0,1,1,1,5.33,1.5,12.0,0.0,4,0.67,0.67,1,3,1,0,0
0,1,0,0,1,1,1,7.74,1.5,17.41,0.0,5,0.67,0.97,2,3,2,0,0
0,1,0,0,1,1,1,7.74,1.5,17.41,0.0,5,0.67,0.97,2,3,2,0,0
0,1,0,0,1,1,1,16.84,1.5,37.9,0.01,9,0.67,2.11,4,5,4,0,0
0,1,0,0,1,1,1,7.74,1.5,17.41,0.0,5,0.67,0.97,2,3,2,0,0
0,1,0,0,1,1,1,16.84,1.5,37.9,0.01,9,0.67,2.11,4,5,4,0,0
0,1,0,0,1,1,1,7.74,1.5,17.41,0.0,5,0.67,0.97,2,3,2,0,0
2,1,0,0,1,1,1,7.35,8.0,470.48,0.02,17,0.13,26.14,6,11,3,2,0
2,1,0,0,1,1,1,7.81,9.0,632.78,0.02,19,0.11,35.15,8,11,4,2,0
0,1,0,0,1,1,1,7.74,1.5,17.41,0.0,5,0.67,0.97,2,3,2,0,0
0,1,0,0,1,1,1,7.86,2.5,49.13,0.01,7,0.4,2.73,2,5,2,0,0
0,1,0,0,1,1,1,5.33,1.5,12.0,0.0,4,0.67,0.67,1,3,1,0,0
0,1,0,0,1,1,1,5.33,1.5,12.0,0.0,4,0.67,0.67,1,3,1,0,0
0,1,0,0,1,1,1,5.33,1.5,12.0,0.0,4,0.67,0.67,1,3,1,0,0
0,1,0,0,1,1,1,5.33,1.5,12.0,0.0,4,0.67,0.67,1,3,1,0,0
0,1,0,0,1,1,1,5.33,1.5,12.0,0.0,4,0.67,0.67,1,3,1,0,0
0,1,0,0,1,1,1,5.33,1.5,12.0,0.0,4,0.67,0.67,1,3,1,0,0
0,1,0,0,1,1,1,5.33,1.5,12.0,0.0,4,0.67,0.67,1,3,1,0,0
0,1,0,0,1,1,1,5.33,1.5,12.0,0.0,4,0.67,0.67,1,3,1,0,0
0,1,0,0,1,1,1,5.33,1.5,12.0,0.0,4,0.67,0.67,1,3,1,0,0
0,1,0,0,1,1,1,5.33,1.5,12.0,0.0,4,0.67,0.67,1,3,1,0,0
0,1,0,0,1,1,1,6.2,2.5,38.77,0.01,6,0.4,2.15,1,5,1,0,0
0,1,0,0,1,1,1,5.33,1.5,12.0,0.0,4,0.67,0.67,1,3,1,0,0
0,1,0,0,1,1,1,5.33,1.5,12.0,0.0,4,0.67,0.67,1,3,1,0,0
0,1,0,0,1,1,1,5.33,1.5,12.0,0.0,4,0.67,0.67,1,3,1,0,0
0,1,0,0,1,1,1,5.33,1.5,12.0,0.0,4,0.67,0.67,1,3,1,0,0
0,1,0,0,1,1,1,5.33,1.5,12.0,0.0,4,0.67,0.67,1,3,1,0,0
0,1,0,0,1,1,1,5.33,1.5,12.0,0.0,4,0.67,0.67,1,3,1,0,0
0,1,0,0,1,1,1,5.33,1.5,12.0,0.0,4,0.67,0.67,1,3,1,0,0
0,1,0,0,1,1,1,5.33,1.5,12.0,0.0,4,0.67,0.67,1,3,1,0,0
0,1,0,0,1,1,1,5.33,1.5,12.0,0.0,4,0.67,0.67,1,3,1,0,0
0,1,0,0,1,1,1,7.86,2.5,49.13,0.01,7,0.4,2.73,2,5,2,0,0
0,1,0,0,1,1,1,5.33,1.5,12.0,0.0,4,0.67,0.67,1,3,1,0,0
0,1,0,0,1,1,1,7.86,2.5,49.13,0.01,7,0.4,2.73,2,5,2,0,0
0,1,0,0,1,1,1,0.0,0.0,0.0,0.0,3,0.0,0.0,0,3,0,0,0
0,1,0,0,1,1,1,7.74,1.5,17.41,0.0,5,0.67,0.97,2,3,2,0,0
0,1,0,0,1,1,1,7.74,1.5,17.41,0.0,5,0.67,0.97,2,3,2,0,0
3,1,0,0,1,1,1,16.84,1.5,37.9,0.01,9,0.67,2.11,4,5,4,3,0
0,1,0,0,1,1,1,7.74,1.5,17.41,0.0,5,0.67,0.97,2,3,2,0,0
0,1,0,0,1,1,1,7.74,1.5,17.41,0.0,5,0.67,0.97,2,3,2,0,0
0,1,0,0,1,1,1,7.74,1.5,17.41,0.0,5,0.67,0.97,2,3,2,0,0
0,1,0,0,1,1,1,7.74,1.5,17.41,0.0,5,0.67,0.97,2,3,2,0,0
0,1,0,0,1,1,1,7.74,1.5,17.41,0.0,5,0.67,0.97,2,3,2,0,0
0,1,0,0,1,1,1,5.8,2.0,23.22,0.0,5,0.5,1.29,1,4,1,0,0
2,1,0,0,1,1,1,5.33,1.5,12.0,0.0,4,0.67,0.67,1,3,1,2,0
2,1,0,0,1,1,1,5.33,1.5,12.0,0.0,4,0.67,0.67,1,3,1,2,0
0,1,0,0,1,1,1,0.0,0.0,0.0,0.0,3,0.0,0.0,0,3,0,0,0
0,1,0,0,1,1,1,0.0,0.0,0.0,0.0,2,0.0,0.0,0,2,0,0,0
0,1,0,0,1,1,1,5.33,1.5,12.0,0.0,4,0.67,0.67,1,3,1,0,0
0,1,0,0,1,1,1,5.33,1.5,12.0,0.0,4,0.67,0.67,1,3,1,0,0
0,1,0,0,1,1,1,0.0,0.0,0.0,0.0,1,0.0,0.0,0,1,0,0,0
15,1,0,3,1,1,1,43.11,8.94,3446.29,0.13,83,0.11,191.46,38,45,17,15,0
15,1,0,3,1,1,1,43.11,8.94,3446.29,0.13,83,0.11,191.46,38,45,17,15,0
2,1,0,0,1,1,1,7.35,8.0,470.48,0.02,17,0.13,26.14,6,11,3,2,0
2,1,0,0,1,1,1,7.81,9.0,632.78,0.02,19,0.11,35.15,8,11,4,2,0
0,1,0,0,1,1,1,7.74,1.5,17.41,0.0,5,0.67,0.97,2,3,2,0,0
0,1,0,0,1,1,1,7.74,1.5,17.41,0.0,5,0.67,0.97,2,3,2,0,0
0,1,0,0,1,1,1,5.33,1.5,12.0,0.0,4,0.67,0.67,1,3,1,0,0
0,1,0,0,1,1,1,5.33,1.5,12.0,0.0,4,0.67,0.67,1,3,1,0,0
0,1,0,0,1,1,1,5.33,1.5,12.0,0.0,4,0.67,0.67,1,3,1,0,0
0,1,0,0,1,1,1,5.33,1.5,12.0,0.0,4,0.67,0.67,1,3,1,0,0
0,1,0,0,1,1,1,5.33,1.5,12.0,0.0,4,0.67,0.67,1,3,1,0,0
0,1,0,0,1,1,1,5.33,1.5,12.0,0.0,4,0.67,0.67,1,3,1,0,0
0,1,0,0,1,1,1,5.33,1.5,12.0,0.0,4,0.67,0.67,1,3,1,0,0
0,1,0,0,1,1,1,5.33,1.5,12.0,0.0,4,0.67,0.67,1,3,1,0,0
0,1,0,0,1,1,1,5.33,1.5,12.0,0.0,4,0.67,0.67,1,3,1,0,0
0,1,0,0,1,1,1,5.33,1.5,12.0,0.0,4,0.67,0.67,1,3,1,0,0
0,1,0,0,1,1,1,5.33,1.5,12.0,0.0,4,0.67,0.67,1,3,1,0,0
0,1,0,0,1,1,1,5.33,1.5,12.0,0.0,4,0.67,0.67,1,3,1,0,0
0,1,0,0,1,1,1,5.33,1.5,12.0,0.0,4,0.67,0.67,1,3,1,0,0
0,1,0,0,1,1,1,5.33,1.5,12.0,0.0,4,0.67,0.67,1,3,1,0,0
0,1,0,0,1,1,1,5.33,1.5,12.0,0.0,4,0.67,0.67,1,3,1,0,0
0,1,0,0,1,1,1,5.33,1.5,12.0,0.0,4,0.67,0.67,1,3,1,0,0
0,1,0,0,1,1,1,5.33,1.5,12.0,0.0,4,0.67,0.67,1,3,1,0,0
0,1,0,0,1,1,1,7.74,1.5,17.41,0.0,5,0.67,0.97,2,3,2,0,0
0,1,0,0,1,1,1,5.33,1.5,12.0,0.0,4,0.67,0.67,1,3,1,0,0
0,1,0,0,1,1,1,7.86,2.5,49.13,0.01,7,0.4,2.73,2,5,2,0,0
0,1,0,0,1,1,1,0.0,0.0,0.0,0.0,3,0.0,0.0,0,3,0,0,0
0,1,0,0,1,1,1,7.74,1.5,17.41,0.0,5,0.67,0.97,2,3,2,0,0
0,1,0,0,1,1,1,7.74,1.5,17.41,0.0,5,0.67,0.97,2,3,2,0,0
0,1,0,0,1,1,1,7.74,1.5,17.41,0.0,5,0.67,0.97,2,3,2,0,0
0,1,0,0,1,1,1,7.74,1.5,17.41,0.0,5,0.67,0.97,2,3,2,0,0
0,1,0,0,1,1,1,7.74,1.5,17.41,0.0,5,0.67,0.97,2,3,2,0,0
0,1,0,0,1,1,1,7.74,1.5,17.41,0.0,5,0.67,0.97,2,3,2,0,0
0,1,0,0,1,1,1,7.74,1.5,17.41,0.0,5,0.67,0.97,2,3,2,0,0
0,1,0,0,1,1,1,5.33,1.5,12.0,0.0,4,0.67,0.67,1,3,1,0,0
2,1,0,0,1,1,1,5.33,1.5,12.0,0.0,4,0.67,0.67,1,3,1,2,0
2,1,0,0,1,1,1,5.33,1.5,12.0,0.0,4,0.67,0.67,1,3,1,2,0
0,1,0,0,1,1,1,0.0,0.0,0.0,0.0,3,0.0,0.0,0,3,0,0,0
0,1,0,0,1,1,1,0.0,0.0,0.0,0.0,2,0.0,0.0,0,2,0,0,0
0,1,0,0,1,1,1,5.33,1.5,12.0,0.0,4,0.67,0.67,1,3,1,0,0
0,1,0,0,1,1,1,5.33,1.5,12.0,0.0,4,0.67,0.67,1,3,1,0,0
0,1,0,0,1,1,1,0.0,0.0,0.0,0.0,1,0.0,0.0,0,1,0,0,0
2,1,0,1,1,1,1,7.74,1.5,17.41,0.0,5,0.67,0.97,2,3,2,2,0
2,1,0,1,1,1,1,7.74,1.5,17.41,0.0,5,0.67,0.97,2,3,2,2,0
2,1,0,0,1,1,1,7.35,8.0,470.48,0.02,17,0.13,26.14,6,11,3,2,0
2,1,0,0,1,1,1,7.81,9.0,632.78,0.02,19,0.11,35.15,8,11,4,2,0
0,1,0,0,1,1,1,7.74,1.5,17.41,0.0,5,0.67,0.97,2,3,2,0,0
0,1,0,0,1,1,1,7.74,1.5,17.41,0.0,5,0.67,0.97,2,3,2,0,0
0,1,0,0,1,1,1,5.33,1.5,12.0,0.0,4,0.67,0.67,1,3,1,0,0
0,1,0,0,1,1,1,5.33,1.5,12.0,0.0,4,0.67,0.67,1,3,1,0,0
0,1,0,0,1,1,1,5.33,1.5,12.0,0.0,4,0.67,0.67,1,3,1,0,0
0,1,0,0,1,1,1,5.33,1.5,12.0,0.0,4,0.67,0.67,1,3,1,0,0
0,1,0,0,1,1,1,5.33,1.5,12.0,0.0,4,0.67,0.67,1,3,1,0,0
0,1,0,0,1,1,1,5.33,1.5,12.0,0.0,4,0.67,0.67,1,3,1,0,0
0,1,0,0,1,1,1,5.33,1.5,12.0,0.0,4,0.67,0.67,1,3,1,0,0
0,1,0,0,1,1,1,5.33,1.5,12.0,0.0,4,0.67,0.67,1,3,1,0,0
0,1,0,0,1,1,1,5.33,1.5,12.0,0.0,4,0.67,0.67,1,3,1,0,0
0,1,0,0,1,1,1,5.33,1.5,12.0,0.0,4,0.67,0.67,1,3,1,0,0
0,1,0,0,1,1,1,5.33,1.5,12.0,0.0,4,0.67,0.67,1,3,1,0,0
0,1,0,0,1,1,1,5.33,1.5,12.0,0.0,4,0.67,0.67,1,3,1,0,0
0,1,0,0,1,1,1,5.33,1.5,12.0,0.0,4,0.67,0.67,1,3,1,0,0
0,1,0,0,1,1,1,5.33,1.5,12.0,0.0,4,0.67,0.67,1,3,1,0,0
0,1,0,0,1,1,1,7.74,1.5,17.41,0.0,5,0.67,0.97,2,3,2,0,0
0,1,0,0,1,1,1,5.33,1.5,12.0,0.0,4,0.67,0.67,1,3,1,0,0
0,1,0,0,1,1,1,7.86,2.5,49.13,0.01,7,0.4,2.73,2,5,2,0,0
0,1,0,0,1,1,1,0.0,0.0,0.0,0.0,3,0.0,0.0,0,3,0,0,0
0,1,0,0,1,1,1,7.74,1.5,17.41,0.0,5,0.67,0.97,2,3,2,0,0
0,1,0,0,1,1,1,7.74,1.5,17.41,0.0,5,0.67,0.97,2,3,2,0,0
0,1,0,0,1,1,1,7.74,1.5,17.41,0.0,5,0.67,0.97,2,3,2,0,0
0,1,0,0,1,1,1,7.74,1.5,17.41,0.0,5,0.67,0.97,2,3,2,0,0
0,1,0,0,1,1,1,7.74,1.5,17.41,0.0,5,0.67,0.97,2,3,2,0,0
0,1,0,0,1,1,1,7.74,1.5,17.41,0.0,5,0.67,0.97,2,3,2,0,0
0,1,0,0,1,1,1,7.74,1.5,17.41,0.0,5,0.67,0.97,2,3,2,0,0
0,1,0,0,1,1,1,5.33,1.5,12.0,0.0,4,0.67,0.67,1,3,1,0,0
9,5,0,2,3,2,1,16.86,7.0,826.2,0.04,31,0.14,45.9,14,17,7,9,0
9,5,0,2,3,2,1,16.86,7.0,826.2,0.04,31,0.14,45.9,14,17,7,9,0
0,1,0,0,1,1,1,0.0,0.0,0.0,0.0,1,0.0,0.0,0,1,0,0,0
0,1,0,0,1,1,1,0.0,0.0,0.0,0.0,1,0.0,0.0,0,1,0,0,0
0,1,0,0,1,1,1,0.0,0.0,0.0,0.0,0,0.0,0.0,0,0,0,0,0
0,1,0,0,1,1,1,0.0,0.0,0.0,0.0,0,0.0,0.0,0,0,0,0,0
0,1,0,0,1,1,1,5.33,1.5,12.0,0.0,4,0.67,0.67,1,3,1,0,0
0,1,0,0,1,1,1,5.33,1.5,12.0,0.0,4,0.67,0.67,1,3,1,0,0
0,1,0,0,1,1,1,5.33,1.5,12.0,0.0,4,0.67,0.67,1,3,1,0,0
0,1,0,0,1,1,1,5.33,1.5,12.0,0.0,4,0.67,0.67,1,3,1,0,0
0,1,0,0,1,1,1,5.33,1.5,12.0,0.0,4,0.67,0.67,1,3,1,0,0
0,1,0,0,1,1,1,5.33,1.5,12.0,0.0,4,0.67,0.67,1,3,1,0,0
0,1,0,0,1,1,1,5.33,1.5,12.0,0.0,4,0.67,0.67,1,3,1,0,0
0,1,0,0,1,1,1,5.33,1.5,12.0,0.0,4,0.67,0.67,1,3,1,0,0
0,1,0,0,1,1,1,5.33,1.5,12.0,0.0,4,0.67,0.67,1,3,1,0,0
0,1,0,0,1,1,1,5.33,1.5,12.0,0.0,4,0.67,0.67,1,3,1,0,0
0,1,0,0,1,1,1,9.51,3.0,85.59,0.01,9,0.33,4.75,3,6,3,0,0
0,1,0,0,1,1,1,9.51,3.0,85.59,0.01,9,0.33,4.75,3,6,3,0,0
0,1,0,0,1,1,1,5.33,1.5,12.0,0.0,4,0.67,0.67,1,3,1,0,0
0,1,0,0,1,1,1,5.33,1.5,12.0,0.0,4,0.67,0.67,1,3,1,0,0
0,1,0,0,1,1,1,5.33,1.5,12.0,0.0,4,0.67,0.67,1,3,1,0,0
0,1,0,0,1,1,1,5.33,1.5,12.0,0.0,4,0.67,0.67,1,3,1,0,0
0,1,0,0,1,1,1,5.33,1.5,12.0,0.0,4,0.67,0.67,1,3,1,0,0
0,1,0,0,1,1,1,5.33,1.5,12.0,0.0,4,0.67,0.67,1,3,1,0,0
0,1,0,0,1,1,1,0.0,0.0,0.0,0.0,1,0.0,0.0,0,1,0,0,0
0,1,0,0,1,1,1,0.0,0.0,0.0,0.0,1,0.0,0.0,0,1,0,0,0
0,1,0,0,1,1,1,0.0,0.0,0.0,0.0,1,0.0,0.0,0,1,0,0,0
0,1,0,0,1,1,1,0.0,0.0,0.0,0.0,1,0.0,0.0,0,1,0,0,0
0,1,0,0,1,1,1,0.0,0.0,0.0,0.0,3,0.0,0.0,0,3,0,0,0
0,1,0,0,1,1,1,0.0,0.0,0.0,0.0,2,0.0,0.0,0,2,0,0,0
0,1,0,0,1,1,1,5.33,1.5,12.0,0.0,4,0.67,0.67,1,3,1,0,0
0,1,0,0,1,1,1,5.33,1.5,12.0,0.0,4,0.67,0.67,1,3,1,0,0
0,1,0,0,1,1,1,5.33,1.5,12.0,0.0,4,0.67,0.67,1,3,1,0,0
0,1,0,0,1,1,1,7.74,1.5,17.41,0.0,5,0.67,0.97,2,3,2,0,0
0,1,0,0,1,1,1,0.0,0.0,0.0,0.0,1,0.0,0.0,0,1,0,0,0
0,1,0,0,1,1,1,7.74,1.5,17.41,0.0,5,0.67,0.97,2,3,2,0,0
6,3,0,2,2,1,1,18.6,5.25,512.78,0.03,25,0.19,28.49,12,13,8,6,0
6,3,0,2,2,1,1,18.6,5.25,512.78,0.03,25,0.19,28.49,12,13,8,6,0
2,1,0,0,1,1,1,7.35,8.0,470.48,0.02,17,0.13,26.14,6,11,3,2,0
2,1,0,0,1,1,1,7.81,9.0,632.78,0.02,19,0.11,35.15,8,11,4,2,0
0,1,0,0,1,1,1,5.33,1.5,12.0,0.0,4,0.67,0.67,1,3,1,0,0
0,1,0,0,1,1,1,7.74,1.5,17.41,0.0,5,0.67,0.97,2,3,2,0,0
0,1,0,0,1,1,1,7.74,1.5,17.41,0.0,5,0.67,0.97,2,3,2,0,0
0,1,0,0,1,1,1,7.74,1.5,17.41,0.0,5,0.67,0.97,2,3,2,0,0
0,1,0,0,1,1,1,7.74,1.5,17.41,0.0,5,0.67,0.97,2,3,2,0,0
0,1,0,0,1,1,1,5.33,1.5,12.0,0.0,4,0.67,0.67,1,3,1,0,0
0,1,0,0,1,1,1,5.33,1.5,12.0,0.0,4,0.67,0.67,1,3,1,0,0
0,1,0,0,1,1,1,5.33,1.5,12.0,0.0,4,0.67,0.67,1,3,1,0,0
0,1,0,0,1,1,1,5.33,1.5,12.0,0.0,4,0.67,0.67,1,3,1,0,0
0,1,0,0,1,1,1,5.33,1.5,12.0,0.0,4,0.67,0.67,1,3,1,0,0
0,1,0,0,1,1,1,5.33,1.5,12.0,0.0,4,0.67,0.67,1,3,1,0,0
0,1,0,0,1,1,1,5.33,1.5,12.0,0.0,4,0.67,0.67,1,3,1,0,0
0,1,0,0,1,1,1,5.33,1.5,12.0,0.0,4,0.67,0.67,1,3,1,0,0
0,1,0,0,1,1,1,5.33,1.5,12.0,0.0,4,0.67,0.67,1,3,1,0,0
0,1,0,0,1,1,1,5.33,1.5,12.0,0.0,4,0.67,0.67,1,3,1,0,0
0,1,0,0,1,1,1,5.33,1.5,12.0,0.0,4,0.67,0.67,1,3,1,0,0
0,1,0,0,1,1,1,5.33,1.5,12.0,0.0,4,0.67,0.67,1,3,1,0,0
0,1,0,0,1,1,1,5.33,1.5,12.0,0.0,4,0.67,0.67,1,3,1,0,0
0,1,0,0,1,1,1,5.33,1.5,12.0,0.0,4,0.67,0.67,1,3,1,0,0
0,1,0,0,1,1,1,5.33,1.5,12.0,0.0,4,0.67,0.67,1,3,1,0,0
0,1,0,0,1,1,1,5.8,2.0,23.22,0.0,5,0.5,1.29,1,4,1,0,0
0,1,0,0,1,1,1,5.33,1.5,12.0,0.0,4,0.67,0.67,1,3,1,0,0
0,1,0,0,1,1,1,5.33,1.5,12.0,0.0,4,0.67,0.67,1,3,1,0,0
0,1,0,0,1,1,1,5.33,1.5,12.0,0.0,4,0.67,0.67,1,3,1,0,0
0,1,0,0,1,1,1,5.33,1.5,12.0,0.0,4,0.67,0.67,1,3,1,0,0
0,1,0,0,1,1,1,5.33,1.5,12.0,0.0,4,0.67,0.67,1,3,1,0,0
0,1,0,0,1,1,1,5.33,1.5,12.0,0.0,4,0.67,0.67,1,3,1,0,0
0,1,0,0,1,1,1,7.74,1.5,17.41,0.0,5,0.67,0.97,2,3,2,0,0
0,1,0,0,1,1,1,5.33,1.5,12.0,0.0,4,0.67,0.67,1,3,1,0,0
0,1,0,0,1,1,1,7.86,2.5,49.13,0.01,7,0.4,2.73,2,5,2,0,0
0,1,0,0,1,1,1,0.0,0.0,0.0,0.0,3,0.0,0.0,0,3,0,0,0
15,5,0,3,1,1,1,32.04,6.6,1396.03,0.07,45,0.15,77.56,18,27,15,15,0
15,5,0,3,1,1,1,32.04,6.6,1396.03,0.07,45,0.15,77.56,18,27,15,15,0
0,1,0,0,1,1,1,7.74,1.5,17.41,0.0,5,0.67,0.97,2,3,2,0,0
0,1,0,0,1,1,1,4.75,1.0,4.75,0.0,3,1.0,0.26,1,2,1,0,0
0,1,0,0,1,1,1,7.74,1.5,17.41,0.0,5,0.67,0.97,2,3,2,0,0
0,1,0,0,1,1,1,7.74,1.5,17.41,0.0,5,0.67,0.97,2,3,2,0,0
0,1,0,0,1,1,1,7.74,1.5,17.41,0.0,5,0.67,0.97,2,3,2,0,0
8,5,0,0,3,2,3,17.48,7.78,1057.26,0.05,32,0.13,58.74,14,18,9,8,0
8,5,0,0,3,2,3,17.48,7.78,1057.26,0.05,32,0.13,58.74,14,18,9,8,0
0,1,0,0,1,1,1,7.74,1.5,17.41,0.0,5,0.67,0.97,2,3,2,0,0
0,1,0,0,1,1,1,7.74,1.5,17.41,0.0,5,0.67,0.97,2,3,2,0,0
0,1,0,0,1,1,1,7.74,1.5,17.41,0.0,5,0.67,0.97,2,3,2,0,0
0,1,0,0,1,1,1,5.33,1.5,12.0,0.0,4,0.67,0.67,1,3,1,0,0
2,1,0,0,1,1,1,5.33,1.5,12.0,0.0,4,0.67,0.67,1,3,1,2,0
2,1,0,0,1,1,1,5.33,1.5,12.0,0.0,4,0.67,0.67,1,3,1,2,0
0,1,0,0,1,1,1,0.0,0.0,0.0,0.0,3,0.0,0.0,0,3,0,0,0
0,1,0,0,1,1,1,0.0,0.0,0.0,0.0,2,0.0,0.0,0,2,0,0,0
0,1,0,0,1,1,1,5.33,1.5,12.0,0.0,4,0.67,0.67,1,3,1,0,0
0,1,0,0,1,1,1,5.33,1.5,12.0,0.0,4,0.67,0.67,1,3,1,0,0
0,1,0,0,1,1,1,0.0,0.0,0.0,0.0,1,0.0,0.0,0,1,0,0,0
15,1,0,3,1,1,1,49.33,8.0,3157.25,0.13,83,0.13,175.4,38,45,19,15,0
15,1,0,3,1,1,1,49.33,8.0,3157.25,0.13,83,0.13,175.4,38,45,19,15,0
2,1,0,0,1,1,1,7.35,8.0,470.48,0.02,17,0.13,26.14,6,11,3,2,0
2,1,0,0,1,1,1,7.81,9.0,632.78,0.02,19,0.11,35.15,8,11,4,2,0
0,1,0,0,1,1,1,7.74,1.5,17.41,0.0,5,0.67,0.97,2,3,2,0,0
0,1,0,0,1,1,1,7.74,1.5,17.41,0.0,5,0.67,0.97,2,3,2,0,0
0,1,0,0,1,1,1,5.33,1.5,12.0,0.0,4,0.67,0.67,1,3,1,0,0
0,1,0,0,1,1,1,5.33,1.5,12.0,0.0,4,0.67,0.67,1,3,1,0,0
0,1,0,0,1,1,1,5.33,1.5,12.0,0.0,4,0.67,0.67,1,3,1,0,0
0,1,0,0,1,1,1,5.33,1.5,12.0,0.0,4,0.67,0.67,1,3,1,0,0
0,1,0,0,1,1,1,5.33,1.5,12.0,0.0,4,0.67,0.67,1,3,1,0,0
0,1,0,0,1,1,1,5.33,1.5,12.0,0.0,4,0.67,0.67,1,3,1,0,0
0,1,0,0,1,1,1,5.33,1.5,12.0,0.0,4,0.67,0.67,1,3,1,0,0
0,1,0,0,1,1,1,5.33,1.5,12.0,0.0,4,0.67,0.67,1,3,1,0,0
0,1,0,0,1,1,1,5.33,1.5,12.0,0.0,4,0.67,0.67,1,3,1,0,0
0,1,0,0,1,1,1,5.33,1.5,12.0,0.0,4,0.67,0.67,1,3,1,0,0
0,1,0,0,1,1,1,5.33,1.5,12.0,0.0,4,0.67,0.67,1,3,1,0,0
0,1,0,0,1,1,1,5.33,1.5,12.0,0.0,4,0.67,0.67,1,3,1,0,0
0,1,0,0,1,1,1,5.33,1.5,12.0,0.0,4,0.67,0.67,1,3,1,0,0
0,1,0,0,1,1,1,5.33,1.5,12.0,0.0,4,0.67,0.67,1,3,1,0,0
0,1,0,0,1,1,1,7.74,1.5,17.41,0.0,5,0.67,0.97,2,3,2,0,0
0,1,0,0,1,1,1,5.33,1.5,12.0,0.0,4,0.67,0.67,1,3,1,0,0
0,1,0,0,1,1,1,7.86,2.5,49.13,0.01,7,0.4,2.73,2,5,2,0,0
0,1,0,0,1,1,1,0.0,0.0,0.0,0.0,3,0.0,0.0,0,3,0,0,0
0,1,0,0,1,1,1,7.74,1.5,17.41,0.0,5,0.67,0.97,2,3,2,0,0
0,1,0,0,1,1,1,7.74,1.5,17.41,0.0,5,0.67,0.97,2,3,2,0,0
0,1,0,0,1,1,1,7.74,1.5,17.41,0.0,5,0.67,0.97,2,3,2,0,0
0,1,0,0,1,1,1,7.74,1.5,17.41,0.0,5,0.67,0.97,2,3,2,0,0
0,1,0,0,1,1,1,7.74,1.5,17.41,0.0,5,0.67,0.97,2,3,2,0,0
0,1,0,0,1,1,1,7.74,1.5,17.41,0.0,5,0.67,0.97,2,3,2,0,0
0,1,0,0,1,1,1,7.74,1.5,17.41,0.0,5,0.67,0.97,2,3,2,0,0
0,1,0,0,1,1,1,5.33,1.5,12.0,0.0,4,0.67,0.67,1,3,1,0,0
0,1,0,0,1,1,1,0.0,0.0,0.0,0.0,3,0.0,0.0,0,3,0,0,0
0,1,0,0,1,1,1,0.0,0.0,0.0,0.0,2,0.0,0.0,0,2,0,0,0
0,1,0,0,1,1,1,5.33,1.5,12.0,0.0,4,0.67,0.67,1,3,1,0,0
0,1,0,0,1,1,1,5.33,1.5,12.0,0.0,4,0.67,0.67,1,3,1,0,0
0,1,0,0,1,1,1,5.33,1.5,12.0,0.0,4,0.67,0.67,1,3,1,0,0
0,1,0,0,1,1,1,7.74,1.5,17.41,0.0,5,0.67,0.97,2,3,2,0,0
0,1,0,0,1,1,1,0.0,0.0,0.0,0.0,1,0.0,0.0,0,1,0,0,0
17,6,0,3,1,1,1,22.16,9.33,1930.31,0.07,44,0.11,107.24,16,28,12,17,0
17,6,0,3,1,1,1,22.16,9.33,1930.31,0.07,44,0.11,107.24,16,28,12,17,0
2,1,0,0,1,1,1,7.35,8.0,470.48,0.02,17,0.13,26.14,6,11,3,2,0
2,1,0,0,1,1,1,7.81,9.0,632.78,0.02,19,0.11,35.15,8,11,4,2,0
0,1,0,0,1,1,1,5.33,1.5,12.0,0.0,4,0.67,0.67,1,3,1,0,0
0,1,0,0,1,1,1,7.74,1.5,17.41,0.0,5,0.67,0.97,2,3,2,0,0
0,1,0,0,1,1,1,7.74,1.5,17.41,0.0,5,0.67,0.97,2,3,2,0,0
0,1,0,0,1,1,1,5.33,1.5,12.0,0.0,4,0.67,0.67,1,3,1,0,0
0,1,0,0,1,1,1,5.33,1.5,12.0,0.0,4,0.67,0.67,1,3,1,0,0
0,1,0,0,1,1,1,5.33,1.5,12.0,0.0,4,0.67,0.67,1,3,1,0,0
0,1,0,0,1,1,1,5.33,1.5,12.0,0.0,4,0.67,0.67,1,3,1,0,0
0,1,0,0,1,1,1,5.33,1.5,12.0,0.0,4,0.67,0.67,1,3,1,0,0
0,1,0,0,1,1,1,5.33,1.5,12.0,0.0,4,0.67,0.67,1,3,1,0,0
0,1,0,0,1,1,1,5.33,1.5,12.0,0.0,4,0.67,0.67,1,3,1,0,0
0,1,0,0,1,1,1,5.8,2.0,23.22,0.0,5,0.5,1.29,1,4,1,0,0
0,1,0,0,1,1,1,5.33,1.5,12.0,0.0,4,0.67,0.67,1,3,1,0,0
0,1,0,0,1,1,1,5.33,1.5,12.0,0.0,4,0.67,0.67,1,3,1,0,0
6,1,0,0,1,1,1,15.93,4.5,322.65,0.02,20,0.22,17.92,9,11,6,6,0
6,1,0,0,1,1,1,15.93,4.5,322.65,0.02,20,0.22,17.92,9,11,6,6,0
0,1,0,0,1,1,1,5.33,1.5,12.0,0.0,4,0.67,0.67,1,3,1,0,0
0,1,0,0,1,1,1,5.33,1.5,12.0,0.0,4,0.67,0.67,1,3,1,0,0
0,1,0,0,1,1,1,5.33,1.5,12.0,0.0,4,0.67,0.67,1,3,1,0,0
0,1,0,0,1,1,1,7.74,1.5,17.41,0.0,5,0.67,0.97,2,3,2,0,0
0,1,0,0,1,1,1,5.33,1.5,12.0,0.0,4,0.67,0.67,1,3,1,0,0
0,1,0,0,1,1,1,7.86,2.5,49.13,0.01,7,0.4,2.73,2,5,2,0,0
0,1,0,0,1,1,1,0.0,0.0,0.0,0.0,3,0.0,0.0,0,3,0,0,0
0,1,0,0,1,1,1,7.74,1.5,17.41,0.0,5,0.67,0.97,2,3,2,0,0
0,1,0,0,1,1,1,4.75,1.0,4.75,0.0,3,1.0,0.26,1,2,1,0,0
0,1,0,0,1,1,1,7.74,1.5,17.41,0.0,5,0.67,0.97,2,3,2,0,0
0,1,0,0,1,1,1,7.74,1.5,17.41,0.0,5,0.67,0.97,2,3,2,0,0
0,1,0,0,1,1,1,7.74,1.5,17.41,0.0,5,0.67,0.97,2,3,2,0,0
0,1,0,0,1,1,1,7.74,1.5,17.41,0.0,5,0.67,0.97,2,3,2,0,0
0,1,0,0,1,1,1,7.74,1.5,17.41,0.0,5,0.67,0.97,2,3,2,0,0
0,1,0,0,1,1,1,7.74,1.5,17.41,0.0,5,0.67,0.97,2,3,2,0,0
0,1,0,0,1,1,1,7.74,1.5,17.41,0.0,5,0.67,0.97,2,3,2,0,0
0,1,0,0,1,1,1,5.33,1.5,12.0,0.0,4,0.67,0.67,1,3,1,0,0
7,3,0,0,2,1,1,14.12,9.63,1308.36,0.05,32,0.1,72.69,14,18,8,7,0
7,3,0,0,2,1,1,14.12,9.63,1308.36,0.05,32,0.1,72.69,14,18,8,7,0
7,3,0,1,2,1,1,16.97,9.17,1426.24,0.05,36,0.11,79.24,15,21,9,7,0
2,1,0,0,1,1,1,6.2,2.5,38.77,0.01,6,0.4,2.15,1,5,1,2,0
0,1,0,0,1,1,1,6.2,2.5,38.77,0.01,6,0.4,2.15,1,5,1,0,0
0,1,0,0,1,1,1,6.2,2.5,38.77,0.01,6,0.4,2.15,1,5,1,0,0
23,7,1,8,4,1,1,23.26,21.67,10918.18,0.17,113,0.05,606.57,52,61,12,24,0
23,7,1,8,4,1,1,23.26,21.67,10918.18,0.17,113,0.05,606.57,52,61,12,24,0
23,7,1,8,4,1,1,25.56,20.0,10223.25,0.17,113,0.05,567.96,52,61,13,24,0
23,7,1,8,4,1,1,23.26,21.67,10918.18,0.17,113,0.05,606.57,52,61,12,24,0
23,7,1,8,4,1,1,25.56,20.0,10223.25,0.17,113,0.05,567.96,52,61,13,24,0
23,7,1,8,4,1,1,23.26,21.67,10918.18,0.17,113,0.05,606.57,52,61,12,24,0
23,7,1,8,4,1,1,25.56,20.0,10223.25,0.17,113,0.05,567.96,52,61,13,24,0
23,7,1,8,4,1,1,23.26,21.67,10918.18,0.17,113,0.05,606.57,52,61,12,24,0
23,7,1,8,4,1,1,25.56,20.0,10223.25,0.17,113,0.05,567.96,52,61,13,24,0
23,7,1,8,4,1,1,23.26,21.67,10918.18,0.17,113,0.05,606.57,52,61,12,24,0
23,7,1,8,4,1,1,25.56,20.0,10223.25,0.17,113,0.05,567.96,52,61,13,24,0
23,7,1,8,4,1,1,23.26,21.67,10918.18,0.17,113,0.05,606.57,52,61,12,24,0
23,7,1,8,4,1,1,25.56,20.0,10223.25,0.17,113,0.05,567.96,52,61,13,24,0
23,7,1,8,4,1,1,23.26,21.67,10918.18,0.17,113,0.05,606.57,52,61,12,24,0
23,7,1,8,4,1,1,25.56,20.0,10223.25,0.17,113,0.05,567.96,52,61,13,24,0
23,7,1,8,4,1,1,23.26,21.67,10918.18,0.17,113,0.05,606.57,52,61,12,24,0
23,7,1,8,4,1,1,25.56,20.0,10223.25,0.17,113,0.05,567.96,52,61,13,24,0
23,7,1,8,4,1,1,23.26,21.67,10918.18,0.17,113,0.05,606.57,52,61,12,24,0
23,7,1,8,4,1,1,25.56,20.0,10223.25,0.17,113,0.05,567.96,52,61,13,24,0
23,7,1,8,4,1,1,25.56,20.0,10223.25,0.17,113,0.05,567.96,52,61,13,24,0
7,5,6,7,3,1,1,18.89,8.44,1345.03,0.05,39,0.12,74.72,15,24,8,13,0
7,5,6,7,3,1,1,18.89,8.44,1345.03,0.05,39,0.12,74.72,15,24,8,13,0
7,5,6,7,3,1,1,18.89,8.44,1345.03,0.05,39,0.12,74.72,15,24,8,13,0
7,5,6,7,3,1,1,18.89,8.44,1345.03,0.05,39,0.12,74.72,15,24,8,13,0
7,5,6,7,3,1,1,18.89,8.44,1345.03,0.05,39,0.12,74.72,15,24,8,13,0
7,5,6,7,3,1,1,18.89,8.44,1345.03,0.05,39,0.12,74.72,15,24,8,13,0
7,5,6,7,3,1,1,18.89,8.44,1345.03,0.05,39,0.12,74.72,15,24,8,13,0
7,5,6,7,3,1,1,18.89,8.44,1345.03,0.05,39,0.12,74.72,15,24,8,13,0
7,5,6,7,3,1,1,18.89,8.44,1345.03,0.05,39,0.12,74.72,15,24,8,13,0
7,5,6,7,3,1,1,18.89,8.44,1345.03,0.05,39,0.12,74.72,15,24,8,13,0
7,5,6,7,3,1,1,18.89,8.44,1345.03,0.05,39,0.12,74.72,15,24,8,13,0
7,5,6,7,3,1,1,18.89,8.44,1345.03,0.05,39,0.12,74.72,15,24,8,13,0
7,5,6,7,3,1,1,18.89,8.44,1345.03,0.05,39,0.12,74.72,15,24,8,13,0
7,5,6,7,3,1,1,18.89,8.44,1345.03,0.05,39,0.12,74.72,15,24,8,13,0
7,5,6,7,3,1,1,18.89,8.44,1345.03,0.05,39,0.12,74.72,15,24,8,13,0
7,5,6,7,3,1,1,18.89,8.44,1345.03,0.05,39,0.12,74.72,15,24,8,13,0
7,5,6,7,3,1,1,18.89,8.44,1345.03,0.05,39,0.12,74.72,15,24,8,13,0
7,5,6,7,3,1,1,18.89,8.44,1345.03,0.05,39,0.12,74.72,15,24,8,13,0
7,5,6,7,3,1,1,18.89,8.44,1345.03,0.05,39,0.12,74.72,15,24,8,13,0
7,5,6,7,3,1,1,18.89,8.44,1345.03,0.05,39,0.12,74.72,15,24,8,13,0
50,23,3,48,12,5,6,22.06,40.8,36720.0,0.3,180,0.02,2040.0,72,108,15,53,0
50,23,3,48,12,5,6,20.4,43.71,38982.45,0.3,180,0.02,2165.69,72,108,14,53,0
50,23,3,48,12,5,6,22.06,40.8,36720.0,0.3,180,0.02,2040.0,72,108,15,53,0
50,23,3,48,12,5,6,20.4,43.71,38982.45,0.3,180,0.02,2165.69,72,108,14,53,0
50,23,3,48,12,5,6,22.06,40.8,36720.0,0.3,180,0.02,2040.0,72,108,15,53,0
50,23,3,48,12,5,6,20.4,43.71,38982.45,0.3,180,0.02,2165.69,72,108,14,53,0
50,23,3,48,12,5,6,22.06,40.8,36720.0,0.3,180,0.02,2040.0,72,108,15,53,0
50,23,3,48,12,5,6,20.4,43.71,38982.45,0.3,180,0.02,2165.69,72,108,14,53,0
50,23,3,48,12,5,6,20.4,43.71,38982.45,0.3,180,0.02,2165.69,72,108,14,53,0
50,23,3,48,12,5,6,22.06,40.8,36720.0,0.3,180,0.02,2040.0,72,108,15,53,0
50,23,3,48,12,5,6,22.06,40.8,36720.0,0.3,180,0.02,2040.0,72,108,15,53,0
50,23,3,48,12,5,6,22.06,40.8,36720.0,0.3,180,0.02,2040.0,72,108,15,53,0
50,23,3,48,12,5,6,20.4,43.71,38982.45,0.3,180,0.02,2165.69,72,108,14,53,0
50,23,3,48,12,5,6,20.4,43.71,38982.45,0.3,180,0.02,2165.69,72,108,14,53,0
50,23,3,48,12,5,6,22.06,40.8,36720.0,0.3,180,0.02,2040.0,72,108,15,53,0
50,23,3,48,12,5,6,20.4,43.71,38982.45,0.3,180,0.02,2165.69,72,108,14,53,0
50,23,3,48,12,5,6,22.06,40.8,36720.0,0.3,180,0.02,2040.0,72,108,15,53,0
50,23,3,48,12,5,6,20.4,43.71,38982.45,0.3,180,0.02,2165.69,72,108,14,53,0
50,23,3,48,12,5,6,22.06,40.8,36720.0,0.3,180,0.02,2040.0,72,108,15,53,0
50,23,3,48,12,5,6,20.4,43.71,38982.45,0.3,180,0.02,2165.69,72,108,14,53,0
3,1,0,0,1,1,1,11.63,2.0,46.53,0.01,9,0.5,2.58,4,5,3,3,0
3,1,0,0,1,1,1,11.63,2.0,46.53,0.01,9,0.5,2.58,4,5,3,3,0
5,1,0,0,1,1,1,28.56,3.33,317.28,0.03,25,0.3,17.63,12,13,9,5,0
5,1,0,0,1,1,1,28.56,3.33,317.28,0.03,25,0.3,17.63,12,13,9,5,0
0,1,0,0,1,1,1,6.2,2.5,38.77,0.01,6,0.4,2.15,1,5,1,0,0
6,3,0,0,2,2,1,7.4,6.0,266.27,0.01,14,0.17,14.79,6,8,3,6,0
6,3,0,0,2,2,1,7.4,6.0,266.27,0.01,14,0.17,14.79,6,8,3,6,0
0,1,0,0,1,1,1,0.0,0.0,0.0,0.0,3,0.0,0.0,0,3,0,0,0
0,1,0,0,1,1,1,0.0,0.0,0.0,0.0,2,0.0,0.0,0,2,0,0,0
0,1,0,0,1,1,1,5.33,1.5,12.0,0.0,4,0.67,0.67,1,3,1,0,0
0,1,0,0,1,1,1,5.33,1.5,12.0,0.0,4,0.67,0.67,1,3,1,0,0
0,1,0,0,1,1,1,5.33,1.5,12.0,0.0,4,0.67,0.67,1,3,1,0,0
0,1,0,0,1,1,1,7.74,1.5,17.41,0.0,5,0.67,0.97,2,3,2,0,0
0,1,0,0,1,1,1,0.0,0.0,0.0,0.0,1,0.0,0.0,0,1,0,0,0
0,1,0,0,1,1,1,7.74,1.5,17.41,0.0,5,0.67,0.97,2,3,2,0,0
7,3,0,2,2,1,1,27.15,4.45,538.68,0.04,29,0.22,29.93,14,15,11,7,0
7,3,0,2,2,1,1,27.15,4.45,538.68,0.04,29,0.22,29.93,14,15,11,7,0
2,1,0,0,1,1,1,7.35,8.0,470.48,0.02,17,0.13,26.14,6,11,3,2,0
2,1,0,0,1,1,1,7.81,9.0,632.78,0.02,19,0.11,35.15,8,11,4,2,0
0,1,0,0,1,1,1,5.33,1.5,12.0,0.0,4,0.67,0.67,1,3,1,0,0
0,1,0,0,1,1,1,7.74,1.5,17.41,0.0,5,0.67,0.97,2,3,2,0,0
0,1,0,0,1,1,1,7.74,1.5,17.41,0.0,5,0.67,0.97,2,3,2,0,0
0,1,0,0,1,1,1,7.74,1.5,17.41,0.0,5,0.67,0.97,2,3,2,0,0
0,1,0,0,1,1,1,7.74,1.5,17.41,0.0,5,0.67,0.97,2,3,2,0,0
0,1,0,0,1,1,1,5.33,1.5,12.0,0.0,4,0.67,0.67,1,3,1,0,0
0,1,0,0,1,1,1,5.33,1.5,12.0,0.0,4,0.67,0.67,1,3,1,0,0
0,1,0,0,1,1,1,5.33,1.5,12.0,0.0,4,0.67,0.67,1,3,1,0,0
0,1,0,0,1,1,1,5.33,1.5,12.0,0.0,4,0.67,0.67,1,3,1,0,0
0,1,0,0,1,1,1,5.33,1.5,12.0,0.0,4,0.67,0.67,1,3,1,0,0
0,1,0,0,1,1,1,5.33,1.5,12.0,0.0,4,0.67,0.67,1,3,1,0,0
0,1,0,0,1,1,1,5.33,1.5,12.0,0.0,4,0.67,0.67,1,3,1,0,0
0,1,0,0,1,1,1,5.33,1.5,12.0,0.0,4,0.67,0.67,1,3,1,0,0
0,1,0,0,1,1,1,5.33,1.5,12.0,0.0,4,0.67,0.67,1,3,1,0,0
0,1,0,0,1,1,1,5.8,2.0,23.22,0.0,5,0.5,1.29,1,4,1,0,0
0,1,0,0,1,1,1,5.33,1.5,12.0,0.0,4,0.67,0.67,1,3,1,0,0
0,1,0,0,1,1,1,5.33,1.5,12.0,0.0,4,0.67,0.67,1,3,1,0,0
0,1,0,0,1,1,1,5.33,1.5,12.0,0.0,4,0.67,0.67,1,3,1,0,0
0,1,0,0,1,1,1,5.33,1.5,12.0,0.0,4,0.67,0.67,1,3,1,0,0
0,1,0,0,1,1,1,5.33,1.5,12.0,0.0,4,0.67,0.67,1,3,1,0,0
0,1,0,0,1,1,1,5.33,1.5,12.0,0.0,4,0.67,0.67,1,3,1,0,0
0,1,0,0,1,1,1,7.74,1.5,17.41,0.0,5,0.67,0.97,2,3,2,0,0
0,1,0,0,1,1,1,5.33,1.5,12.0,0.0,4,0.67,0.67,1,3,1,0,0
0,1,0,0,1,1,1,7.86,2.5,49.13,0.01,7,0.4,2.73,2,5,2,0,0
0,1,0,0,1,1,1,0.0,0.0,0.0,0.0,3,0.0,0.0,0,3,0,0,0
0,1,0,0,1,1,1,7.74,1.5,17.41,0.0,5,0.67,0.97,2,3,2,0,0
0,1,0,0,1,1,1,4.75,1.0,4.75,0.0,3,1.0,0.26,1,2,1,0,0
0,1,0,0,1,1,1,7.74,1.5,17.41,0.0,5,0.67,0.97,2,3,2,0,0
0,1,0,0,1,1,1,7.74,1.5,17.41,0.0,5,0.67,0.97,2,3,2,0,0
0,1,0,0,1,1,1,7.74,1.5,17.41,0.0,5,0.67,0.97,2,3,2,0,0
0,1,0,0,1,1,1,7.74,1.5,17.41,0.0,5,0.67,0.97,2,3,2,0,0
0,1,0,0,1,1,1,7.74,1.5,17.41,0.0,5,0.67,0.97,2,3,2,0,0
7,3,0,3,2,2,1,9.87,6.75,449.6,0.02,18,0.15,24.98,6,12,4,7,0
7,3,0,3,2,2,1,9.87,6.75,449.6,0.02,18,0.15,24.98,6,12,4,7,0
0,1,0,0,1,1,1,7.74,1.5,17.41,0.0,5,0.67,0.97,2,3,2,0,0
0,1,0,0,1,1,1,5.33,1.5,12.0,0.0,4,0.67,0.67,1,3,1,0,0
3,3,0,0,2,2,1,9.6,2.5,60.0,0.01,8,0.4,3.33,3,5,3,3,0
3,3,0,0,2,2,1,9.6,2.5,60.0,0.01,8,0.4,3.33,3,5,3,3,0
0,1,0,0,1,1,1,5.33,1.5,12.0,0.0,4,0.67,0.67,1,3,1,0,0
0,1,0,0,1,1,1,7.74,1.5,17.41,0.0,5,0.67,0.97,2,3,2,0,0
1,1,0,0,1,1,1,0.0,0.0,0.0,0.0,1,0.0,0.0,0,1,0,1,0
1,1,0,0,1,1,1,0.0,0.0,0.0,0.0,1,0.0,0.0,0,1,0,1,0
0,1,0,0,1,1,1,5.33,1.5,12.0,0.0,4,0.67,0.67,1,3,1,0,0
0,1,0,0,1,1,1,5.33,1.5,12.0,0.0,4,0.67,0.67,1,3,1,0,0
0,1,0,0,1,1,1,5.33,1.5,12.0,0.0,4,0.67,0.67,1,3,1,0,0
4,1,0,0,1,1,1,10.24,7.0,501.89,0.02,20,0.14,27.88,7,13,4,4,0
4,3,0,0,2,2,1,21.5,7.15,1099.18,0.05,35,0.14,61.07,13,22,10,4,0
8,3,0,0,2,2,1,23.46,10.29,2485.24,0.08,52,0.1,138.07,19,33,12,8,0
54,13,1,8,7,6,6,25.11,40.0,40181.42,0.33,184,0.03,2232.3,80,104,22,55,0
0,1,0,0,1,1,1,8.3,6.67,369.01,0.02,16,0.15,20.5,5,11,3,0,0
23,5,0,1,3,2,1,19.78,20.04,7940.87,0.13,80,0.05,441.16,33,47,14,23,0
0,1,0,0,1,1,1,8.6,7.5,483.97,0.02,18,0.13,26.89,5,13,3,0,0
19,5,0,3,3,3,1,19.07,10.91,2270.01,0.07,46,0.09,126.11,20,26,11,19,0
12,3,0,2,2,2,1,14.73,8.94,1176.94,0.04,31,0.11,65.39,13,18,8,12,0
12,9,0,0,5,3,3,17.46,16.55,4779.2,0.1,63,0.06,265.51,28,35,11,12,0
4,1,0,0,1,1,1,9.47,2.67,67.38,0.01,9,0.38,3.74,4,5,3,4,0
13,5,0,0,3,3,1,16.4,7.07,820.29,0.04,29,0.14,45.57,11,18,7,13,0
13,5,0,0,3,3,1,17.24,7.5,969.51,0.04,31,0.13,53.86,12,19,8,13,0
4,3,0,0,2,2,1,11.99,6.67,533.03,0.03,21,0.15,29.61,10,11,6,4,0
0,1,0,0,1,1,1,6.55,3.0,58.95,0.01,7,0.33,3.28,1,6,1,0,0
0,3,0,0,2,2,1,6.69,7.5,376.42,0.02,14,0.13,20.91,5,9,3,0,0
0,1,0,0,1,1,1,7.86,2.5,49.13,0.01,7,0.4,2.73,2,5,2,0,0
0,3,0,0,2,2,1,9.32,5.0,233.02,0.02,13,0.2,12.95,5,8,4,0,0
6,1,0,0,1,1,1,17.51,5.0,437.85,0.03,23,0.2,24.32,10,13,7,6,0
0,3,0,0,2,2,1,7.75,2.0,31.02,0.01,6,0.5,1.72,2,4,2,0,0
0,3,0,0,2,2,1,7.86,2.5,49.13,0.01,7,0.4,2.73,2,5,2,0,0
11,7,0,0,4,2,3,12.35,16.0,3162.47,0.07,45,0.06,175.69,16,29,7,11,0
3,3,0,0,2,2,1,14.28,4.0,228.44,0.02,15,0.25,12.69,6,9,6,3,0
0,1,0,0,1,1,1,0.0,0.0,0.0,0.0,1,0.0,0.0,0,1,0,0,0
2,1,0,0,1,1,1,13.5,2.0,54.0,0.01,9,0.5,3.0,4,5,4,2,0
0,1,0,0,1,1,1,7.75,2.0,31.02,0.01,6,0.5,1.72,2,4,2,0,0
0,1,0,0,1,1,1,7.75,2.0,31.02,0.01,6,0.5,1.72,2,4,2,0,0
0,1,0,0,1,1,1,7.75,2.0,31.02,0.01,6,0.5,1.72,2,4,2,0,0
0,1,0,0,1,1,1,7.74,1.5,17.41,0.0,5,0.67,0.97,2,3,2,0,0
1,1,0,0,1,1,1,7.74,1.5,17.41,0.0,5,0.67,0.97,2,3,2,1,0
0,1,0,0,1,1,1,5.8,2.0,23.22,0.0,5,0.5,1.29,1,4,1,0,0
2,1,0,0,1,1,1,7.75,2.0,31.02,0.01,6,0.5,1.72,2,4,2,2,0
1,1,0,1,1,1,1,0.0,0.0,0.0,0.0,1,0.0,0.0,0,1,0,1,0
2,1,0,0,1,1,1,7.75,2.0,31.02,0.01,6,0.5,1.72,2,4,2,2,0
0,1,0,0,1,1,1,9.31,2.5,58.16,0.01,9,0.4,3.23,1,8,1,0,0
7,3,1,1,2,2,1,21.65,7.39,1182.22,0.05,40,0.14,65.68,19,21,9,8,0
0,1,0,0,1,1,1,7.75,2.0,31.02,0.01,6,0.5,1.72,2,4,2,0,0
0,1,0,0,1,1,1,10.68,4.67,232.53,0.02,15,0.21,12.92,4,11,3,0,0
7,5,0,0,3,2,1,11.89,13.13,2048.55,0.05,35,0.08,113.81,15,20,8,7,0
5,3,0,0,2,2,1,17.22,4.08,287.09,0.02,19,0.24,15.95,7,12,6,5,0
4,3,0,0,2,2,1,11.18,5.63,353.85,0.02,17,0.18,19.66,5,12,4,4,0
0,1,0,0,1,1,1,0.0,0.0,0.0,0.0,0,0.0,0.0,0,0,0,0,0
0,1,0,0,1,1,1,6.2,2.5,38.77,0.01,6,0.4,2.15,1,5,1,0,0
0,1,0,0,1,1,1,11.86,3.5,145.3,0.01,12,0.29,8.07,4,8,4,0,0
0,1,0,0,1,1,1,0.0,0.0,0.0,0.0,0,0.0,0.0,0,0,0,0,0
0,1,0,0,1,1,1,0.0,0.0,0.0,0.0,0,0.0,0.0,0,0,0,0,0
0,1,0,0,1,1,1,0.0,0.0,0.0,0.0,0,0.0,0.0,0,0,0,0,0
0,1,0,0,1,1,1,7.33,4.5,148.5,0.01,11,0.22,8.25,3,8,2,0,0
8,3,0,0,2,1,1,15.07,9.75,1432.72,0.05,34,0.1,79.6,13,21,8,8,0
35,9,3,3,5,3,1,73.66,17.92,23666.9,0.44,214,0.06,1314.83,100,114,53,38,0
3,1,0,0,1,1,1,9.51,3.0,85.59,0.01,9,0.33,4.75,3,6,3,3,0
5,3,0,0,2,2,1,15.36,3.5,188.21,0.02,15,0.29,10.46,5,10,5,5,0
4,3,0,0,2,2,1,10.88,5.6,341.29,0.02,17,0.18,18.96,8,9,5,4,0
0,1,0,0,1,1,1,7.74,1.5,17.41,0.0,5,0.67,0.97,2,3,2,0,0
0,1,0,0,1,1,1,12.68,2.5,79.25,0.01,10,0.4,4.4,4,6,4,0,0
0,1,0,0,1,1,1,7.74,1.5,17.41,0.0,5,0.67,0.97,2,3,2,0,0
0,1,0,0,1,1,1,7.75,2.0,31.02,0.01,6,0.5,1.72,2,4,2,0,0
0,1,0,0,1,1,1,7.75,2.0,31.02,0.01,6,0.5,1.72,2,4,2,0,0
0,1,0,0,1,1,1,7.75,2.0,31.02,0.01,6,0.5,1.72,2,4,2,0,0
0,1,0,0,1,1,1,7.75,2.0,31.02,0.01,6,0.5,1.72,2,4,2,0,0
0,1,0,0,1,1,1,7.74,1.5,17.41,0.0,5,0.67,0.97,2,3,2,0,0
0,1,0,0,1,1,1,9.6,2.5,60.0,0.01,8,0.4,3.33,3,5,3,0,0
0,1,0,0,1,1,1,7.75,2.0,31.02,0.01,6,0.5,1.72,2,4,2,0,0
0,1,0,0,1,1,1,6.86,3.5,84.0,0.01,8,0.29,4.67,1,7,1,0,0
0,1,0,0,1,1,1,7.75,2.0,31.02,0.01,6,0.5,1.72,2,4,2,0,0
0,1,0,0,1,1,1,8.3,6.0,298.97,0.02,15,0.17,16.61,3,12,2,0,0
0,1,0,0,1,1,1,8.3,6.0,298.97,0.02,15,0.17,16.61,3,12,2,0,0
0,1,0,0,1,1,1,8.3,6.0,298.97,0.02,15,0.17,16.61,3,12,2,0,0
74,25,1,17,13,9,3,104.53,29.55,91277.08,1.03,461,0.03,5070.95,197,264,80,75,0
0,1,0,0,1,1,1,7.75,2.0,31.02,0.01,6,0.5,1.72,2,4,2,0,0
0,1,0,0,1,1,1,7.75,2.0,31.02,0.01,6,0.5,1.72,2,4,2,0,0
0,1,0,0,1,1,1,7.75,2.0,31.02,0.01,6,0.5,1.72,2,4,2,0,0
0,1,0,0,1,1,1,7.75,2.0,31.02,0.01,6,0.5,1.72,2,4,2,0,0
0,3,0,0,2,1,1,7.75,2.0,31.02,0.01,6,0.5,1.72,2,4,2,0,0
0,1,0,0,1,1,1,5.8,2.0,23.22,0.0,5,0.5,1.29,1,4,1,0,0
0,3,0,0,2,1,1,7.75,2.0,31.02,0.01,6,0.5,1.72,2,4,2,0,0
0,1,0,0,1,1,1,12.18,3.0,109.62,0.01,11,0.33,6.09,4,7,4,0,0
0,1,0,0,1,1,1,7.75,2.0,31.02,0.01,6,0.5,1.72,2,4,2,0,0
0,1,0,0,1,1,1,7.75,2.0,31.02,0.01,6,0.5,1.72,2,4,2,0,0
0,1,0,0,1,1,1,7.75,2.0,31.02,0.01,6,0.5,1.72,2,4,2,0,0
0,1,0,0,1,1,1,5.8,2.0,23.22,0.0,5,0.5,1.29,1,4,1,0,0
0,1,0,0,1,1,1,7.75,2.0,31.02,0.01,6,0.5,1.72,2,4,2,0,0
2,1,0,0,1,1,1,8.98,2.5,56.15,0.01,8,0.4,3.12,2,6,2,2,0
2,1,0,0,1,1,1,5.33,1.5,12.0,0.0,4,0.67,0.67,1,3,1,2,0
0,1,0,0,1,1,1,5.33,1.5,12.0,0.0,4,0.67,0.67,1,3,1,0,0
2,1,0,0,1,1,1,5.33,1.5,12.0,0.0,4,0.67,0.67,1,3,1,2,0
2,1,0,0,1,1,1,5.33,1.5,12.0,0.0,4,0.67,0.67,1,3,1,2,0
3,1,0,0,1,1,1,12.0,2.5,75.0,0.01,10,0.4,4.17,3,7,3,3,0
0,1,0,0,1,1,1,7.86,2.5,49.13,0.01,7,0.4,2.73,2,5,2,0,0
0,1,0,0,1,1,1,6.55,3.0,58.95,0.01,7,0.33,3.28,1,6,1,0,0
0,1,0,0,1,1,1,6.55,3.0,58.95,0.01,7,0.33,3.28,1,6,1,0,0
2,1,0,0,1,1,1,8.98,2.5,56.15,0.01,8,0.4,3.12,2,6,2,2,0
2,1,0,0,1,1,1,5.33,1.5,12.0,0.0,4,0.67,0.67,1,3,1,2,0
0,1,0,0,1,1,1,5.33,1.5,12.0,0.0,4,0.67,0.67,1,3,1,0,0
2,1,0,0,1,1,1,5.33,1.5,12.0,0.0,4,0.67,0.67,1,3,1,2,0
2,1,0,0,1,1,1,5.33,1.5,12.0,0.0,4,0.67,0.67,1,3,1,2,0
0,1,0,0,1,1,1,5.33,1.5,12.0,0.0,4,0.67,0.67,1,3,1,0,0
0,1,0,0,1,1,1,5.33,1.5,12.0,0.0,4,0.67,0.67,1,3,1,0,0
0,1,0,0,1,1,1,7.75,2.0,31.02,0.01,6,0.5,1.72,2,4,2,0,0
0,1,0,0,1,1,1,9.0,3.0,81.0,0.01,9,0.33,4.5,2,7,2,0,0
0,1,0,0,1,1,1,8.3,6.0,298.97,0.02,15,0.17,16.61,3,12,2,0,0
2,1,0,0,1,1,1,7.74,1.5,17.41,0.0,5,0.67,0.97,2,3,2,2,0
0,1,0,0,1,1,1,9.51,3.0,85.59,0.01,9,0.33,4.75,3,6,3,0,0
0,1,0,0,1,1,1,9.51,3.0,85.59,0.01,9,0.33,4.75,3,6,3,0,0
0,1,0,0,1,1,1,9.51,3.0,85.59,0.01,9,0.33,4.75,3,6,3,0,0
0,1,0,0,1,1,1,9.51,3.0,85.59,0.01,9,0.33,4.75,3,6,3,0,0
4,3,0,0,2,2,1,13.67,6.0,492.27,0.03,21,0.17,27.35,6,15,5,4,0
9,5,0,0,3,1,1,11.46,13.2,1996.32,0.05,37,0.08,110.91,11,26,5,9,0
12,5,0,0,3,1,1,15.35,9.64,1427.14,0.05,37,0.1,79.29,15,22,7,12,0
9,3,0,3,2,1,1,11.26,10.0,1125.88,0.04,27,0.1,62.55,10,17,6,9,0
2,1,0,0,1,1,1,7.74,1.5,17.41,0.0,5,0.67,0.97,2,3,2,2,0
0,1,0,0,1,1,1,5.33,1.5,12.0,0.0,4,0.67,0.67,1,3,1,0,0
0,1,0,0,1,1,1,5.33,1.5,12.0,0.0,4,0.67,0.67,1,3,1,0,0
0,1,0,0,1,1,1,5.33,1.5,12.0,0.0,4,0.67,0.67,1,3,1,0,0
3,1,0,0,1,1,1,9.0,3.33,100.0,0.01,10,0.3,5.56,4,6,3,3,0
8,1,0,0,1,1,1,23.01,5.63,728.16,0.04,34,0.18,40.45,15,19,8,8,0
2,1,0,0,1,1,1,7.74,1.5,17.41,0.0,5,0.67,0.97,2,3,2,2,0
0,1,0,0,1,1,1,7.74,1.5,17.41,0.0,5,0.67,0.97,2,3,2,0,0
2,1,0,0,1,1,1,7.74,1.5,17.41,0.0,5,0.67,0.97,2,3,2,2,0
0,1,0,0,1,1,1,7.74,1.5,17.41,0.0,5,0.67,0.97,2,3,2,0,0
4,1,0,0,1,1,1,10.24,7.0,501.89,0.02,20,0.14,27.88,7,13,4,4,0
4,3,0,0,2,2,1,21.5,7.15,1099.18,0.05,35,0.14,61.07,13,22,10,4,0
8,3,0,0,2,2,1,23.46,10.29,2485.24,0.08,52,0.1,138.07,19,33,12,8,0
54,13,1,8,7,6,6,25.11,40.0,40181.42,0.33,184,0.03,2232.3,80,104,22,55,0
0,1,0,0,1,1,1,8.3,6.67,369.01,0.02,16,0.15,20.5,5,11,3,0,0
23,5,0,1,3,2,1,19.78,20.04,7940.87,0.13,80,0.05,441.16,33,47,14,23,0
0,1,0,0,1,1,1,8.6,7.5,483.97,0.02,18,0.13,26.89,5,13,3,0,0
19,5,0,3,3,3,1,19.07,10.91,2270.01,0.07,46,0.09,126.11,20,26,11,19,0
12,3,0,2,2,2,1,14.73,8.94,1176.94,0.04,31,0.11,65.39,13,18,8,12,0
12,9,0,0,5,3,3,17.46,16.55,4779.2,0.1,63,0.06,265.51,28,35,11,12,0
4,1,0,0,1,1,1,9.47,2.67,67.38,0.01,9,0.38,3.74,4,5,3,4,0
13,5,0,0,3,3,1,16.4,7.07,820.29,0.04,29,0.14,45.57,11,18,7,13,0
13,5,0,0,3,3,1,17.24,7.5,969.51,0.04,31,0.13,53.86,12,19,8,13,0
4,3,0,0,2,2,1,11.99,6.67,533.03,0.03,21,0.15,29.61,10,11,6,4,0
0,1,0,0,1,1,1,6.55,3.0,58.95,0.01,7,0.33,3.28,1,6,1,0,0
0,3,0,0,2,2,1,6.69,7.5,376.42,0.02,14,0.13,20.91,5,9,3,0,0
0,1,0,0,1,1,1,7.86,2.5,49.13,0.01,7,0.4,2.73,2,5,2,0,0
0,3,0,0,2,2,1,9.32,5.0,233.02,0.02,13,0.2,12.95,5,8,4,0,0
6,1,0,0,1,1,1,17.51,5.0,437.85,0.03,23,0.2,24.32,10,13,7,6,0
0,3,0,0,2,2,1,7.75,2.0,31.02,0.01,6,0.5,1.72,2,4,2,0,0
0,3,0,0,2,2,1,7.86,2.5,49.13,0.01,7,0.4,2.73,2,5,2,0,0
11,7,0,0,4,2,3,12.35,16.0,3162.47,0.07,45,0.06,175.69,16,29,7,11,0
3,3,0,0,2,2,1,14.28,4.0,228.44,0.02,15,0.25,12.69,6,9,6,3,0
0,1,0,0,1,1,1,0.0,0.0,0.0,0.0,1,0.0,0.0,0,1,0,0,0
2,1,0,0,1,1,1,13.5,2.0,54.0,0.01,9,0.5,3.0,4,5,4,2,0
0,1,0,0,1,1,1,7.75,2.0,31.02,0.01,6,0.5,1.72,2,4,2,0,0
0,1,0,0,1,1,1,7.75,2.0,31.02,0.01,6,0.5,1.72,2,4,2,0,0
0,1,0,0,1,1,1,7.75,2.0,31.02,0.01,6,0.5,1.72,2,4,2,0,0
0,1,0,0,1,1,1,7.74,1.5,17.41,0.0,5,0.67,0.97,2,3,2,0,0
1,1,0,0,1,1,1,7.74,1.5,17.41,0.0,5,0.67,0.97,2,3,2,1,0
0,1,0,0,1,1,1,5.8,2.0,23.22,0.0,5,0.5,1.29,1,4,1,0,0
2,1,0,0,1,1,1,7.75,2.0,31.02,0.01,6,0.5,1.72,2,4,2,2,0
1,1,0,1,1,1,1,0.0,0.0,0.0,0.0,1,0.0,0.0,0,1,0,1,0
2,1,0,0,1,1,1,7.75,2.0,31.02,0.01,6,0.5,1.72,2,4,2,2,0
0,1,0,0,1,1,1,9.31,2.5,58.16,0.01,9,0.4,3.23,1,8,1,0,0
0,1,0,0,1,1,1,7.75,2.0,31.02,0.01,6,0.5,1.72,2,4,2,0,0
0,1,0,0,1,1,1,10.68,4.67,232.53,0.02,15,0.21,12.92,4,11,3,0,0
7,5,0,0,3,2,1,11.89,13.13,2048.55,0.05,35,0.08,113.81,15,20,8,7,0
5,3,0,0,2,2,1,17.22,4.08,287.09,0.02,19,0.24,15.95,7,12,6,5,0
4,3,0,0,2,2,1,11.18,5.63,353.85,0.02,17,0.18,19.66,5,12,4,4,0
0,1,0,0,1,1,1,0.0,0.0,0.0,0.0,0,0.0,0.0,0,0,0,0,0
3,1,0,0,1,1,1,10.34,2.0,41.36,0.01,8,0.5,2.3,2,6,2,3,0
3,1,0,0,1,1,1,10.34,2.0,41.36,0.01,8,0.5,2.3,2,6,2,3,0
3,1,0,0,1,1,1,10.34,2.0,41.36,0.01,8,0.5,2.3,2,6,2,3,0
3,1,0,0,1,1,1,10.34,2.0,41.36,0.01,8,0.5,2.3,2,6,2,3,0
0,1,0,0,1,1,1,6.2,2.5,38.77,0.01,6,0.4,2.15,1,5,1,0,0
0,1,0,0,1,1,1,11.86,3.5,145.3,0.01,12,0.29,8.07,4,8,4,0,0
0,1,0,0,1,1,1,0.0,0.0,0.0,0.0,0,0.0,0.0,0,0,0,0,0
0,1,0,0,1,1,1,0.0,0.0,0.0,0.0,0,0.0,0.0,0,0,0,0,0
0,1,0,0,1,1,1,0.0,0.0,0.0,0.0,0,0.0,0.0,0,0,0,0,0
0,1,0,0,1,1,1,7.33,4.5,148.5,0.01,11,0.22,8.25,3,8,2,0,0
8,3,0,0,2,1,1,15.07,9.75,1432.72,0.05,34,0.1,79.6,13,21,8,8,0
2,1,0,0,1,1,1,7.74,1.5,17.41,0.0,5,0.67,0.97,2,3,2,2,0
2,1,0,0,1,1,1,8.15,3.5,99.85,0.01,9,0.29,5.55,2,7,2,2,0
3,1,0,0,1,1,1,8.72,4.0,139.48,0.01,11,0.25,7.75,4,7,3,3,0
2,1,0,0,1,1,1,7.74,1.5,17.41,0.0,5,0.67,0.97,2,3,2,2,0
3,1,0,0,1,1,1,9.73,5.33,276.75,0.02,15,0.19,15.38,4,11,3,3,0
2,1,0,0,1,1,1,7.71,3.5,94.5,0.01,9,0.29,5.25,1,8,1,2,0
2,1,0,0,1,1,1,7.71,3.5,94.5,0.01,9,0.29,5.25,1,8,1,2,0
2,1,0,0,1,1,1,7.71,3.5,94.5,0.01,9,0.29,5.25,1,8,1,2,0
2,1,0,0,1,1,1,7.71,3.5,94.5,0.01,9,0.29,5.25,1,8,1,2,0
2,1,0,0,1,1,1,9.96,3.5,122.04,0.01,11,0.29,6.78,2,9,2,2,0
3,1,0,0,1,1,1,9.51,4.0,152.21,0.01,11,0.25,8.46,3,8,3,3,0
2,1,0,1,1,1,1,7.71,3.5,94.5,0.01,9,0.29,5.25,1,8,1,2,0
2,1,0,0,1,1,1,9.43,3.5,115.5,0.01,11,0.29,6.42,1,10,1,2,0
2,1,0,0,1,1,1,9.96,3.5,122.04,0.01,11,0.29,6.78,2,9,2,2,0
2,1,0,0,1,1,1,9.96,3.5,122.04,0.01,11,0.29,6.78,2,9,2,2,0
2,1,0,0,1,1,1,9.96,3.5,122.04,0.01,11,0.29,6.78,2,9,2,2,0
2,1,0,0,1,1,1,9.96,3.5,122.04,0.01,11,0.29,6.78,2,9,2,2,0
2,1,0,0,1,1,1,7.71,3.5,94.5,0.01,9,0.29,5.25,1,8,1,2,0
8,5,2,1,3,3,1,18.05,12.09,2638.98,0.07,47,0.08,146.61,19,28,11,10,0
3,1,0,1,1,1,1,7.75,6.0,279.04,0.02,14,0.17,15.5,3,11,2,3,0
3,1,0,0,1,1,1,9.51,3.0,85.59,0.01,9,0.33,4.75,3,6,3,3,0
5,3,0,0,2,2,1,15.36,3.5,188.21,0.02,15,0.29,10.46,5,10,5,5,0
4,3,0,0,2,2,1,10.88,5.6,341.29,0.02,17,0.18,18.96,8,9,5,4,0
0,1,0,0,1,1,1,7.74,1.5,17.41,0.0,5,0.67,0.97,2,3,2,0,0
0,1,0,0,1,1,1,12.68,2.5,79.25,0.01,10,0.4,4.4,4,6,4,0,0
0,1,0,0,1,1,1,7.74,1.5,17.41,0.0,5,0.67,0.97,2,3,2,0,0
0,1,0,0,1,1,1,7.75,2.0,31.02,0.01,6,0.5,1.72,2,4,2,0,0
0,1,0,0,1,1,1,7.75,2.0,31.02,0.01,6,0.5,1.72,2,4,2,0,0
0,1,0,0,1,1,1,7.75,2.0,31.02,0.01,6,0.5,1.72,2,4,2,0,0
0,1,0,0,1,1,1,7.75,2.0,31.02,0.01,6,0.5,1.72,2,4,2,0,0
7,3,0,0,2,2,1,15.65,7.31,836.91,0.04,28,0.14,46.49,13,15,8,7,0
0,1,0,0,1,1,1,9.6,2.5,60.0,0.01,8,0.4,3.33,3,5,3,0,0
0,1,0,0,1,1,1,7.75,2.0,31.02,0.01,6,0.5,1.72,2,4,2,0,0
0,1,0,0,1,1,1,6.86,3.5,84.0,0.01,8,0.29,4.67,1,7,1,0,0
0,1,0,0,1,1,1,7.75,2.0,31.02,0.01,6,0.5,1.72,2,4,2,0,0
0,1,0,0,1,1,1,8.3,6.0,298.97,0.02,15,0.17,16.61,3,12,2,0,0
0,1,0,0,1,1,1,8.3,6.0,298.97,0.02,15,0.17,16.61,3,12,2,0,0
0,1,0,0,1,1,1,8.3,6.0,298.97,0.02,15,0.17,16.61,3,12,2,0,0
0,1,0,0,1,1,1,7.75,2.0,31.02,0.01,6,0.5,1.72,2,4,2,0,0
0,1,0,0,1,1,1,7.75,2.0,31.02,0.01,6,0.5,1.72,2,4,2,0,0
0,1,0,0,1,1,1,7.75,2.0,31.02,0.01,6,0.5,1.72,2,4,2,0,0
0,1,0,0,1,1,1,7.75,2.0,31.02,0.01,6,0.5,1.72,2,4,2,0,0
0,3,0,0,2,1,1,7.75,2.0,31.02,0.01,6,0.5,1.72,2,4,2,0,0
0,1,0,0,1,1,1,5.8,2.0,23.22,0.0,5,0.5,1.29,1,4,1,0,0
0,3,0,0,2,1,1,7.75,2.0,31.02,0.01,6,0.5,1.72,2,4,2,0,0
0,1,0,0,1,1,1,12.18,3.0,109.62,0.01,11,0.33,6.09,4,7,4,0,0
0,1,0,0,1,1,1,7.75,2.0,31.02,0.01,6,0.5,1.72,2,4,2,0,0
0,1,0,0,1,1,1,7.75,2.0,31.02,0.01,6,0.5,1.72,2,4,2,0,0
0,1,0,0,1,1,1,7.75,2.0,31.02,0.01,6,0.5,1.72,2,4,2,0,0
0,1,0,0,1,1,1,5.8,2.0,23.22,0.0,5,0.5,1.29,1,4,1,0,0
0,1,0,0,1,1,1,7.75,2.0,31.02,0.01,6,0.5,1.72,2,4,2,0,0
2,1,0,0,1,1,1,8.98,2.5,56.15,0.01,8,0.4,3.12,2,6,2,2,0
2,1,0,0,1,1,1,5.33,1.5,12.0,0.0,4,0.67,0.67,1,3,1,2,0
0,1,0,0,1,1,1,5.33,1.5,12.0,0.0,4,0.67,0.67,1,3,1,0,0
2,1,0,0,1,1,1,5.33,1.5,12.0,0.0,4,0.67,0.67,1,3,1,2,0
2,1,0,0,1,1,1,5.33,1.5,12.0,0.0,4,0.67,0.67,1,3,1,2,0
3,1,0,0,1,1,1,12.0,2.5,75.0,0.01,10,0.4,4.17,3,7,3,3,0
0,1,0,0,1,1,1,7.86,2.5,49.13,0.01,7,0.4,2.73,2,5,2,0,0
0,1,0,0,1,1,1,6.55,3.0,58.95,0.01,7,0.33,3.28,1,6,1,0,0
0,1,0,0,1,1,1,6.55,3.0,58.95,0.01,7,0.33,3.28,1,6,1,0,0
2,1,0,0,1,1,1,8.98,2.5,56.15,0.01,8,0.4,3.12,2,6,2,2,0
2,1,0,0,1,1,1,5.33,1.5,12.0,0.0,4,0.67,0.67,1,3,1,2,0
0,1,0,0,1,1,1,5.33,1.5,12.0,0.0,4,0.67,0.67,1,3,1,0,0
2,1,0,0,1,1,1,5.33,1.5,12.0,0.0,4,0.67,0.67,1,3,1,2,0
2,1,0,0,1,1,1,5.33,1.5,12.0,0.0,4,0.67,0.67,1,3,1,2,0
0,1,0,0,1,1,1,5.33,1.5,12.0,0.0,4,0.67,0.67,1,3,1,0,0
0,1,0,0,1,1,1,5.33,1.5,12.0,0.0,4,0.67,0.67,1,3,1,0,0
0,1,0,0,1,1,1,7.75,2.0,31.02,0.01,6,0.5,1.72,2,4,2,0,0
0,1,0,0,1,1,1,9.0,3.0,81.0,0.01,9,0.33,4.5,2,7,2,0,0
0,1,0,0,1,1,1,8.3,6.0,298.97,0.02,15,0.17,16.61,3,12,2,0,0
0,1,0,0,1,1,1,9.51,3.0,85.59,0.01,9,0.33,4.75,3,6,3,0,0
0,1,0,0,1,1,1,9.51,3.0,85.59,0.01,9,0.33,4.75,3,6,3,0,0
0,1,0,0,1,1,1,9.51,3.0,85.59,0.01,9,0.33,4.75,3,6,3,0,0
0,1,0,0,1,1,1,9.51,3.0,85.59,0.01,9,0.33,4.75,3,6,3,0,0
4,3,0,0,2,2,1,13.67,6.0,492.27,0.03,21,0.17,27.35,6,15,5,4,0
9,5,0,4,1,1,1,13.75,16.89,3921.48,0.08,50,0.06,217.86,19,31,9,9,0
3,1,0,0,1,1,1,10.34,2.0,41.36,0.01,8,0.5,2.3,2,6,2,3,0
3,1,0,0,1,1,1,10.34,2.0,41.36,0.01,8,0.5,2.3,2,6,2,3,0
3,1,0,0,1,1,1,10.34,2.0,41.36,0.01,8,0.5,2.3,2,6,2,3,0
3,1,0,0,1,1,1,10.34,2.0,41.36,0.01,8,0.5,2.3,2,6,2,3,0
2,1,1,0,1,1,1,11.23,2.0,44.92,0.01,8,0.5,2.5,3,5,3,3,0
0,1,0,0,1,1,1,5.8,2.0,23.22,0.0,5,0.5,1.29,1,4,1,0,0
0,1,0,0,1,1,1,5.8,2.0,23.22,0.0,5,0.5,1.29,1,4,1,0,0
0,1,0,0,1,1,1,7.74,1.5,17.41,0.0,5,0.67,0.97,2,3,2,0,0
0,1,0,0,1,1,1,7.74,1.5,17.41,0.0,5,0.67,0.97,2,3,2,0,0
6,5,0,0,3,2,3,7.47,8.0,478.36,0.02,18,0.13,26.58,4,14,2,6,0
7,3,0,0,2,2,1,7.35,8.0,470.48,0.02,17,0.13,26.14,6,11,3,7,0
26,11,0,0,6,6,5,27.75,18.07,9063.48,0.17,108,0.06,503.53,46,62,14,26,0
6,3,0,0,2,2,1,7.75,6.0,279.04,0.02,14,0.17,15.5,3,11,2,6,0
6,3,0,0,2,2,1,7.85,5.25,216.35,0.01,13,0.19,12.02,3,10,2,6,0
25,11,0,0,6,5,3,25.54,12.73,4136.76,0.11,74,0.08,229.82,28,46,11,25,0
6,5,0,0,3,2,3,7.47,8.0,478.36,0.02,18,0.13,26.58,4,14,2,6,0
6,5,0,0,3,2,3,7.47,8.0,478.36,0.02,18,0.13,26.58,4,14,2,6,0
9,3,0,0,2,2,1,18.89,5.63,597.79,0.04,26,0.18,33.21,10,16,8,9,0
9,3,0,0,2,2,1,18.89,5.63,597.79,0.04,26,0.18,33.21,10,16,8,9,0
11,5,0,0,3,2,1,14.85,6.67,659.94,0.03,26,0.15,36.66,10,16,6,11,0
11,5,0,0,3,2,1,14.85,6.67,659.94,0.03,26,0.15,36.66,10,16,6,11,0
11,5,0,0,3,2,1,14.85,6.67,659.94,0.03,26,0.15,36.66,10,16,6,11,0
11,5,0,0,3,2,1,14.85,6.67,659.94,0.03,26,0.15,36.66,10,16,6,11,0
0,1,0,0,1,1,1,5.33,1.5,12.0,0.0,4,0.67,0.67,1,3,1,0,0
13,5,0,2,3,3,1,22.99,6.22,890.16,0.05,35,0.16,49.45,14,21,9,13,0
22,11,0,2,6,4,3,26.88,10.77,3117.78,0.1,64,0.09,173.21,28,36,13,22,0
17,7,0,2,4,4,3,23.6,8.1,1548.37,0.06,45,0.12,86.02,18,27,10,17,0
9,3,0,0,2,2,1,13.71,6.67,609.18,0.03,24,0.15,33.84,10,14,6,9,0
10,3,0,0,2,2,1,16.78,6.29,663.06,0.04,27,0.16,36.84,11,16,7,10,0
7,3,0,0,2,2,1,7.35,8.0,470.48,0.02,17,0.13,26.14,6,11,3,7,0
7,3,0,0,2,1,1,7.59,7.0,372.06,0.02,16,0.14,20.67,6,10,3,7,0
7,3,0,0,2,1,1,7.59,7.0,372.06,0.02,16,0.14,20.67,6,10,3,7,0
7,3,0,0,2,2,1,7.35,8.0,470.48,0.02,17,0.13,26.14,6,11,3,7,0
0,1,0,0,1,1,1,5.33,1.5,12.0,0.0,4,0.67,0.67,1,3,1,0,0
0,1,0,0,1,1,1,5.33,1.5,12.0,0.0,4,0.67,0.67,1,3,1,0,0
0,1,0,0,1,1,1,5.33,1.5,12.0,0.0,4,0.67,0.67,1,3,1,0,0
0,1,0,0,1,1,1,5.33,1.5,12.0,0.0,4,0.67,0.67,1,3,1,0,0
0,1,0,0,1,1,1,5.33,1.5,12.0,0.0,4,0.67,0.67,1,3,1,0,0
0,1,0,0,1,1,1,0.0,0.0,0.0,0.0,0,0.0,0.0,0,0,0,0,0
0,1,0,0,1,1,1,0.0,0.0,0.0,0.0,0,0.0,0.0,0,0,0,0,0
0,1,0,0,1,1,1,5.33,1.5,12.0,0.0,4,0.67,0.67,1,3,1,0,0
0,1,0,0,1,1,1,5.33,1.5,12.0,0.0,4,0.67,0.67,1,3,1,0,0
0,1,0,0,1,1,1,5.33,1.5,12.0,0.0,4,0.67,0.67,1,3,1,0,0
0,1,0,0,1,1,1,5.33,1.5,12.0,0.0,4,0.67,0.67,1,3,1,0,0
4,3,0,0,2,2,1,9.25,4.67,201.53,0.01,13,0.21,11.2,4,9,3,4,0
4,3,0,0,2,2,1,9.08,5.33,258.3,0.02,14,0.19,14.35,4,10,3,4,0
4,3,0,0,2,2,1,9.08,5.33,258.3,0.02,14,0.19,14.35,4,10,3,4,0
4,3,0,0,2,2,1,9.25,4.67,201.53,0.01,13,0.21,11.2,4,9,3,4,0
4,3,0,0,2,2,1,9.08,5.33,258.3,0.02,14,0.19,14.35,4,10,3,4,0
4,3,0,0,2,2,1,9.08,5.33,258.3,0.02,14,0.19,14.35,4,10,3,4,0
4,3,0,0,2,2,1,9.08,5.33,258.3,0.02,14,0.19,14.35,4,10,3,4,0
4,3,0,0,2,2,1,9.08,5.33,258.3,0.02,14,0.19,14.35,4,10,3,4,0
4,3,0,0,2,2,1,9.08,5.33,258.3,0.02,14,0.19,14.35,4,10,3,4,0
4,3,0,0,2,2,1,9.08,5.33,258.3,0.02,14,0.19,14.35,4,10,3,4,0
4,3,0,0,2,2,1,9.08,5.33,258.3,0.02,14,0.19,14.35,4,10,3,4,0
4,3,0,0,2,2,1,9.08,5.33,258.3,0.02,14,0.19,14.35,4,10,3,4,0
4,1,0,0,1,1,1,13.45,3.6,174.36,0.02,14,0.28,9.69,6,8,5,4,0
4,1,0,0,1,1,1,13.45,3.6,174.36,0.02,14,0.28,9.69,6,8,5,4,0
4,1,0,0,1,1,1,13.45,3.6,174.36,0.02,14,0.28,9.69,6,8,5,4,0
4,1,0,0,1,1,1,13.45,3.6,174.36,0.02,14,0.28,9.69,6,8,5,4,0
4,1,0,0,1,1,1,13.45,3.6,174.36,0.02,14,0.28,9.69,6,8,5,4,0
3,1,0,0,1,1,1,11.23,2.0,44.92,0.01,8,0.5,2.5,3,5,3,3,0
0,1,0,0,1,1,1,5.33,1.5,12.0,0.0,4,0.67,0.67,1,3,1,0,0
3,1,0,0,1,1,1,11.23,2.0,44.92,0.01,8,0.5,2.5,3,5,3,3,0
0,1,0,0,1,1,1,5.33,1.5,12.0,0.0,4,0.67,0.67,1,3,1,0,0
4,1,0,0,1,1,1,10.24,7.0,501.89,0.02,20,0.14,27.88,7,13,4,4,0
4,3,0,0,2,2,1,21.5,7.15,1099.18,0.05,35,0.14,61.07,13,22,10,4,0
8,3,0,0,2,2,1,23.46,10.29,2485.24,0.08,52,0.1,138.07,19,33,12,8,0
54,13,1,8,7,6,6,25.11,40.0,40181.42,0.33,184,0.03,2232.3,80,104,22,55,0
0,1,0,0,1,1,1,8.3,6.67,369.01,0.02,16,0.15,20.5,5,11,3,0,0
23,5,0,1,3,2,1,19.78,20.04,7940.87,0.13,80,0.05,441.16,33,47,14,23,0
0,1,0,0,1,1,1,8.6,7.5,483.97,0.02,18,0.13,26.89,5,13,3,0,0
19,5,0,3,3,3,1,19.07,10.91,2270.01,0.07,46,0.09,126.11,20,26,11,19,0
12,3,0,2,2,2,1,14.73,8.94,1176.94,0.04,31,0.11,65.39,13,18,8,12,0
12,9,0,0,5,3,3,17.46,16.55,4779.2,0.1,63,0.06,265.51,28,35,11,12,0
4,1,0,0,1,1,1,9.47,2.67,67.38,0.01,9,0.38,3.74,4,5,3,4,0
13,5,0,0,3,3,1,16.4,7.07,820.29,0.04,29,0.14,45.57,11,18,7,13,0
13,5,0,0,3,3,1,17.24,7.5,969.51,0.04,31,0.13,53.86,12,19,8,13,0
4,3,0,0,2,2,1,11.99,6.67,533.03,0.03,21,0.15,29.61,10,11,6,4,0
0,1,0,0,1,1,1,6.55,3.0,58.95,0.01,7,0.33,3.28,1,6,1,0,0
0,3,0,0,2,2,1,6.69,7.5,376.42,0.02,14,0.13,20.91,5,9,3,0,0
0,1,0,0,1,1,1,7.86,2.5,49.13,0.01,7,0.4,2.73,2,5,2,0,0
0,3,0,0,2,2,1,9.32,5.0,233.02,0.02,13,0.2,12.95,5,8,4,0,0
6,1,0,0,1,1,1,17.51,5.0,437.85,0.03,23,0.2,24.32,10,13,7,6,0
0,3,0,0,2,2,1,7.75,2.0,31.02,0.01,6,0.5,1.72,2,4,2,0,0
0,3,0,0,2,2,1,7.86,2.5,49.13,0.01,7,0.4,2.73,2,5,2,0,0
11,7,0,0,4,2,3,12.35,16.0,3162.47,0.07,45,0.06,175.69,16,29,7,11,0
6,1,0,0,1,1,1,11.81,6.75,538.15,0.03,24,0.15,29.9,9,15,4,6,0
10,3,0,0,2,2,1,13.4,7.0,656.36,0.03,24,0.14,36.46,7,17,5,10,0
3,3,0,0,2,2,1,14.28,4.0,228.44,0.02,15,0.25,12.69,6,9,6,3,0
0,1,0,0,1,1,1,0.0,0.0,0.0,0.0,1,0.0,0.0,0,1,0,0,0
2,1,0,0,1,1,1,13.5,2.0,54.0,0.01,9,0.5,3.0,4,5,4,2,0
0,1,0,0,1,1,1,7.75,2.0,31.02,0.01,6,0.5,1.72,2,4,2,0,0
0,1,0,0,1,1,1,7.75,2.0,31.02,0.01,6,0.5,1.72,2,4,2,0,0
0,1,0,0,1,1,1,6.2,2.5,38.77,0.01,6,0.4,2.15,1,5,1,0,0
0,1,0,0,1,1,1,6.2,2.5,38.77,0.01,6,0.4,2.15,1,5,1,0,0
0,1,0,0,1,1,1,6.2,2.5,38.77,0.01,6,0.4,2.15,1,5,1,0,0
0,1,0,0,1,1,1,7.75,2.0,31.02,0.01,6,0.5,1.72,2,4,2,0,0
0,1,0,0,1,1,1,7.74,1.5,17.41,0.0,5,0.67,0.97,2,3,2,0,0
21,11,0,0,6,1,3,8.36,27.0,6094.62,0.08,61,0.04,338.59,24,37,4,21,0
18,9,0,0,5,1,1,6.16,28.5,5006.4,0.06,49,0.04,278.13,19,30,3,18,0
0,1,0,0,1,1,1,0.0,0.0,0.0,0.0,1,0.0,0.0,0,1,0,0,0
0,1,0,0,1,1,1,7.74,1.5,17.41,0.0,5,0.67,0.97,2,3,2,0,0
3,3,0,0,2,1,1,5.07,8.75,388.32,0.01,14,0.11,21.57,5,9,2,3,0
3,3,0,0,2,1,1,5.07,8.75,388.32,0.01,14,0.11,21.57,5,9,2,3,0
1,1,0,0,1,1,1,7.74,1.5,17.41,0.0,5,0.67,0.97,2,3,2,1,0
0,1,0,0,1,1,1,5.8,2.0,23.22,0.0,5,0.5,1.29,1,4,1,0,0
2,1,0,0,1,1,1,7.75,2.0,31.02,0.01,6,0.5,1.72,2,4,2,2,0
1,1,0,1,1,1,1,0.0,0.0,0.0,0.0,1,0.0,0.0,0,1,0,1,0
2,1,0,0,1,1,1,7.75,2.0,31.02,0.01,6,0.5,1.72,2,4,2,2,0
0,1,0,0,1,1,1,9.31,2.5,58.16,0.01,9,0.4,3.23,1,8,1,0,0
3,1,0,0,1,1,1,6.89,3.0,62.04,0.01,8,0.33,3.45,3,5,2,3,0
0,1,0,0,1,1,1,7.75,2.0,31.02,0.01,6,0.5,1.72,2,4,2,0,0
0,1,0,0,1,1,1,10.68,4.67,232.53,0.02,15,0.21,12.92,4,11,3,0,0
7,5,0,0,3,2,1,11.89,13.13,2048.55,0.05,35,0.08,113.81,15,20,8,7,0
5,3,0,0,2,2,1,17.22,4.08,287.09,0.02,19,0.24,15.95,7,12,6,5,0
4,3,0,0,2,2,1,11.18,5.63,353.85,0.02,17,0.18,19.66,5,12,4,4,0
0,1,0,0,1,1,1,0.0,0.0,0.0,0.0,0,0.0,0.0,0,0,0,0,0
0,1,0,0,1,1,1,6.2,2.5,38.77,0.01,6,0.4,2.15,1,5,1,0,0
0,1,0,0,1,1,1,11.86,3.5,145.3,0.01,12,0.29,8.07,4,8,4,0,0
0,1,0,0,1,1,1,0.0,0.0,0.0,0.0,0,0.0,0.0,0,0,0,0,0
0,1,0,0,1,1,1,0.0,0.0,0.0,0.0,0,0.0,0.0,0,0,0,0,0
0,1,0,0,1,1,1,0.0,0.0,0.0,0.0,0,0.0,0.0,0,0,0,0,0
0,1,0,0,1,1,1,7.33,4.5,148.5,0.01,11,0.22,8.25,3,8,2,0,0
8,3,0,0,2,1,1,15.07,9.75,1432.72,0.05,34,0.1,79.6,13,21,8,8,0
0,1,0,0,1,1,1,8.0,1.0,8.0,0.0,4,1.0,0.44,2,2,2,0,0
3,1,0,0,1,1,1,9.51,3.0,85.59,0.01,9,0.33,4.75,3,6,3,3,0
5,3,0,0,2,2,1,15.36,3.5,188.21,0.02,15,0.29,10.46,5,10,5,5,0
0,1,0,0,1,1,1,6.55,3.0,58.95,0.01,7,0.33,3.28,1,6,1,0,0
0,1,0,0,1,1,1,6.55,3.0,58.95,0.01,7,0.33,3.28,1,6,1,0,0
0,1,0,0,1,1,1,6.55,3.0,58.95,0.01,7,0.33,3.28,1,6,1,0,0
0,1,0,0,1,1,1,5.8,2.0,23.22,0.0,5,0.5,1.29,1,4,1,0,0
4,3,0,0,2,2,1,10.88,5.6,341.29,0.02,17,0.18,18.96,8,9,5,4,0
0,1,0,0,1,1,1,7.74,1.5,17.41,0.0,5,0.67,0.97,2,3,2,0,0
0,1,0,0,1,1,1,12.68,2.5,79.25,0.01,10,0.4,4.4,4,6,4,0,0
0,1,0,0,1,1,1,7.74,1.5,17.41,0.0,5,0.67,0.97,2,3,2,0,0
0,1,0,0,1,1,1,7.75,2.0,31.02,0.01,6,0.5,1.72,2,4,2,0,0
0,1,0,0,1,1,1,7.75,2.0,31.02,0.01,6,0.5,1.72,2,4,2,0,0
0,1,0,0,1,1,1,7.75,2.0,31.02,0.01,6,0.5,1.72,2,4,2,0,0
0,1,0,0,1,1,1,7.75,2.0,31.02,0.01,6,0.5,1.72,2,4,2,0,0
3,1,0,0,1,1,1,9.9,3.33,110.0,0.01,11,0.3,6.11,4,7,3,3,0
0,1,0,0,1,1,1,9.6,2.5,60.0,0.01,8,0.4,3.33,3,5,3,0,0
0,1,0,0,1,1,1,7.75,2.0,31.02,0.01,6,0.5,1.72,2,4,2,0,0
0,1,0,0,1,1,1,6.86,3.5,84.0,0.01,8,0.29,4.67,1,7,1,0,0
0,1,0,0,1,1,1,7.75,2.0,31.02,0.01,6,0.5,1.72,2,4,2,0,0
0,1,0,0,1,1,1,8.3,6.0,298.97,0.02,15,0.17,16.61,3,12,2,0,0
0,1,0,0,1,1,1,8.3,6.0,298.97,0.02,15,0.17,16.61,3,12,2,0,0
0,1,0,0,1,1,1,8.3,6.0,298.97,0.02,15,0.17,16.61,3,12,2,0,0
0,1,0,0,1,1,1,5.8,2.0,23.22,0.0,5,0.5,1.29,1,4,1,0,0
0,1,0,0,1,1,1,7.75,2.0,31.02,0.01,6,0.5,1.72,2,4,2,0,0
0,1,0,0,1,1,1,7.75,2.0,31.02,0.01,6,0.5,1.72,2,4,2,0,0
7,3,0,0,2,2,1,5.23,11.25,661.62,0.02,17,0.09,36.76,5,12,2,7,0
0,1,0,0,1,1,1,7.75,2.0,31.02,0.01,6,0.5,1.72,2,4,2,0,0
0,1,0,0,1,1,1,7.75,2.0,31.02,0.01,6,0.5,1.72,2,4,2,0,0
0,3,0,0,2,1,1,7.75,2.0,31.02,0.01,6,0.5,1.72,2,4,2,0,0
0,1,0,0,1,1,1,5.8,2.0,23.22,0.0,5,0.5,1.29,1,4,1,0,0
0,3,0,0,2,1,1,7.75,2.0,31.02,0.01,6,0.5,1.72,2,4,2,0,0
0,1,0,0,1,1,1,12.18,3.0,109.62,0.01,11,0.33,6.09,4,7,4,0,0
0,1,0,0,1,1,1,7.75,2.0,31.02,0.01,6,0.5,1.72,2,4,2,0,0
0,1,0,0,1,1,1,7.75,2.0,31.02,0.01,6,0.5,1.72,2,4,2,0,0
0,1,0,0,1,1,1,10.0,1.0,10.0,0.0,5,1.0,0.56,2,3,2,0,0
0,1,0,0,1,1,1,7.75,2.0,31.02,0.01,6,0.5,1.72,2,4,2,0,0
0,1,0,0,1,1,1,5.8,2.0,23.22,0.0,5,0.5,1.29,1,4,1,0,0
0,1,0,0,1,1,1,7.75,2.0,31.02,0.01,6,0.5,1.72,2,4,2,0,0
2,1,0,0,1,1,1,8.98,2.5,56.15,0.01,8,0.4,3.12,2,6,2,2,0
2,1,0,0,1,1,1,5.33,1.5,12.0,0.0,4,0.67,0.67,1,3,1,2,0
0,1,0,0,1,1,1,5.33,1.5,12.0,0.0,4,0.67,0.67,1,3,1,0,0
2,1,0,0,1,1,1,5.33,1.5,12.0,0.0,4,0.67,0.67,1,3,1,2,0
2,1,0,0,1,1,1,5.33,1.5,12.0,0.0,4,0.67,0.67,1,3,1,2,0
3,1,0,0,1,1,1,12.0,2.5,75.0,0.01,10,0.4,4.17,3,7,3,3,0
0,1,0,0,1,1,1,7.86,2.5,49.13,0.01,7,0.4,2.73,2,5,2,0,0
0,1,0,0,1,1,1,6.55,3.0,58.95,0.01,7,0.33,3.28,1,6,1,0,0
0,1,0,0,1,1,1,6.55,3.0,58.95,0.01,7,0.33,3.28,1,6,1,0,0
2,1,0,0,1,1,1,8.98,2.5,56.15,0.01,8,0.4,3.12,2,6,2,2,0
2,1,0,0,1,1,1,5.33,1.5,12.0,0.0,4,0.67,0.67,1,3,1,2,0
0,1,0,0,1,1,1,5.33,1.5,12.0,0.0,4,0.67,0.67,1,3,1,0,0
2,1,0,0,1,1,1,5.33,1.5,12.0,0.0,4,0.67,0.67,1,3,1,2,0
2,1,0,0,1,1,1,5.33,1.5,12.0,0.0,4,0.67,0.67,1,3,1,2,0
0,1,0,0,1,1,1,5.33,1.5,12.0,0.0,4,0.67,0.67,1,3,1,0,0
0,1,0,0,1,1,1,5.33,1.5,12.0,0.0,4,0.67,0.67,1,3,1,0,0
0,1,0,0,1,1,1,7.75,2.0,31.02,0.01,6,0.5,1.72,2,4,2,0,0
0,1,0,0,1,1,1,9.0,3.0,81.0,0.01,9,0.33,4.5,2,7,2,0,0
0,1,0,0,1,1,1,8.3,6.0,298.97,0.02,15,0.17,16.61,3,12,2,0,0
0,1,0,0,1,1,1,9.51,3.0,85.59,0.01,9,0.33,4.75,3,6,3,0,0
0,1,0,0,1,1,1,9.51,3.0,85.59,0.01,9,0.33,4.75,3,6,3,0,0
0,1,0,0,1,1,1,9.51,3.0,85.59,0.01,9,0.33,4.75,3,6,3,0,0
0,1,0,0,1,1,1,9.51,3.0,85.59,0.01,9,0.33,4.75,3,6,3,0,0
4,3,0,0,2,2,1,13.67,6.0,492.27,0.03,21,0.17,27.35,6,15,5,4,0
2,1,0,0,1,1,1,10.57,3.0,95.1,0.01,10,0.33,5.28,3,7,3,2,0
2,1,0,0,1,1,1,10.57,3.0,95.1,0.01,10,0.33,5.28,3,7,3,2,0
0,1,0,0,1,1,1,0.0,0.0,0.0,0.0,1,0.0,0.0,1,0,1,0,0
4,1,0,0,1,1,1,10.24,7.0,501.89,0.02,20,0.14,27.88,7,13,4,4,0
4,3,0,0,2,2,1,21.5,7.15,1099.18,0.05,35,0.14,61.07,13,22,10,4,0
8,3,0,0,2,2,1,23.46,10.29,2485.24,0.08,52,0.1,138.07,19,33,12,8,0
54,13,1,8,7,6,6,25.11,40.0,40181.42,0.33,184,0.03,2232.3,80,104,22,55,0
0,1,0,0,1,1,1,8.3,6.67,369.01,0.02,16,0.15,20.5,5,11,3,0,0
23,5,0,1,3,2,1,19.78,20.04,7940.87,0.13,80,0.05,441.16,33,47,14,23,0
0,1,0,0,1,1,1,8.6,7.5,483.97,0.02,18,0.13,26.89,5,13,3,0,0
19,5,0,3,3,3,1,19.07,10.91,2270.01,0.07,46,0.09,126.11,20,26,11,19,0
19,5,0,3,3,3,1,20.96,10.5,2310.82,0.07,48,0.1,128.38,21,27,12,19,0
12,3,0,2,2,2,1,14.73,8.94,1176.94,0.04,31,0.11,65.39,13,18,8,12,0
12,9,0,0,5,3,3,17.46,16.55,4779.2,0.1,63,0.06,265.51,28,35,11,12,0
4,1,0,0,1,1,1,9.47,2.67,67.38,0.01,9,0.38,3.74,4,5,3,4,0
13,5,0,0,3,3,1,16.4,7.07,820.29,0.04,29,0.14,45.57,11,18,7,13,0
13,5,0,0,3,3,1,17.24,7.5,969.51,0.04,31,0.13,53.86,12,19,8,13,0
4,3,0,0,2,2,1,11.99,6.67,533.03,0.03,21,0.15,29.61,10,11,6,4,0
0,1,0,0,1,1,1,6.55,3.0,58.95,0.01,7,0.33,3.28,1,6,1,0,0
0,3,0,0,2,2,1,6.69,7.5,376.42,0.02,14,0.13,20.91,5,9,3,0,0
0,1,0,0,1,1,1,7.86,2.5,49.13,0.01,7,0.4,2.73,2,5,2,0,0
0,3,0,0,2,2,1,9.32,5.0,233.02,0.02,13,0.2,12.95,5,8,4,0,0
0,1,0,0,1,1,1,6.55,3.0,58.95,0.01,7,0.33,3.28,1,6,1,0,0
0,3,0,0,2,2,1,6.69,7.5,376.42,0.02,14,0.13,20.91,5,9,3,0,0
0,1,0,0,1,1,1,7.86,2.5,49.13,0.01,7,0.4,2.73,2,5,2,0,0
0,3,0,0,2,2,1,9.32,5.0,233.02,0.02,13,0.2,12.95,5,8,4,0,0
6,1,0,0,1,1,1,17.51,5.0,437.85,0.03,23,0.2,24.32,10,13,7,6,0
0,3,0,0,2,2,1,7.75,2.0,31.02,0.01,6,0.5,1.72,2,4,2,0,0
0,3,0,0,2,2,1,7.86,2.5,49.13,0.01,7,0.4,2.73,2,5,2,0,0
11,7,0,0,4,2,3,12.35,16.0,3162.47,0.07,45,0.06,175.69,16,29,7,11,0
3,3,0,0,2,2,1,14.28,4.0,228.44,0.02,15,0.25,12.69,6,9,6,3,0
0,1,0,0,1,1,1,7.75,2.0,31.02,0.01,6,0.5,1.72,2,4,2,0,0
0,1,0,0,1,1,1,7.75,2.0,31.02,0.01,6,0.5,1.72,2,4,2,0,0
0,1,0,0,1,1,1,0.0,0.0,0.0,0.0,1,0.0,0.0,0,1,0,0,0
2,1,0,0,1,1,1,13.5,2.0,54.0,0.01,9,0.5,3.0,4,5,4,2,0
0,1,0,0,1,1,1,7.75,2.0,31.02,0.01,6,0.5,1.72,2,4,2,0,0
0,1,0,0,1,1,1,7.75,2.0,31.02,0.01,6,0.5,1.72,2,4,2,0,0
0,1,0,0,1,1,1,9.83,2.0,39.3,0.01,7,0.5,2.18,3,4,3,0,0
0,1,0,0,1,1,1,9.83,2.0,39.3,0.01,7,0.5,2.18,3,4,3,0,0
0,1,0,0,1,1,1,7.75,2.0,31.02,0.01,6,0.5,1.72,2,4,2,0,0
0,1,0,0,1,1,1,7.74,1.5,17.41,0.0,5,0.67,0.97,2,3,2,0,0
1,1,0,0,1,1,1,7.74,1.5,17.41,0.0,5,0.67,0.97,2,3,2,1,0
0,1,0,0,1,1,1,5.8,2.0,23.22,0.0,5,0.5,1.29,1,4,1,0,0
2,1,0,0,1,1,1,7.75,2.0,31.02,0.01,6,0.5,1.72,2,4,2,2,0
1,1,0,1,1,1,1,0.0,0.0,0.0,0.0,1,0.0,0.0,0,1,0,1,0
2,1,0,0,1,1,1,7.75,2.0,31.02,0.01,6,0.5,1.72,2,4,2,2,0
0,1,0,0,1,1,1,9.31,2.5,58.16,0.01,9,0.4,3.23,1,8,1,0,0
0,1,0,0,1,1,1,7.75,2.0,31.02,0.01,6,0.5,1.72,2,4,2,0,0
0,1,0,0,1,1,1,10.68,4.67,232.53,0.02,15,0.21,12.92,4,11,3,0,0
7,5,0,0,3,2,1,11.89,13.13,2048.55,0.05,35,0.08,113.81,15,20,8,7,0
7,5,0,0,3,2,1,11.89,13.13,2048.55,0.05,35,0.08,113.81,15,20,8,7,0
5,3,0,0,2,2,1,17.22,4.08,287.09,0.02,19,0.24,15.95,7,12,6,5,0
4,3,0,0,2,2,1,11.18,5.63,353.85,0.02,17,0.18,19.66,5,12,4,4,0
0,1,0,0,1,1,1,0.0,0.0,0.0,0.0,0,0.0,0.0,0,0,0,0,0
0,1,0,0,1,1,1,0.0,0.0,0.0,0.0,1,0.0,0.0,0,1,0,0,0
0,1,0,0,1,1,1,0.0,0.0,0.0,0.0,0,0.0,0.0,0,0,0,0,0
0,1,0,0,1,1,1,6.2,2.5,38.77,0.01,6,0.4,2.15,1,5,1,0,0
0,1,0,0,1,1,1,0.0,0.0,0.0,0.0,1,0.0,0.0,0,1,0,0,0
0,1,0,0,1,1,1,0.0,0.0,0.0,0.0,0,0.0,0.0,0,0,0,0,0
0,1,0,0,1,1,1,0.0,0.0,0.0,0.0,3,0.0,0.0,0,3,0,0,0
0,1,0,0,1,1,1,0.0,0.0,0.0,0.0,2,0.0,0.0,0,2,0,0,0
0,1,0,0,1,1,1,0.0,0.0,0.0,0.0,1,0.0,0.0,0,1,0,0,0
0,1,0,0,1,1,1,0.0,0.0,0.0,0.0,0,0.0,0.0,0,0,0,0,0
0,1,0,0,1,1,1,5.33,1.5,12.0,0.0,4,0.67,0.67,1,3,1,0,0
0,1,0,0,1,1,1,5.33,1.5,12.0,0.0,4,0.67,0.67,1,3,1,0,0
0,1,0,0,1,1,1,11.86,3.5,145.3,0.01,12,0.29,8.07,4,8,4,0,0
0,1,0,0,1,1,1,0.0,0.0,0.0,0.0,0,0.0,0.0,0,0,0,0,0
0,1,0,0,1,1,1,0.0,0.0,0.0,0.0,0,0.0,0.0,0,0,0,0,0
0,1,0,0,1,1,1,0.0,0.0,0.0,0.0,0,0.0,0.0,0,0,0,0,0
0,1,0,0,1,1,1,0.0,0.0,0.0,0.0,1,0.0,0.0,0,1,0,0,0
0,1,0,0,1,1,1,0.0,0.0,0.0,0.0,1,0.0,0.0,0,1,0,0,0
0,1,0,0,1,1,1,0.0,0.0,0.0,0.0,0,0.0,0.0,0,0,0,0,0
0,1,0,0,1,1,1,7.33,4.5,148.5,0.01,11,0.22,8.25,3,8,2,0,0
8,3,0,0,2,1,1,15.07,9.75,1432.72,0.05,34,0.1,79.6,13,21,8,8,0
8,3,0,0,2,1,1,15.07,9.75,1432.72,0.05,34,0.1,79.6,13,21,8,8,0
23,5,1,0,3,3,1,66.6,8.84,5203.41,0.2,113,0.11,289.08,55,58,28,24,0
23,5,1,0,3,3,1,66.6,8.84,5203.41,0.2,113,0.11,289.08,55,58,28,24,0
0,1,0,0,1,1,1,0.0,0.0,0.0,0.0,1,0.0,0.0,0,1,0,0,0
0,1,0,0,1,1,1,0.0,0.0,0.0,0.0,0,0.0,0.0,0,0,0,0,0
0,1,0,0,1,1,1,0.0,0.0,0.0,0.0,1,0.0,0.0,0,1,0,0,0
0,1,0,0,1,1,1,0.0,0.0,0.0,0.0,0,0.0,0.0,0,0,0,0,0
0,1,0,0,1,1,1,0.0,0.0,0.0,0.0,1,0.0,0.0,0,1,0,0,0
21,11,3,5,6,6,1,52.64,16.5,14331.03,0.29,168,0.06,796.17,75,93,25,24,0
21,11,3,5,6,6,1,52.64,16.5,14331.03,0.29,168,0.06,796.17,75,93,25,24,0
3,1,0,0,1,1,1,9.51,3.0,85.59,0.01,9,0.33,4.75,3,6,3,3,0
3,1,0,0,1,1,1,9.51,3.0,85.59,0.01,9,0.33,4.75,3,6,3,3,0
5,3,0,0,2,2,1,15.36,3.5,188.21,0.02,15,0.29,10.46,5,10,5,5,0
5,3,0,0,2,2,1,15.36,3.5,188.21,0.02,15,0.29,10.46,5,10,5,5,0
4,3,0,0,2,2,1,10.88,5.6,341.29,0.02,17,0.18,18.96,8,9,5,4,0
4,3,0,0,2,2,1,10.88,5.6,341.29,0.02,17,0.18,18.96,8,9,5,4,0
0,1,0,0,1,1,1,7.74,1.5,17.41,0.0,5,0.67,0.97,2,3,2,0,0
0,1,0,0,1,1,1,7.74,1.5,17.41,0.0,5,0.67,0.97,2,3,2,0,0
2,1,0,0,1,1,1,7.35,8.0,470.48,0.02,17,0.13,26.14,6,11,3,2,0
0,1,0,0,1,1,1,12.68,2.5,79.25,0.01,10,0.4,4.4,4,6,4,0,0
0,1,0,0,1,1,1,12.68,2.5,79.25,0.01,10,0.4,4.4,4,6,4,0,0
0,1,0,0,1,1,1,7.74,1.5,17.41,0.0,5,0.67,0.97,2,3,2,0,0
0,1,0,0,1,1,1,7.74,1.5,17.41,0.0,5,0.67,0.97,2,3,2,0,0
0,1,0,0,1,1,1,7.75,2.0,31.02,0.01,6,0.5,1.72,2,4,2,0,0
0,1,0,0,1,1,1,7.75,2.0,31.02,0.01,6,0.5,1.72,2,4,2,0,0
0,1,0,0,1,1,1,7.75,2.0,31.02,0.01,6,0.5,1.72,2,4,2,0,0
0,1,0,0,1,1,1,7.75,2.0,31.02,0.01,6,0.5,1.72,2,4,2,0,0
0,1,0,0,1,1,1,7.75,2.0,31.02,0.01,6,0.5,1.72,2,4,2,0,0
0,1,0,0,1,1,1,7.75,2.0,31.02,0.01,6,0.5,1.72,2,4,2,0,0
0,1,0,0,1,1,1,7.75,2.0,31.02,0.01,6,0.5,1.72,2,4,2,0,0
0,1,0,0,1,1,1,7.75,2.0,31.02,0.01,6,0.5,1.72,2,4,2,0,0
2,1,0,0,1,1,1,7.81,9.0,632.78,0.02,19,0.11,35.15,8,11,4,2,0
7,3,0,0,2,2,1,15.65,7.31,836.91,0.04,28,0.14,46.49,13,15,8,7,0
0,1,0,0,1,1,1,7.74,1.5,17.41,0.0,5,0.67,0.97,2,3,2,0,0
0,1,0,0,1,1,1,9.6,2.5,60.0,0.01,8,0.4,3.33,3,5,3,0,0
0,1,0,0,1,1,1,7.75,2.0,31.02,0.01,6,0.5,1.72,2,4,2,0,0
0,1,0,0,1,1,1,7.75,2.0,31.02,0.01,6,0.5,1.72,2,4,2,0,0
0,1,0,0,1,1,1,6.86,3.5,84.0,0.01,8,0.29,4.67,1,7,1,0,0
0,1,0,0,1,1,1,7.74,1.5,17.41,0.0,5,0.67,0.97,2,3,2,0,0
0,1,0,0,1,1,1,7.75,2.0,31.02,0.01,6,0.5,1.72,2,4,2,0,0
0,1,0,0,1,1,1,7.75,2.0,31.02,0.01,6,0.5,1.72,2,4,2,0,0
9,1,0,0,1,1,1,16.05,10.31,1708.46,0.06,39,0.1,94.91,15,24,8,9,0
9,1,0,0,1,1,1,16.05,10.31,1708.46,0.06,39,0.1,94.91,15,24,8,9,0
0,1,0,0,1,1,1,8.3,6.0,298.97,0.02,15,0.17,16.61,3,12,2,0,0
0,1,0,0,1,1,1,8.3,6.0,298.97,0.02,15,0.17,16.61,3,12,2,0,0
0,1,0,0,1,1,1,8.3,6.0,298.97,0.02,15,0.17,16.61,3,12,2,0,0
0,1,0,0,1,1,1,5.33,1.5,12.0,0.0,4,0.67,0.67,1,3,1,0,0
0,1,0,0,1,1,1,5.33,1.5,12.0,0.0,4,0.67,0.67,1,3,1,0,0
0,1,0,0,1,1,1,5.33,1.5,12.0,0.0,4,0.67,0.67,1,3,1,0,0
0,1,0,0,1,1,1,5.33,1.5,12.0,0.0,4,0.67,0.67,1,3,1,0,0
0,1,0,0,1,1,1,5.33,1.5,12.0,0.0,4,0.67,0.67,1,3,1,0,0
0,1,0,0,1,1,1,5.33,1.5,12.0,0.0,4,0.67,0.67,1,3,1,0,0
0,1,0,0,1,1,1,5.33,1.5,12.0,0.0,4,0.67,0.67,1,3,1,0,0
0,1,0,0,1,1,1,5.33,1.5,12.0,0.0,4,0.67,0.67,1,3,1,0,0
0,1,0,0,1,1,1,5.33,1.5,12.0,0.0,4,0.67,0.67,1,3,1,0,0
0,1,0,0,1,1,1,5.33,1.5,12.0,0.0,4,0.67,0.67,1,3,1,0,0
0,1,0,0,1,1,1,5.33,1.5,12.0,0.0,4,0.67,0.67,1,3,1,0,0
0,1,0,0,1,1,1,5.33,1.5,12.0,0.0,4,0.67,0.67,1,3,1,0,0
0,1,0,0,1,1,1,5.33,1.5,12.0,0.0,4,0.67,0.67,1,3,1,0,0
0,1,0,0,1,1,1,5.33,1.5,12.0,0.0,4,0.67,0.67,1,3,1,0,0
3,1,0,0,1,1,1,15.5,3.0,139.52,0.02,14,0.33,7.75,6,8,5,3,0
3,1,0,0,1,1,1,15.5,3.0,139.52,0.02,14,0.33,7.75,6,8,5,3,0
24,9,3,1,5,4,1,51.6,10.12,5284.28,0.17,101,0.1,293.57,46,55,25,27,0
24,9,3,1,5,4,1,51.6,10.12,5284.28,0.17,101,0.1,293.57,46,55,25,27,0
24,9,3,1,5,4,1,59.86,9.63,5545.05,0.19,109,0.1,308.06,49,60,28,27,0
24,9,3,1,5,4,1,59.86,9.63,5545.05,0.19,109,0.1,308.06,49,60,28,27,0
13,5,1,1,3,3,1,27.53,7.5,1548.29,0.07,47,0.13,86.02,20,27,12,14,0
13,5,1,1,3,3,1,27.53,7.5,1548.29,0.07,47,0.13,86.02,20,27,12,14,0
21,13,6,1,7,6,4,49.06,12.0,7064.02,0.2,113,0.08,392.45,50,63,25,27,0
21,13,6,1,7,6,4,49.06,12.0,7064.02,0.2,113,0.08,392.45,50,63,25,27,0
3,1,0,0,1,1,1,15.5,3.0,139.52,0.02,14,0.33,7.75,6,8,5,3,0
3,1,0,0,1,1,1,15.5,3.0,139.52,0.02,14,0.33,7.75,6,8,5,3,0
0,1,0,0,1,1,1,7.75,2.0,31.02,0.01,6,0.5,1.72,2,4,2,0,0
0,1,0,0,1,1,1,7.75,2.0,31.02,0.01,6,0.5,1.72,2,4,2,0,0
0,1,0,0,1,1,1,7.75,2.0,31.02,0.01,6,0.5,1.72,2,4,2,0,0
0,1,0,0,1,1,1,7.75,2.0,31.02,0.01,6,0.5,1.72,2,4,2,0,0
0,1,0,0,1,1,1,7.75,2.0,31.02,0.01,6,0.5,1.72,2,4,2,0,0
0,1,0,0,1,1,1,7.75,2.0,31.02,0.01,6,0.5,1.72,2,4,2,0,0
0,1,0,0,1,1,1,7.75,2.0,31.02,0.01,6,0.5,1.72,2,4,2,0,0
0,1,0,0,1,1,1,7.75,2.0,31.02,0.01,6,0.5,1.72,2,4,2,0,0
0,1,0,0,1,1,1,7.74,1.5,17.41,0.0,5,0.67,0.97,2,3,2,0,0
0,1,0,0,1,1,1,5.33,1.5,12.0,0.0,4,0.67,0.67,1,3,1,0,0
0,3,0,0,2,1,1,7.75,2.0,31.02,0.01,6,0.5,1.72,2,4,2,0,0
0,3,0,0,2,1,1,7.75,2.0,31.02,0.01,6,0.5,1.72,2,4,2,0,0
0,1,0,0,1,1,1,5.8,2.0,23.22,0.0,5,0.5,1.29,1,4,1,0,0
0,1,0,0,1,1,1,5.8,2.0,23.22,0.0,5,0.5,1.29,1,4,1,0,0
0,3,0,0,2,1,1,7.75,2.0,31.02,0.01,6,0.5,1.72,2,4,2,0,0
0,3,0,0,2,1,1,7.75,2.0,31.02,0.01,6,0.5,1.72,2,4,2,0,0
10,5,0,0,3,2,1,28.99,6.92,1389.28,0.07,45,0.14,77.18,20,25,13,10,0
10,5,0,0,3,2,1,28.99,6.92,1389.28,0.07,45,0.14,77.18,20,25,13,10,0
0,1,0,0,1,1,1,12.18,3.0,109.62,0.01,11,0.33,6.09,4,7,4,0,0
0,1,0,0,1,1,1,7.75,2.0,31.02,0.01,6,0.5,1.72,2,4,2,0,0
0,1,0,0,1,1,1,7.75,2.0,31.02,0.01,6,0.5,1.72,2,4,2,0,0
0,1,0,0,1,1,1,7.75,2.0,31.02,0.01,6,0.5,1.72,2,4,2,0,0
0,1,0,0,1,1,1,7.75,2.0,31.02,0.01,6,0.5,1.72,2,4,2,0,0
0,1,0,0,1,1,1,7.75,2.0,31.02,0.01,6,0.5,1.72,2,4,2,0,0
0,1,0,0,1,1,1,7.75,2.0,31.02,0.01,6,0.5,1.72,2,4,2,0,0
0,1,0,0,1,1,1,5.8,2.0,23.22,0.0,5,0.5,1.29,1,4,1,0,0
0,1,0,0,1,1,1,5.8,2.0,23.22,0.0,5,0.5,1.29,1,4,1,0,0
0,1,0,0,1,1,1,7.75,2.0,31.02,0.01,6,0.5,1.72,2,4,2,0,0
0,1,0,0,1,1,1,7.75,2.0,31.02,0.01,6,0.5,1.72,2,4,2,0,0
18,7,1,10,4,4,1,51.33,9.55,4677.27,0.16,98,0.1,259.85,42,56,22,19,0
18,7,1,10,4,4,1,51.33,9.55,4677.27,0.16,98,0.1,259.85,42,56,22,19,0
15,5,1,0,3,3,1,30.54,8.67,2294.06,0.09,57,0.12,127.45,26,31,15,16,0
15,5,1,0,3,3,1,30.54,8.67,2294.06,0.09,57,0.12,127.45,26,31,15,16,0
15,5,1,0,3,3,1,30.54,8.67,2294.06,0.09,57,0.12,127.45,26,31,15,16,0
15,5,1,0,3,3,1,30.54,8.67,2294.06,0.09,57,0.12,127.45,26,31,15,16,0
14,5,1,0,3,2,1,29.73,6.79,1368.94,0.07,44,0.15,76.05,19,25,14,15,0
14,5,1,0,3,2,1,29.73,6.79,1368.94,0.07,44,0.15,76.05,19,25,14,15,0
2,1,0,0,1,1,1,8.98,2.5,56.15,0.01,8,0.4,3.12,2,6,2,2,0
2,1,0,0,1,1,1,8.98,2.5,56.15,0.01,8,0.4,3.12,2,6,2,2,0
2,1,0,0,1,1,1,5.33,1.5,12.0,0.0,4,0.67,0.67,1,3,1,2,0
0,1,0,0,1,1,1,5.33,1.5,12.0,0.0,4,0.67,0.67,1,3,1,0,0
2,1,0,0,1,1,1,5.33,1.5,12.0,0.0,4,0.67,0.67,1,3,1,2,0
2,1,0,0,1,1,1,5.33,1.5,12.0,0.0,4,0.67,0.67,1,3,1,2,0
2,1,0,0,1,1,1,5.33,1.5,12.0,0.0,4,0.67,0.67,1,3,1,2,0
3,1,0,0,1,1,1,12.0,2.5,75.0,0.01,10,0.4,4.17,3,7,3,3,0
0,1,0,0,1,1,1,7.86,2.5,49.13,0.01,7,0.4,2.73,2,5,2,0,0
0,1,0,0,1,1,1,6.55,3.0,58.95,0.01,7,0.33,3.28,1,6,1,0,0
0,1,0,0,1,1,1,6.55,3.0,58.95,0.01,7,0.33,3.28,1,6,1,0,0
2,1,0,0,1,1,1,8.98,2.5,56.15,0.01,8,0.4,3.12,2,6,2,2,0
2,1,0,0,1,1,1,8.98,2.5,56.15,0.01,8,0.4,3.12,2,6,2,2,0
2,1,0,0,1,1,1,5.33,1.5,12.0,0.0,4,0.67,0.67,1,3,1,2,0
0,1,0,0,1,1,1,5.33,1.5,12.0,0.0,4,0.67,0.67,1,3,1,0,0
2,1,0,0,1,1,1,5.33,1.5,12.0,0.0,4,0.67,0.67,1,3,1,2,0
2,1,0,0,1,1,1,5.33,1.5,12.0,0.0,4,0.67,0.67,1,3,1,2,0
2,1,0,0,1,1,1,5.33,1.5,12.0,0.0,4,0.67,0.67,1,3,1,2,0
0,1,0,0,1,1,1,5.33,1.5,12.0,0.0,4,0.67,0.67,1,3,1,0,0
0,1,0,0,1,1,1,5.33,1.5,12.0,0.0,4,0.67,0.67,1,3,1,0,0
0,1,0,0,1,1,1,7.86,2.5,49.13,0.01,7,0.4,2.73,2,5,2,0,0
0,1,0,0,1,1,1,0.0,0.0,0.0,0.0,3,0.0,0.0,0,3,0,0,0
0,1,0,0,1,1,1,7.75,2.0,31.02,0.01,6,0.5,1.72,2,4,2,0,0
0,1,0,0,1,1,1,7.75,2.0,31.02,0.01,6,0.5,1.72,2,4,2,0,0
3,1,0,0,1,1,1,11.23,2.0,44.92,0.01,8,0.5,2.5,3,5,3,3,0
3,1,0,0,1,1,1,11.23,2.0,44.92,0.01,8,0.5,2.5,3,5,3,3,0
0,1,0,0,1,1,1,9.29,1.5,20.9,0.0,6,0.67,1.16,2,4,2,0,0
0,1,0,0,1,1,1,9.29,1.5,20.9,0.0,6,0.67,1.16,2,4,2,0,0
20,11,0,5,6,5,6,42.08,11.3,5376.72,0.16,92,0.09,298.71,40,52,23,20,0
20,11,0,5,6,5,6,42.08,11.3,5376.72,0.16,92,0.09,298.71,40,52,23,20,0
27,7,0,4,1,1,1,34.35,13.68,6431.58,0.16,94,0.07,357.31,40,54,19,27,0
27,7,0,4,1,1,1,34.35,13.68,6431.58,0.16,94,0.07,357.31,40,54,19,27,0
20,11,0,1,1,1,1,21.1,18.56,7271.57,0.13,77,0.05,403.98,33,44,16,20,0
30,7,0,4,1,1,1,39.58,14.77,8638.18,0.19,114,0.07,479.9,50,64,22,30,0
30,7,0,4,1,1,1,39.58,14.77,8638.18,0.19,114,0.07,479.9,50,64,22,30,0
27,7,0,4,1,1,1,34.35,13.68,6431.58,0.16,94,0.07,357.31,40,54,19,27,0
27,7,0,4,1,1,1,34.35,13.68,6431.58,0.16,94,0.07,357.31,40,54,19,27,0
0,1,0,0,1,1,1,9.29,1.5,20.9,0.0,6,0.67,1.16,2,4,2,0,0
0,1,0,0,1,1,1,11.23,2.0,44.92,0.01,8,0.5,2.5,3,5,3,0,0
0,1,0,0,1,1,1,9.29,1.5,20.9,0.0,6,0.67,1.16,2,4,2,0,0
0,1,0,0,1,1,1,11.23,2.0,44.92,0.01,8,0.5,2.5,3,5,3,0,0
0,1,0,0,1,1,1,9.0,3.0,81.0,0.01,9,0.33,4.5,2,7,2,0,0
0,1,0,0,1,1,1,9.0,3.0,81.0,0.01,9,0.33,4.5,2,7,2,0,0
0,1,0,0,1,1,1,8.3,6.0,298.97,0.02,15,0.17,16.61,3,12,2,0,0
9,1,0,0,1,1,1,31.26,4.75,705.19,0.05,38,0.21,39.18,19,19,10,9,0
9,1,0,0,1,1,1,31.26,4.75,705.19,0.05,38,0.21,39.18,19,19,10,9,0
9,1,0,0,1,1,1,34.4,5.0,860.0,0.06,43,0.2,47.78,22,21,11,9,0
9,1,0,0,1,1,1,34.4,5.0,860.0,0.06,43,0.2,47.78,22,21,11,9,0
0,1,0,0,1,1,1,7.74,1.5,17.41,0.0,5,0.67,0.97,2,3,2,0,0
0,1,0,0,1,1,1,7.74,1.5,17.41,0.0,5,0.67,0.97,2,3,2,0,0
0,1,0,0,1,1,1,7.74,1.5,17.41,0.0,5,0.67,0.97,2,3,2,0,0
0,1,0,0,1,1,1,7.74,1.5,17.41,0.0,5,0.67,0.97,2,3,2,0,0
0,1,0,0,1,1,1,7.74,1.5,17.41,0.0,5,0.67,0.97,2,3,2,0,0
0,1,0,0,1,1,1,7.74,1.5,17.41,0.0,5,0.67,0.97,2,3,2,0,0
10,3,0,0,2,2,1,25.32,5.6,793.95,0.05,34,0.18,44.11,14,20,10,10,0
10,3,0,0,2,2,1,25.32,5.6,793.95,0.05,34,0.18,44.11,14,20,10,10,0
12,5,0,1,3,3,1,18.15,7.71,1080.0,0.05,35,0.13,60.0,12,23,7,12,0
12,5,1,8,3,3,1,23.67,9.09,1956.58,0.07,49,0.11,108.7,20,29,11,13,0
12,5,1,8,3,3,1,23.67,9.09,1956.58,0.07,49,0.11,108.7,20,29,11,13,0
28,17,0,7,9,6,9,40.77,18.67,14204.39,0.25,145,0.05,789.13,64,81,24,28,0
28,17,0,7,9,6,9,40.77,18.67,14204.39,0.25,145,0.05,789.13,64,81,24,28,0
0,1,0,0,1,1,1,9.51,3.0,85.59,0.01,9,0.33,4.75,3,6,3,0,0
0,1,0,0,1,1,1,9.51,3.0,85.59,0.01,9,0.33,4.75,3,6,3,0,0
0,1,0,0,1,1,1,9.51,3.0,85.59,0.01,9,0.33,4.75,3,6,3,0,0
0,1,0,0,1,1,1,9.51,3.0,85.59,0.01,9,0.33,4.75,3,6,3,0,0
4,3,0,0,2,2,1,13.67,6.0,492.27,0.03,21,0.17,27.35,6,15,5,4,0
37,21,4,16,11,10,11,68.57,22.03,33269.8,0.5,269,0.05,1848.32,122,147,36,41,0
37,21,4,16,11,10,11,68.57,22.03,33269.8,0.5,269,0.05,1848.32,122,147,36,41,0
26,7,1,4,4,4,1,72.57,10.48,7975.84,0.25,142,0.1,443.1,65,77,31,27,0
26,7,1,4,4,4,1,72.57,10.48,7975.84,0.25,142,0.1,443.1,65,77,31,27,0
38,21,5,16,11,10,11,62.0,25.21,39410.78,0.52,283,0.04,2189.49,128,155,33,43,0
38,21,5,16,11,10,11,62.0,25.21,39410.78,0.52,283,0.04,2189.49,128,155,33,43,0
36,21,10,16,11,10,11,63.83,25.24,40649.79,0.54,290,0.04,2258.32,132,158,34,46,0
36,21,10,16,11,10,11,63.83,25.24,40649.79,0.54,290,0.04,2258.32,132,158,34,46,0
38,21,11,16,11,10,11,68.12,26.54,47985.65,0.6,322,0.04,2665.87,147,175,36,49,0
38,21,11,16,11,10,11,68.12,26.54,47985.65,0.6,322,0.04,2665.87,147,175,36,49,0
15,7,0,2,4,4,1,29.17,9.62,2696.74,0.09,62,0.1,149.82,25,37,13,15,0
15,7,0,2,4,4,1,29.17,9.62,2696.74,0.09,62,0.1,149.82,25,37,13,15,0
40,23,4,16,12,11,11,57.78,27.64,44151.48,0.53,283,0.04,2452.86,129,154,35,44,0
40,23,4,16,12,11,11,57.78,27.64,44151.48,0.53,283,0.04,2452.86,129,154,35,44,0
78,41,13,26,21,19,19,84.23,48.37,197048.57,1.36,679,0.02,10947.14,316,363,49,91,0
78,41,13,26,21,19,19,84.23,48.37,197048.57,1.36,679,0.02,10947.14,316,363,49,91,0
78,41,13,26,21,19,19,86.27,47.4,193827.5,1.36,679,0.02,10768.19,316,363,50,91,0
78,41,13,26,21,19,19,86.27,47.4,193827.5,1.36,679,0.02,10768.19,316,363,50,91,0
21,11,3,5,6,6,1,52.79,15.18,12164.32,0.27,155,0.07,675.8,69,86,25,24,0
21,11,3,5,6,6,1,52.79,15.18,12164.32,0.27,155,0.07,675.8,69,86,25,24,0
36,21,4,16,11,10,11,57.78,23.9,33016.0,0.46,253,0.04,1834.22,114,139,31,40,0
36,21,4,16,11,10,11,57.78,23.9,33016.0,0.46,253,0.04,1834.22,114,139,31,40,0
36,21,6,17,11,10,11,57.5,25.16,36402.08,0.48,265,0.04,2022.34,120,145,31,42,0
36,21,6,17,11,10,11,57.5,25.16,36402.08,0.48,265,0.04,2022.34,120,145,31,42,0
66,41,8,26,21,19,19,68.71,44.09,133582.51,1.01,515,0.02,7421.25,237,278,43,74,0
66,41,8,26,21,19,19,68.71,44.09,133582.51,1.01,515,0.02,7421.25,237,278,43,74,0
36,21,5,16,11,10,11,57.64,24.53,34688.44,0.47,259,0.04,1927.14,117,142,31,41,0
36,21,5,16,11,10,11,57.64,24.53,34688.44,0.47,259,0.04,1927.14,117,142,31,41,0
36,21,4,16,11,10,11,64.48,21.79,30627.51,0.47,253,0.05,1701.53,114,139,34,40,0
36,21,4,16,11,10,11,64.48,21.79,30627.51,0.47,253,0.05,1701.53,114,139,34,40,0
14,7,1,0,4,4,4,37.41,8.39,2636.29,0.1,64,0.12,146.46,29,35,19,15,0
14,7,1,0,4,4,4,37.41,8.39,2636.29,0.1,64,0.12,146.46,29,35,19,15,0
15,9,1,0,5,5,5,36.36,10.21,3793.43,0.12,73,0.1,210.75,33,40,21,16,0
15,9,1,0,5,5,5,36.36,10.21,3793.43,0.12,73,0.1,210.75,33,40,21,16,0
27,13,0,7,7,4,6,54.92,12.35,8376.79,0.23,125,0.08,465.38,57,68,30,27,0
27,13,0,7,7,4,6,54.92,12.35,8376.79,0.23,125,0.08,465.38,57,68,30,27,0
27,15,0,7,8,5,6,50.39,14.03,9921.03,0.24,128,0.07,551.17,58,70,31,27,0
27,15,0,7,8,5,6,50.39,14.03,9921.03,0.24,128,0.07,551.17,58,70,31,27,0
17,11,0,2,6,4,1,29.4,11.54,3914.62,0.11,75,0.09,217.48,30,45,13,17,0
17,11,0,2,6,4,1,29.4,11.54,3914.62,0.11,75,0.09,217.48,30,45,13,17,0
25,13,0,7,7,4,6,55.29,11.48,7290.46,0.21,117,0.09,405.03,53,64,30,25,0
25,13,0,7,7,4,6,55.29,11.48,7290.46,0.21,117,0.09,405.03,53,64,30,25,0
2,1,0,0,1,1,1,9.51,3.0,85.59,0.01,9,0.33,4.75,3,6,3,2,0
2,1,0,0,1,1,1,9.51,3.0,85.59,0.01,9,0.33,4.75,3,6,3,2,0
10,5,0,0,3,2,1,26.35,7.5,1482.41,0.07,45,0.13,82.36,20,25,12,10,0
10,5,0,0,3,2,1,26.35,7.5,1482.41,0.07,45,0.13,82.36,20,25,12,10,0
12,5,0,2,3,3,1,21.89,8.0,1401.09,0.06,42,0.13,77.84,16,26,9,12,0
12,5,0,2,3,3,1,21.89,8.0,1401.09,0.06,42,0.13,77.84,16,26,9,12,0
24,13,0,7,7,4,6,49.18,11.8,6842.92,0.19,109,0.08,380.16,49,60,27,24,0
24,13,0,7,7,4,6,49.18,11.8,6842.92,0.19,109,0.08,380.16,49,60,27,24,0
26,15,0,7,8,5,6,45.02,14.46,9418.45,0.22,120,0.07,523.25,54,66,28,26,0
26,15,0,7,8,5,6,45.02,14.46,9418.45,0.22,120,0.07,523.25,54,66,28,26,0
24,13,0,7,7,4,6,49.18,11.8,6842.92,0.19,109,0.08,380.16,49,60,27,24,0
24,13,0,7,7,4,6,49.18,11.8,6842.92,0.19,109,0.08,380.16,49,60,27,24,0
8,5,1,1,3,3,1,26.24,9.38,2305.97,0.08,56,0.11,128.11,25,31,12,9,0
8,5,1,1,3,3,1,26.24,9.38,2305.97,0.08,56,0.11,128.11,25,31,12,9,0
23,11,0,6,6,4,6,39.72,13.8,7564.59,0.18,103,0.07,420.25,46,57,25,23,0
23,11,0,6,6,4,6,39.72,13.8,7564.59,0.18,103,0.07,420.25,46,57,25,23,0
23,11,0,6,6,4,6,39.72,13.8,7564.59,0.18,103,0.07,420.25,46,57,25,23,0
23,11,0,6,6,4,6,39.72,13.8,7564.59,0.18,103,0.07,420.25,46,57,25,23,0
23,11,0,6,6,4,6,39.72,13.8,7564.59,0.18,103,0.07,420.25,46,57,25,23,0
23,11,0,6,6,4,6,39.72,13.8,7564.59,0.18,103,0.07,420.25,46,57,25,23,0
7,5,1,1,3,2,1,19.46,7.5,1094.61,0.05,35,0.13,60.81,15,20,9,8,0
7,5,1,1,3,2,1,19.46,7.5,1094.61,0.05,35,0.13,60.81,15,20,9,8,0
8,5,0,1,3,2,1,19.08,6.5,806.0,0.04,31,0.15,44.78,13,18,8,8,0
8,5,0,1,3,2,1,19.08,6.5,806.0,0.04,31,0.15,44.78,13,18,8,8,0
0,1,0,0,1,1,1,7.74,1.5,17.41,0.0,5,0.67,0.97,2,3,2,0,0
0,1,0,0,1,1,1,5.33,1.5,12.0,0.0,4,0.67,0.67,1,3,1,0,0
4,1,0,0,1,1,1,10.24,7.0,501.89,0.02,20,0.14,27.88,7,13,4,4,0
4,3,0,0,2,2,1,21.5,7.15,1099.18,0.05,35,0.14,61.07,13,22,10,4,0
8,3,0,0,2,2,1,23.46,10.29,2485.24,0.08,52,0.1,138.07,19,33,12,8,0
54,13,1,8,7,6,6,25.11,40.0,40181.42,0.33,184,0.03,2232.3,80,104,22,55,0
0,1,0,0,1,1,1,8.3,6.67,369.01,0.02,16,0.15,20.5,5,11,3,0,0
23,5,0,1,3,2,1,19.78,20.04,7940.87,0.13,80,0.05,441.16,33,47,14,23,0
0,1,0,0,1,1,1,8.6,7.5,483.97,0.02,18,0.13,26.89,5,13,3,0,0
19,5,0,3,3,3,1,19.07,10.91,2270.01,0.07,46,0.09,126.11,20,26,11,19,0
12,3,0,2,2,2,1,14.73,8.94,1176.94,0.04,31,0.11,65.39,13,18,8,12,0
12,9,0,0,5,3,3,17.46,16.55,4779.2,0.1,63,0.06,265.51,28,35,11,12,0
4,1,0,0,1,1,1,9.47,2.67,67.38,0.01,9,0.38,3.74,4,5,3,4,0
13,5,0,0,3,3,1,16.4,7.07,820.29,0.04,29,0.14,45.57,11,18,7,13,0
13,5,0,0,3,3,1,17.24,7.5,969.51,0.04,31,0.13,53.86,12,19,8,13,0
4,3,0,0,2,2,1,11.99,6.67,533.03,0.03,21,0.15,29.61,10,11,6,4,0
0,1,0,0,1,1,1,6.55,3.0,58.95,0.01,7,0.33,3.28,1,6,1,0,0
0,3,0,0,2,2,1,6.69,7.5,376.42,0.02,14,0.13,20.91,5,9,3,0,0
0,1,0,0,1,1,1,7.86,2.5,49.13,0.01,7,0.4,2.73,2,5,2,0,0
0,3,0,0,2,2,1,9.32,5.0,233.02,0.02,13,0.2,12.95,5,8,4,0,0
6,1,0,0,1,1,1,17.51,5.0,437.85,0.03,23,0.2,24.32,10,13,7,6,0
0,3,0,0,2,2,1,7.75,2.0,31.02,0.01,6,0.5,1.72,2,4,2,0,0
0,3,0,0,2,2,1,7.86,2.5,49.13,0.01,7,0.4,2.73,2,5,2,0,0
11,7,0,0,4,2,3,12.35,16.0,3162.47,0.07,45,0.06,175.69,16,29,7,11,0
3,3,0,0,2,2,1,14.28,4.0,228.44,0.02,15,0.25,12.69,6,9,6,3,0
0,1,0,0,1,1,1,0.0,0.0,0.0,0.0,1,0.0,0.0,0,1,0,0,0
2,1,0,0,1,1,1,13.5,2.0,54.0,0.01,9,0.5,3.0,4,5,4,2,0
0,1,0,0,1,1,1,7.75,2.0,31.02,0.01,6,0.5,1.72,2,4,2,0,0
0,1,0,0,1,1,1,7.75,2.0,31.02,0.01,6,0.5,1.72,2,4,2,0,0
0,1,0,0,1,1,1,7.75,2.0,31.02,0.01,6,0.5,1.72,2,4,2,0,0
0,1,0,0,1,1,1,7.74,1.5,17.41,0.0,5,0.67,0.97,2,3,2,0,0
1,1,0,0,1,1,1,7.74,1.5,17.41,0.0,5,0.67,0.97,2,3,2,1,0
0,1,0,0,1,1,1,5.8,2.0,23.22,0.0,5,0.5,1.29,1,4,1,0,0
2,1,0,0,1,1,1,7.75,2.0,31.02,0.01,6,0.5,1.72,2,4,2,2,0
1,1,0,1,1,1,1,0.0,0.0,0.0,0.0,1,0.0,0.0,0,1,0,1,0
2,1,0,0,1,1,1,7.75,2.0,31.02,0.01,6,0.5,1.72,2,4,2,2,0
0,1,0,0,1,1,1,9.31,2.5,58.16,0.01,9,0.4,3.23,1,8,1,0,0
1,1,0,1,1,1,1,0.0,0.0,0.0,0.0,1,0.0,0.0,0,1,0,1,0
0,1,0,0,1,1,1,7.75,2.0,31.02,0.01,6,0.5,1.72,2,4,2,0,0
0,1,0,0,1,1,1,10.68,4.67,232.53,0.02,15,0.21,12.92,4,11,3,0,0
7,5,0,0,3,2,1,11.89,13.13,2048.55,0.05,35,0.08,113.81,15,20,8,7,0
5,3,0,0,2,2,1,17.22,4.08,287.09,0.02,19,0.24,15.95,7,12,6,5,0
4,3,0,0,2,2,1,11.18,5.63,353.85,0.02,17,0.18,19.66,5,12,4,4,0
0,1,0,0,1,1,1,0.0,0.0,0.0,0.0,0,0.0,0.0,0,0,0,0,0
0,1,0,0,1,1,1,6.2,2.5,38.77,0.01,6,0.4,2.15,1,5,1,0,0
0,1,0,0,1,1,1,11.86,3.5,145.3,0.01,12,0.29,8.07,4,8,4,0,0
0,1,0,0,1,1,1,0.0,0.0,0.0,0.0,0,0.0,0.0,0,0,0,0,0
0,1,0,0,1,1,1,0.0,0.0,0.0,0.0,0,0.0,0.0,0,0,0,0,0
0,1,0,0,1,1,1,0.0,0.0,0.0,0.0,0,0.0,0.0,0,0,0,0,0
0,1,0,0,1,1,1,7.33,4.5,148.5,0.01,11,0.22,8.25,3,8,2,0,0
8,3,0,0,2,1,1,15.07,9.75,1432.72,0.05,34,0.1,79.6,13,21,8,8,0
4,1,0,2,1,1,1,23.44,3.33,260.45,0.03,20,0.3,14.47,10,10,9,4,0
3,1,0,0,1,1,1,9.51,3.0,85.59,0.01,9,0.33,4.75,3,6,3,3,0
5,3,0,0,2,2,1,15.36,3.5,188.21,0.02,15,0.29,10.46,5,10,5,5,0
4,3,0,0,2,2,1,10.88,5.6,341.29,0.02,17,0.18,18.96,8,9,5,4,0
0,1,0,0,1,1,1,7.74,1.5,17.41,0.0,5,0.67,0.97,2,3,2,0,0
0,1,0,0,1,1,1,12.68,2.5,79.25,0.01,10,0.4,4.4,4,6,4,0,0
0,1,0,0,1,1,1,7.74,1.5,17.41,0.0,5,0.67,0.97,2,3,2,0,0
0,1,0,0,1,1,1,7.75,2.0,31.02,0.01,6,0.5,1.72,2,4,2,0,0
0,1,0,0,1,1,1,7.75,2.0,31.02,0.01,6,0.5,1.72,2,4,2,0,0
0,1,0,0,1,1,1,7.75,2.0,31.02,0.01,6,0.5,1.72,2,4,2,0,0
0,1,0,0,1,1,1,7.75,2.0,31.02,0.01,6,0.5,1.72,2,4,2,0,0
0,1,0,0,1,1,1,9.6,2.5,60.0,0.01,8,0.4,3.33,3,5,3,0,0
0,1,0,0,1,1,1,7.75,2.0,31.02,0.01,6,0.5,1.72,2,4,2,0,0
0,1,0,0,1,1,1,6.86,3.5,84.0,0.01,8,0.29,4.67,1,7,1,0,0
0,1,0,0,1,1,1,7.75,2.0,31.02,0.01,6,0.5,1.72,2,4,2,0,0
0,1,0,0,1,1,1,8.3,6.0,298.97,0.02,15,0.17,16.61,3,12,2,0,0
0,1,0,0,1,1,1,8.3,6.0,298.97,0.02,15,0.17,16.61,3,12,2,0,0
0,1,0,0,1,1,1,8.3,6.0,298.97,0.02,15,0.17,16.61,3,12,2,0,0
0,1,0,0,1,1,1,7.75,2.0,31.02,0.01,6,0.5,1.72,2,4,2,0,0
0,1,0,0,1,1,1,7.75,2.0,31.02,0.01,6,0.5,1.72,2,4,2,0,0
0,1,0,0,1,1,1,7.75,2.0,31.02,0.01,6,0.5,1.72,2,4,2,0,0
0,1,0,0,1,1,1,7.75,2.0,31.02,0.01,6,0.5,1.72,2,4,2,0,0
0,3,0,0,2,1,1,7.75,2.0,31.02,0.01,6,0.5,1.72,2,4,2,0,0
0,1,0,0,1,1,1,5.8,2.0,23.22,0.0,5,0.5,1.29,1,4,1,0,0
0,3,0,0,2,1,1,7.75,2.0,31.02,0.01,6,0.5,1.72,2,4,2,0,0
0,1,0,0,1,1,1,12.18,3.0,109.62,0.01,11,0.33,6.09,4,7,4,0,0
0,1,0,0,1,1,1,7.75,2.0,31.02,0.01,6,0.5,1.72,2,4,2,0,0
0,1,0,0,1,1,1,7.75,2.0,31.02,0.01,6,0.5,1.72,2,4,2,0,0
0,1,0,0,1,1,1,7.75,2.0,31.02,0.01,6,0.5,1.72,2,4,2,0,0
0,1,0,0,1,1,1,5.8,2.0,23.22,0.0,5,0.5,1.29,1,4,1,0,0
0,1,0,0,1,1,1,7.75,2.0,31.02,0.01,6,0.5,1.72,2,4,2,0,0
2,1,0,0,1,1,1,8.98,2.5,56.15,0.01,8,0.4,3.12,2,6,2,2,0
2,1,0,0,1,1,1,5.33,1.5,12.0,0.0,4,0.67,0.67,1,3,1,2,0
0,1,0,0,1,1,1,5.33,1.5,12.0,0.0,4,0.67,0.67,1,3,1,0,0
2,1,0,0,1,1,1,5.33,1.5,12.0,0.0,4,0.67,0.67,1,3,1,2,0
2,1,0,0,1,1,1,5.33,1.5,12.0,0.0,4,0.67,0.67,1,3,1,2,0
3,1,0,0,1,1,1,12.0,2.5,75.0,0.01,10,0.4,4.17,3,7,3,3,0
0,1,0,0,1,1,1,7.86,2.5,49.13,0.01,7,0.4,2.73,2,5,2,0,0
0,1,0,0,1,1,1,6.55,3.0,58.95,0.01,7,0.33,3.28,1,6,1,0,0
0,1,0,0,1,1,1,6.55,3.0,58.95,0.01,7,0.33,3.28,1,6,1,0,0
2,1,0,0,1,1,1,8.98,2.5,56.15,0.01,8,0.4,3.12,2,6,2,2,0
2,1,0,0,1,1,1,5.33,1.5,12.0,0.0,4,0.67,0.67,1,3,1,2,0
0,1,0,0,1,1,1,5.33,1.5,12.0,0.0,4,0.67,0.67,1,3,1,0,0
2,1,0,0,1,1,1,5.33,1.5,12.0,0.0,4,0.67,0.67,1,3,1,2,0
2,1,0,0,1,1,1,5.33,1.5,12.0,0.0,4,0.67,0.67,1,3,1,2,0
0,1,0,0,1,1,1,5.33,1.5,12.0,0.0,4,0.67,0.67,1,3,1,0,0
0,1,0,0,1,1,1,5.33,1.5,12.0,0.0,4,0.67,0.67,1,3,1,0,0
0,1,0,0,1,1,1,7.75,2.0,31.02,0.01,6,0.5,1.72,2,4,2,0,0
0,1,0,0,1,1,1,9.0,3.0,81.0,0.01,9,0.33,4.5,2,7,2,0,0
0,1,0,0,1,1,1,8.3,6.0,298.97,0.02,15,0.17,16.61,3,12,2,0,0
0,1,0,0,1,1,1,9.51,3.0,85.59,0.01,9,0.33,4.75,3,6,3,0,0
0,1,0,0,1,1,1,9.51,3.0,85.59,0.01,9,0.33,4.75,3,6,3,0,0
0,1,0,0,1,1,1,9.51,3.0,85.59,0.01,9,0.33,4.75,3,6,3,0,0
0,1,0,0,1,1,1,9.51,3.0,85.59,0.01,9,0.33,4.75,3,6,3,0,0
4,3,0,0,2,2,1,13.67,6.0,492.27,0.03,21,0.17,27.35,6,15,5,4,0
2,1,0,1,1,1,1,6.2,2.5,38.77,0.01,6,0.4,2.15,1,5,1,2,0
11,5,0,2,3,3,1,26.82,5.32,758.5,0.05,33,0.19,42.14,13,20,11,11,0
20,7,0,0,4,2,1,14.41,14.0,2824.34,0.07,44,0.07,156.91,20,24,10,20,0
7,3,0,0,2,2,1,12.44,4.9,298.63,0.02,17,0.2,16.59,7,10,5,7,0
30,7,0,2,4,4,1,44.58,6.98,2168.6,0.1,64,0.14,120.48,31,33,20,30,0
4,1,0,0,1,1,1,13.5,2.0,54.0,0.01,9,0.5,3.0,4,5,4,4,0
11,3,0,0,2,2,1,36.01,9.96,3573.4,0.12,83,0.1,198.52,37,46,13,11,0
91,31,0,8,1,1,1,52.83,48.86,126098.15,0.86,427,0.02,7005.45,171,256,42,91,0
79,37,0,3,19,18,10,41.31,48.56,97401.54,0.67,341,0.02,5411.2,152,189,36,79,0
78,33,0,1,17,15,7,48.49,34.68,58312.98,0.56,295,0.03,3239.61,131,164,34,78,0
22,11,0,2,6,4,1,18.66,13.54,3420.02,0.08,52,0.07,190.0,22,30,13,22,0
26,5,0,7,3,3,1,35.6,9.0,2883.83,0.11,69,0.11,160.21,32,37,16,26,0
39,21,0,1,11,5,1,30.17,28.56,24609.46,0.29,156,0.04,1367.19,68,88,25,39,0
30,13,0,1,7,5,7,22.2,19.56,8493.88,0.14,84,0.05,471.88,35,49,17,30,0
12,1,0,2,1,1,1,30.82,6.29,1217.72,0.06,56,0.16,67.65,22,34,7,12,0
12,1,0,2,1,1,1,30.82,6.29,1217.72,0.06,56,0.16,67.65,22,34,7,12,0
12,1,0,3,1,1,1,17.29,18.0,5601.22,0.1,72,0.06,311.18,24,48,8,12,0
12,1,0,3,1,1,1,17.29,18.0,5601.22,0.1,72,0.06,311.18,24,48,8,12,0
6,3,7,4,2,2,1,40.82,10.25,4288.91,0.14,88,0.1,238.27,41,47,18,13,0
6,3,7,4,2,2,1,40.82,10.25,4288.91,0.14,88,0.1,238.27,41,47,18,13,0
1,1,7,0,1,1,1,48.37,5.36,1388.16,0.09,61,0.19,77.12,30,31,14,8,0
1,1,7,0,1,1,1,48.37,5.36,1388.16,0.09,61,0.19,77.12,30,31,14,8,0
8,3,7,2,2,2,1,26.22,13.6,4849.99,0.12,75,0.07,269.44,34,41,15,15,0
8,3,7,2,2,2,1,26.22,13.6,4849.99,0.12,75,0.07,269.44,34,41,15,15,0
52,13,3,11,7,3,3,48.19,31.87,48957.02,0.51,259,0.03,2719.83,113,146,39,55,0
52,13,3,11,7,3,3,48.19,31.87,48957.02,0.51,259,0.03,2719.83,113,146,39,55,0
10,5,0,6,3,3,1,27.97,8.25,1903.71,0.08,48,0.12,105.76,22,26,16,10,0
10,5,0,6,3,3,1,27.97,8.25,1903.71,0.08,48,0.12,105.76,22,26,16,10,0
36,11,1,23,6,6,1,35.32,41.43,60620.78,0.49,262,0.02,3367.82,116,146,28,37,0
36,11,1,23,6,6,1,35.32,41.43,60620.78,0.49,262,0.02,3367.82,116,146,28,37,0
14,5,1,7,3,3,1,36.11,11.56,4827.88,0.14,79,0.09,268.22,37,42,24,15,0
14,5,1,7,3,3,1,36.11,11.56,4827.88,0.14,79,0.09,268.22,37,42,24,15,0
37,11,1,18,6,6,1,38.12,38.25,55776.93,0.49,264,0.03,3098.72,119,145,28,38,0
37,11,1,18,6,6,1,38.12,38.25,55776.93,0.49,264,0.03,3098.72,119,145,28,38,0
19,5,0,3,3,3,1,18.24,22.91,9574.79,0.14,90,0.04,531.93,36,54,11,19,0
19,5,0,3,3,3,1,18.24,22.91,9574.79,0.14,90,0.04,531.93,36,54,11,19,0
20,5,0,7,3,2,1,21.95,22.1,10718.5,0.16,97,0.05,595.47,39,58,15,20,0
20,5,0,7,3,2,1,22.87,20.8,9892.54,0.16,96,0.05,549.59,39,57,15,20,0
19,5,0,3,3,3,1,18.73,24.38,11126.44,0.15,96,0.04,618.14,39,57,12,19,0
19,5,0,3,3,3,1,18.73,24.38,11126.44,0.15,96,0.04,618.14,39,57,12,19,0
20,5,0,7,3,2,1,22.69,21.71,10688.22,0.16,96,0.05,593.79,41,55,17,20,0
20,5,0,7,3,2,1,22.92,21.71,10799.55,0.17,97,0.05,599.98,41,56,17,20,0
10,1,0,6,1,1,1,48.65,3.6,630.5,0.06,46,0.28,35.03,18,28,10,10,0
10,1,0,6,1,1,1,48.65,3.6,630.5,0.06,46,0.28,35.03,18,28,10,10,0
9,1,0,0,1,1,1,42.67,3.56,539.44,0.05,41,0.28,29.97,16,25,9,9,0
9,1,0,0,1,1,1,42.67,3.56,539.44,0.05,41,0.28,29.97,16,25,9,9,0
9,1,0,0,1,1,1,42.67,3.56,539.44,0.05,41,0.28,29.97,16,25,9,9,0
9,1,0,0,1,1,1,42.67,3.56,539.44,0.05,41,0.28,29.97,16,25,9,9,0
88,25,6,6,13,9,3,40.25,78.0,244910.47,1.05,536,0.01,13606.14,221,315,34,94,0
88,25,6,6,13,9,3,40.25,78.0,244910.47,1.05,536,0.01,13606.14,221,315,34,94,0
9,3,0,1,2,2,1,12.73,6.75,580.17,0.03,22,0.15,32.22,9,13,6,9,0
9,3,0,1,2,2,1,12.73,6.75,580.17,0.03,22,0.15,32.22,9,13,6,9,0
12,1,4,9,1,1,1,41.56,18.41,14082.95,0.26,153,0.05,782.39,81,72,22,16,0
12,1,4,9,1,1,1,41.56,18.41,14082.95,0.26,153,0.05,782.39,81,72,22,16,0
8,3,0,6,2,2,1,25.48,6.92,1221.36,0.06,39,0.14,67.85,18,21,13,8,0
8,3,0,6,2,2,1,25.48,6.92,1221.36,0.06,39,0.14,67.85,18,21,13,8,0
41,7,0,23,4,4,1,28.38,51.4,74995.63,0.49,278,0.02,4166.42,127,151,21,41,0
41,7,0,23,4,4,1,28.38,51.4,74995.63,0.49,278,0.02,4166.42,127,151,21,41,0
14,3,1,7,2,2,1,39.38,9.82,3796.17,0.13,76,0.1,210.9,36,40,22,15,0
14,3,1,7,2,2,1,39.38,9.82,3796.17,0.13,76,0.1,210.9,36,40,22,15,0
44,7,0,21,4,4,1,33.53,50.43,85301.8,0.56,320,0.02,4738.99,145,175,23,44,0
44,7,0,21,4,4,1,33.53,50.43,85301.8,0.56,320,0.02,4738.99,145,175,23,44,0
19,5,0,3,3,3,1,19.18,21.27,8680.58,0.14,89,0.05,482.25,36,53,11,19,0
19,5,0,3,3,3,1,19.18,21.27,8680.58,0.14,89,0.05,482.25,36,53,11,19,0
20,5,0,3,3,2,1,26.1,25.94,17563.87,0.23,132,0.04,975.77,49,83,17,20,0
20,5,0,3,3,2,1,25.9,25.94,17430.81,0.22,131,0.04,968.38,49,82,17,20,0
19,5,0,3,3,3,1,19.63,22.75,10158.83,0.15,95,0.04,564.38,39,56,12,19,0
19,5,0,3,3,3,1,19.63,22.75,10158.83,0.15,95,0.04,564.38,39,56,12,19,0
21,5,0,3,3,2,1,26.36,25.5,17138.3,0.22,130,0.04,952.13,51,79,18,21,0
21,5,0,3,3,2,1,26.56,25.5,17270.13,0.23,131,0.04,959.45,51,80,18,21,0
21,3,0,4,2,1,1,34.39,17.33,10332.61,0.2,124,0.06,574.03,40,84,15,21,0
21,3,0,4,2,1,1,34.39,17.33,10332.61,0.2,124,0.06,574.03,40,84,15,21,0
11,7,0,21,4,3,4,16.32,10.11,1668.32,0.05,37,0.1,92.68,14,23,9,11,0
11,7,0,21,4,3,4,16.32,10.11,1668.32,0.05,37,0.1,92.68,14,23,9,11,0
6,3,7,4,2,2,1,40.82,10.25,4288.91,0.14,88,0.1,238.27,41,47,18,13,0
6,3,7,4,2,2,1,40.82,10.25,4288.91,0.14,88,0.1,238.27,41,47,18,13,0
1,1,7,0,1,1,1,48.37,5.36,1388.16,0.09,61,0.19,77.12,30,31,14,8,0
1,1,7,0,1,1,1,48.37,5.36,1388.16,0.09,61,0.19,77.12,30,31,14,8,0
8,3,7,2,2,2,1,26.22,13.6,4849.99,0.12,75,0.07,269.44,34,41,15,15,0
8,3,7,2,2,2,1,26.22,13.6,4849.99,0.12,75,0.07,269.44,34,41,15,15,0
52,13,3,11,7,3,3,48.19,31.87,48957.02,0.51,259,0.03,2719.83,113,146,39,55,0
52,13,3,11,7,3,3,48.19,31.87,48957.02,0.51,259,0.03,2719.83,113,146,39,55,0
10,5,0,6,3,3,1,27.97,8.25,1903.71,0.08,48,0.12,105.76,22,26,16,10,0
10,5,0,6,3,3,1,27.97,8.25,1903.71,0.08,48,0.12,105.76,22,26,16,10,0
36,11,1,23,6,6,1,35.32,41.43,60620.78,0.49,262,0.02,3367.82,116,146,28,37,0
36,11,1,23,6,6,1,35.32,41.43,60620.78,0.49,262,0.02,3367.82,116,146,28,37,0
14,5,1,7,3,3,1,36.11,11.56,4827.88,0.14,79,0.09,268.22,37,42,24,15,0
14,5,1,7,3,3,1,36.11,11.56,4827.88,0.14,79,0.09,268.22,37,42,24,15,0
37,11,1,18,6,6,1,38.12,38.25,55776.93,0.49,264,0.03,3098.72,119,145,28,38,0
37,11,1,18,6,6,1,38.12,38.25,55776.93,0.49,264,0.03,3098.72,119,145,28,38,0
19,5,0,3,3,3,1,18.24,22.91,9574.79,0.14,90,0.04,531.93,36,54,11,19,0
19,5,0,3,3,3,1,18.24,22.91,9574.79,0.14,90,0.04,531.93,36,54,11,19,0
19,5,0,3,3,2,1,18.99,31.5,18845.31,0.2,114,0.03,1046.96,51,63,17,19,0
19,5,0,3,3,2,1,18.99,31.5,18845.31,0.2,114,0.03,1046.96,51,63,17,19,0
19,5,0,3,3,3,1,18.73,24.38,11126.44,0.15,96,0.04,618.14,39,57,12,19,0
19,5,0,3,3,3,1,18.73,24.38,11126.44,0.15,96,0.04,618.14,39,57,12,19,0
23,5,0,4,3,3,1,22.98,28.81,19072.03,0.22,122,0.03,1059.56,55,67,21,23,0
23,5,0,4,3,3,1,22.98,28.81,19072.03,0.22,122,0.03,1059.56,55,67,21,23,0
17,1,0,2,1,1,1,60.75,5.33,1728.0,0.11,81,0.19,96.0,32,49,12,17,0
17,1,0,2,1,1,1,60.75,5.33,1728.0,0.11,81,0.19,96.0,32,49,12,17,0
9,1,0,0,1,1,1,42.67,3.56,539.44,0.05,41,0.28,29.97,16,25,9,9,0
9,1,0,0,1,1,1,42.67,3.56,539.44,0.05,41,0.28,29.97,16,25,9,9,0
9,1,0,0,1,1,1,42.67,3.56,539.44,0.05,41,0.28,29.97,16,25,9,9,0
9,1,0,0,1,1,1,42.67,3.56,539.44,0.05,41,0.28,29.97,16,25,9,9,0
10,5,0,2,3,2,1,14.31,15.11,3267.33,0.07,46,0.07,181.52,16,30,9,10,0
10,5,0,2,3,2,1,14.31,15.11,3267.33,0.07,46,0.07,181.52,16,30,9,10,0
88,25,6,6,13,9,3,40.25,78.0,244910.47,1.05,536,0.01,13606.14,221,315,34,94,0
88,25,6,6,13,9,3,40.25,78.0,244910.47,1.05,536,0.01,13606.14,221,315,34,94,0
9,3,0,1,2,2,1,12.73,6.75,580.17,0.03,22,0.15,32.22,9,13,6,9,0
9,3,0,1,2,2,1,12.73,6.75,580.17,0.03,22,0.15,32.22,9,13,6,9,0
12,1,4,12,1,1,1,41.56,18.41,14082.95,0.26,153,0.05,782.39,81,72,22,16,0
12,1,4,12,1,1,1,41.56,18.41,14082.95,0.26,153,0.05,782.39,81,72,22,16,0
8,3,0,6,2,2,1,25.48,6.92,1221.36,0.06,39,0.14,67.85,18,21,13,8,0
8,3,0,6,2,2,1,25.48,6.92,1221.36,0.06,39,0.14,67.85,18,21,13,8,0
41,7,0,23,4,4,1,28.38,51.4,74995.63,0.49,278,0.02,4166.42,127,151,21,41,0
41,7,0,23,4,4,1,28.38,51.4,74995.63,0.49,278,0.02,4166.42,127,151,21,41,0
14,3,1,7,2,2,1,39.38,9.82,3796.17,0.13,76,0.1,210.9,36,40,22,15,0
14,3,1,7,2,2,1,39.38,9.82,3796.17,0.13,76,0.1,210.9,36,40,22,15,0
44,7,0,21,4,4,1,33.53,50.43,85301.8,0.56,320,0.02,4738.99,145,175,23,44,0
44,7,0,21,4,4,1,33.53,50.43,85301.8,0.56,320,0.02,4738.99,145,175,23,44,0
19,5,0,3,3,3,1,19.18,21.27,8680.58,0.14,89,0.05,482.25,36,53,11,19,0
19,5,0,3,3,3,1,19.18,21.27,8680.58,0.14,89,0.05,482.25,36,53,11,19,0
19,5,0,3,3,2,1,20.49,30.0,18441.46,0.2,118,0.03,1024.53,51,67,17,19,0
19,5,0,3,3,2,1,20.49,30.0,18441.46,0.2,118,0.03,1024.53,51,67,17,19,0
19,5,0,3,3,3,1,19.63,22.75,10158.83,0.15,95,0.04,564.38,39,56,12,19,0
19,5,0,3,3,3,1,19.63,22.75,10158.83,0.15,95,0.04,564.38,39,56,12,19,0
23,5,0,3,3,3,1,24.9,27.5,18832.67,0.23,127,0.04,1046.26,55,72,21,23,0
23,5,0,3,3,3,1,24.9,27.5,18832.67,0.23,127,0.04,1046.26,55,72,21,23,0
19,1,0,4,1,1,1,35.77,15.32,8395.76,0.18,118,0.07,466.43,39,79,14,19,0
19,1,0,4,1,1,1,35.77,15.32,8395.76,0.18,118,0.07,466.43,39,79,14,19,0
11,7,0,21,4,3,4,16.32,10.11,1668.32,0.05,37,0.1,92.68,14,23,9,11,0
11,7,0,21,4,3,4,16.32,10.11,1668.32,0.05,37,0.1,92.68,14,23,9,11,0
10,5,0,3,3,2,1,14.31,15.11,3267.33,0.07,46,0.07,181.52,16,30,9,10,0
10,5,0,3,3,2,1,14.31,15.11,3267.33,0.07,46,0.07,181.52,16,30,9,10,0
9,1,0,7,1,1,1,41.68,6.43,1722.6,0.09,62,0.16,95.7,30,32,14,9,0
9,1,0,7,1,1,1,41.68,6.43,1722.6,0.09,62,0.16,95.7,30,32,14,9,0
11,1,0,5,1,1,1,26.68,20.0,10672.33,0.18,111,0.05,592.91,40,71,14,11,0
11,1,0,5,1,1,1,26.68,20.0,10672.33,0.18,111,0.05,592.91,40,71,14,11,0
8,3,0,19,2,1,1,17.09,5.71,558.13,0.03,25,0.18,31.01,10,15,7,8,0
8,3,0,19,2,1,1,17.09,5.71,558.13,0.03,25,0.18,31.01,10,15,7,8,0
53,7,0,117,4,4,1,19.63,120.11,283140.67,0.79,440,0.01,15730.04,188,252,18,53,0
53,7,0,117,4,4,1,19.63,120.11,283140.67,0.79,440,0.01,15730.04,188,252,18,53,0
14,3,0,4,2,2,1,22.45,12.07,3271.7,0.09,57,0.08,181.76,26,31,14,14,0
14,3,0,4,2,2,1,22.45,12.07,3271.7,0.09,57,0.08,181.76,26,31,14,14,0
62,7,0,114,4,4,1,22.37,122.73,336912.17,0.92,497,0.01,18717.34,225,272,22,62,0
62,7,0,114,4,4,1,22.37,122.73,336912.17,0.92,497,0.01,18717.34,225,272,22,62,0
49,21,0,87,11,8,1,21.75,67.36,98690.19,0.49,270,0.01,5482.79,97,173,18,49,0
49,21,0,87,11,8,1,21.75,67.36,98690.19,0.49,270,0.01,5482.79,97,173,18,49,0
58,21,0,12,11,8,1,24.66,80.39,159325.18,0.66,353,0.01,8851.4,131,222,22,58,0
58,21,0,12,11,8,1,24.66,80.39,159325.18,0.66,353,0.01,8851.4,131,222,22,58,0
59,21,0,36,11,10,1,28.52,66.04,124369.51,0.63,332,0.02,6909.42,127,205,25,59,0
59,21,0,36,11,10,1,28.52,66.04,124369.51,0.63,332,0.02,6909.42,127,205,25,59,0
63,21,0,80,11,10,1,28.39,77.78,171770.62,0.74,382,0.01,9542.81,150,232,27,63,0
63,21,0,80,11,10,1,28.39,77.78,171770.62,0.74,382,0.01,9542.81,150,232,27,63,0
15,5,0,1,3,1,1,15.86,13.3,2805.08,0.07,46,0.08,155.84,19,27,10,15,0
15,5,0,1,3,1,1,15.86,13.3,2805.08,0.07,46,0.08,155.84,19,27,10,15,0
24,3,0,5,2,1,1,54.76,9.05,4482.37,0.17,100,0.11,249.02,38,62,21,24,0
24,3,0,5,2,1,1,54.76,9.05,4482.37,0.17,100,0.11,249.02,38,62,21,24,0
11,1,0,0,1,1,1,54.79,3.64,724.55,0.07,51,0.28,40.25,20,31,11,11,0
11,1,0,0,1,1,1,54.79,3.64,724.55,0.07,51,0.28,40.25,20,31,11,11,0
19,3,0,1,2,1,1,40.29,8.75,3084.66,0.12,75,0.11,171.37,28,47,16,19,0
19,3,0,1,2,1,1,40.29,8.75,3084.66,0.12,75,0.11,171.37,28,47,16,19,0
12,3,0,0,2,2,1,12.63,11.0,1528.71,0.05,34,0.09,84.93,12,22,6,12,0
12,3,0,0,2,2,1,12.63,11.0,1528.71,0.05,34,0.09,84.93,12,22,6,12,0
8,3,0,0,2,2,1,16.97,7.07,848.57,0.04,30,0.14,47.14,11,19,7,8,0
8,3,0,0,2,2,1,16.97,7.07,848.57,0.04,30,0.14,47.14,11,19,7,8,0
12,3,0,0,2,2,1,14.7,10.21,1533.34,0.05,36,0.1,85.19,13,23,7,12,0
12,3,0,0,2,2,1,14.7,10.21,1533.34,0.05,36,0.1,85.19,13,23,7,12,0
21,9,0,1,5,3,1,19.21,19.0,6935.0,0.12,73,0.05,385.28,26,47,13,21,0
21,9,0,1,5,3,1,19.21,19.0,6935.0,0.12,73,0.05,385.28,26,47,13,21,0
42,11,0,27,6,4,1,49.26,38.25,72074.4,0.63,319,0.03,4004.13,153,166,40,42,0
42,11,0,27,6,4,1,49.26,38.25,72074.4,0.63,319,0.03,4004.13,153,166,40,42,0
8,3,0,0,2,2,1,14.59,7.5,820.45,0.04,28,0.13,45.58,10,18,6,8,0
8,3,0,0,2,2,1,14.59,7.5,820.45,0.04,28,0.13,45.58,10,18,6,8,0
10,5,0,2,3,2,1,14.31,15.11,3267.33,0.07,46,0.07,181.52,16,30,9,10,0
10,5,0,2,3,2,1,14.31,15.11,3267.33,0.07,46,0.07,181.52,16,30,9,10,0
11,1,0,6,1,1,1,21.12,21.27,9558.4,0.15,98,0.05,531.02,36,62,11,11,0
11,1,0,6,1,1,1,21.12,21.27,9558.4,0.15,98,0.05,531.02,36,62,11,11,0
9,3,0,20,2,2,1,13.2,6.67,586.67,0.03,22,0.15,32.59,8,14,6,9,0
9,3,0,20,2,2,1,13.2,6.67,586.67,0.03,22,0.15,32.59,8,14,6,9,0
2,1,0,1,1,1,1,12.55,4.0,200.76,0.02,14,0.25,11.15,4,10,4,2,0
2,1,0,1,1,1,1,12.55,4.0,200.76,0.02,14,0.25,11.15,4,10,4,2,0
24,1,0,90,1,1,1,55.09,23.9,31458.99,0.44,237,0.04,1747.72,125,112,34,24,0
24,1,0,90,1,1,1,55.09,23.9,31458.99,0.44,237,0.04,1747.72,125,112,34,24,0
8,3,0,3,2,1,1,16.18,6.43,668.57,0.03,26,0.16,37.14,10,16,7,8,0
8,3,0,3,2,1,1,16.18,6.43,668.57,0.03,26,0.16,37.14,10,16,7,8,0
35,7,0,76,4,4,1,19.16,70.7,95764.59,0.45,262,0.01,5320.25,101,161,15,35,0
35,7,0,76,4,4,1,19.16,70.7,95764.59,0.45,262,0.01,5320.25,101,161,15,35,0
15,3,0,4,2,2,1,23.88,12.66,3824.79,0.1,61,0.08,212.49,27,34,16,15,0
15,3,0,4,2,2,1,23.88,12.66,3824.79,0.1,61,0.08,212.49,27,34,16,15,0
44,7,0,77,4,4,1,21.39,79.89,136544.83,0.57,319,0.01,7585.82,138,181,19,44,0
44,7,0,77,4,4,1,21.39,79.89,136544.83,0.57,319,0.01,7585.82,138,181,19,44,0
49,21,0,93,11,8,1,21.75,67.36,98690.19,0.49,270,0.01,5482.79,97,173,18,49,0
49,21,0,93,11,8,1,21.75,67.36,98690.19,0.49,270,0.01,5482.79,97,173,18,49,0
58,21,0,12,11,8,1,25.76,77.41,154340.69,0.66,357,0.01,8574.48,131,226,22,58,0
58,21,0,12,11,8,1,25.76,77.41,154340.69,0.66,357,0.01,8574.48,131,226,22,58,0
61,21,0,15,11,10,1,28.94,67.5,131842.41,0.65,341,0.01,7324.58,130,211,26,61,0
61,21,0,15,11,10,1,28.94,67.5,131842.41,0.65,341,0.01,7324.58,130,211,26,61,0
63,21,0,14,11,10,1,29.62,75.0,166603.99,0.74,386,0.01,9255.78,150,236,27,63,0
63,21,0,14,11,10,1,29.62,75.0,166603.99,0.74,386,0.01,9255.78,150,236,27,63,0
14,1,0,8,1,1,1,27.22,16.0,6969.14,0.15,95,0.06,387.17,32,63,12,14,0
14,1,0,8,1,1,1,27.22,16.0,6969.14,0.15,95,0.06,387.17,32,63,12,14,0
16,5,0,19,3,3,1,19.62,17.73,6166.12,0.12,74,0.06,342.56,26,48,11,16,0
16,5,0,19,3,3,1,19.62,17.73,6166.12,0.12,74,0.06,342.56,26,48,11,16,0
10,5,0,3,3,2,1,14.31,15.11,3267.33,0.07,46,0.07,181.52,16,30,9,10,0
10,5,0,3,3,2,1,14.31,15.11,3267.33,0.07,46,0.07,181.52,16,30,9,10,0
6,1,1,0,1,1,1,20.08,5.5,607.27,0.04,29,0.18,33.74,11,18,7,7,0
6,1,1,0,1,1,1,20.08,5.5,607.27,0.04,29,0.18,33.74,11,18,7,7,0
4,3,9,1,2,1,1,26.92,12.44,4168.89,0.11,67,0.08,231.6,32,35,18,13,0
4,3,9,1,2,1,1,26.92,12.44,4168.89,0.11,67,0.08,231.6,32,35,18,13,0
1,1,2,0,1,1,1,15.0,2.0,60.0,0.01,10,0.5,3.33,4,6,4,3,0
1,1,2,0,1,1,1,15.0,2.0,60.0,0.01,10,0.5,3.33,4,6,4,3,0
14,5,8,0,3,3,1,20.4,18.13,6709.33,0.12,74,0.06,372.74,32,42,15,22,0
14,5,8,0,3,3,1,20.4,18.13,6709.33,0.12,74,0.06,372.74,32,42,15,22,0
20,11,0,6,6,5,1,25.3,15.47,6054.18,0.13,79,0.06,336.34,33,46,16,20,0
13,9,1,1,5,4,1,12.48,21.12,5567.26,0.09,60,0.05,309.29,26,34,8,14,0
2,1,0,0,1,1,1,6.55,3.0,58.95,0.01,7,0.33,3.28,1,6,1,2,0
2,1,0,0,1,1,1,6.55,3.0,58.95,0.01,7,0.33,3.28,1,6,1,2,0
62,31,2,1,16,8,16,36.13,35.2,44768.42,0.42,221,0.03,2487.13,88,133,30,64,0
62,31,2,1,16,8,16,36.13,35.2,44768.42,0.42,221,0.03,2487.13,88,133,30,64,0
10,3,4,1,2,1,1,20.67,13.42,3720.79,0.09,59,0.07,206.71,23,36,12,14,0
10,3,4,1,2,1,1,22.65,12.38,3474.36,0.09,59,0.08,193.02,23,36,13,14,0
27,8,10,3,6,4,1,22.46,39.38,34814.92,0.29,161,0.03,1934.16,63,98,20,37,0
27,8,10,3,6,4,1,24.9,36.36,32923.55,0.3,163,0.03,1829.09,64,99,22,37,0
8,3,8,1,2,1,1,25.45,12.6,4039.9,0.11,66,0.08,224.44,27,39,15,16,0
8,3,8,1,2,1,1,25.45,12.6,4039.9,0.11,66,0.08,224.44,27,39,15,16,0
9,3,7,1,2,1,1,25.45,12.6,4039.9,0.11,66,0.08,224.44,27,39,15,16,0
31,11,10,3,6,3,1,40.07,25.5,26056.16,0.34,192,0.04,1447.56,69,123,23,41,0
31,11,10,3,6,3,1,42.09,24.44,25137.63,0.34,192,0.04,1396.54,69,123,24,41,0
9,3,7,1,2,1,1,25.45,12.6,4039.9,0.11,66,0.08,224.44,27,39,15,16,0
31,19,18,1,10,5,1,36.47,26.65,25908.95,0.32,175,0.04,1439.39,66,109,26,49,0
31,19,18,1,10,5,1,36.47,26.65,25908.95,0.32,175,0.04,1439.39,66,109,26,49,0
36,12,13,9,8,6,3,39.4,37.78,56237.13,0.5,268,0.03,3124.28,102,166,27,49,0
36,12,13,9,8,6,3,52.46,30.56,48975.36,0.53,276,0.03,2720.85,110,166,36,49,0
386,351,6,105,192,186,7,44.82,833.78,31159817.68,12.46,5227,0.0,1731100.99,2279,2948,82,392,0
386,351,6,105,192,186,7,44.82,833.78,31159817.68,12.46,5227,0.0,1731100.99,2279,2948,82,392,0
16,3,0,0,2,2,1,30.45,4.62,648.71,0.05,32,0.22,36.04,15,17,13,16,0
31,5,0,2,3,3,1,46.98,12.6,7458.76,0.2,112,0.08,414.38,45,67,25,31,0
4,1,0,4,1,1,1,11.35,6.0,408.69,0.02,19,0.17,22.7,6,13,4,4,0
4,1,0,4,1,1,1,11.35,6.0,408.69,0.02,19,0.17,22.7,6,13,4,4,0
3,1,0,0,1,1,1,10.8,2.5,67.5,0.01,9,0.4,3.75,3,6,3,3,0
3,1,0,0,1,1,1,10.8,2.5,67.5,0.01,9,0.4,3.75,3,6,3,3,0
29,7,3,69,4,4,1,51.63,17.0,14919.63,0.29,158,0.06,828.87,60,98,30,32,0
29,7,3,69,4,4,1,45.44,19.68,17598.33,0.3,161,0.05,977.68,58,103,28,32,0
77,22,0,2,19,19,1,55.81,36.78,75505.99,0.68,317,0.03,4194.78,119,198,55,77,0
85,26,0,1,21,20,1,58.9,39.38,91316.89,0.77,353,0.03,5073.16,135,218,60,85,0
5,3,0,0,2,1,1,12.12,6.6,528.0,0.03,20,0.15,29.33,6,14,5,5,0
5,3,0,0,2,1,1,12.37,6.0,445.39,0.02,19,0.17,24.74,6,13,5,5,0
10,3,0,0,2,2,1,11.26,10.0,1125.88,0.04,27,0.1,62.55,10,17,6,10,0
10,3,0,0,2,2,1,11.59,9.17,974.18,0.04,26,0.11,54.12,10,16,6,10,0
10,3,0,0,2,2,1,11.59,9.17,974.18,0.04,26,0.11,54.12,10,16,6,10,0
10,3,0,0,2,2,1,11.26,10.0,1125.88,0.04,27,0.1,62.55,10,17,6,10,0
5,3,0,0,2,1,1,12.37,6.0,445.39,0.02,19,0.17,24.74,6,13,5,5,0
5,3,0,0,2,1,1,12.37,6.0,445.39,0.02,19,0.17,24.74,6,13,5,5,0
10,3,0,0,2,2,1,11.59,9.17,974.18,0.04,26,0.11,54.12,10,16,6,10,0
10,3,0,0,2,2,1,11.59,9.17,974.18,0.04,26,0.11,54.12,10,16,6,10,0
4,1,0,0,1,1,1,10.24,7.0,501.89,0.02,20,0.14,27.88,7,13,4,4,0
4,3,0,0,2,2,1,21.5,7.15,1099.18,0.05,35,0.14,61.07,13,22,10,4,0
8,3,0,0,2,2,1,23.46,10.29,2485.24,0.08,52,0.1,138.07,19,33,12,8,0
54,13,1,8,7,6,6,25.11,40.0,40181.42,0.33,184,0.03,2232.3,80,104,22,55,0
0,1,0,0,1,1,1,8.3,6.67,369.01,0.02,16,0.15,20.5,5,11,3,0,0
23,5,0,1,3,2,1,19.78,20.04,7940.87,0.13,80,0.05,441.16,33,47,14,23,0
0,1,0,0,1,1,1,8.6,7.5,483.97,0.02,18,0.13,26.89,5,13,3,0,0
19,5,0,3,3,3,1,19.07,10.91,2270.01,0.07,46,0.09,126.11,20,26,11,19,0
12,3,0,2,2,2,1,14.73,8.94,1176.94,0.04,31,0.11,65.39,13,18,8,12,0
12,9,0,0,5,3,3,17.46,16.55,4779.2,0.1,63,0.06,265.51,28,35,11,12,0
4,1,0,0,1,1,1,9.47,2.67,67.38,0.01,9,0.38,3.74,4,5,3,4,0
13,5,0,0,3,3,1,16.4,7.07,820.29,0.04,29,0.14,45.57,11,18,7,13,0
13,5,0,0,3,3,1,17.24,7.5,969.51,0.04,31,0.13,53.86,12,19,8,13,0
4,3,0,0,2,2,1,11.99,6.67,533.03,0.03,21,0.15,29.61,10,11,6,4,0
0,1,0,0,1,1,1,6.55,3.0,58.95,0.01,7,0.33,3.28,1,6,1,0,0
0,3,0,0,2,2,1,6.69,7.5,376.42,0.02,14,0.13,20.91,5,9,3,0,0
0,1,0,0,1,1,1,7.86,2.5,49.13,0.01,7,0.4,2.73,2,5,2,0,0
0,3,0,0,2,2,1,9.32,5.0,233.02,0.02,13,0.2,12.95,5,8,4,0,0
6,1,0,0,1,1,1,17.51,5.0,437.85,0.03,23,0.2,24.32,10,13,7,6,0
0,3,0,0,2,2,1,7.75,2.0,31.02,0.01,6,0.5,1.72,2,4,2,0,0
0,3,0,0,2,2,1,7.86,2.5,49.13,0.01,7,0.4,2.73,2,5,2,0,0
11,7,0,0,4,2,3,12.35,16.0,3162.47,0.07,45,0.06,175.69,16,29,7,11,0
6,1,0,0,1,1,1,11.81,6.75,538.15,0.03,24,0.15,29.9,9,15,4,6,0
10,3,0,0,2,2,1,13.4,7.0,656.36,0.03,24,0.14,36.46,7,17,5,10,0
3,3,0,0,2,2,1,14.28,4.0,228.44,0.02,15,0.25,12.69,6,9,6,3,0
0,1,0,0,1,1,1,0.0,0.0,0.0,0.0,1,0.0,0.0,0,1,0,0,0
2,1,0,0,1,1,1,13.5,2.0,54.0,0.01,9,0.5,3.0,4,5,4,2,0
0,1,0,0,1,1,1,7.75,2.0,31.02,0.01,6,0.5,1.72,2,4,2,0,0
0,1,0,0,1,1,1,7.75,2.0,31.02,0.01,6,0.5,1.72,2,4,2,0,0
0,1,0,0,1,1,1,6.2,2.5,38.77,0.01,6,0.4,2.15,1,5,1,0,0
0,1,0,0,1,1,1,6.2,2.5,38.77,0.01,6,0.4,2.15,1,5,1,0,0
0,1,0,0,1,1,1,6.2,2.5,38.77,0.01,6,0.4,2.15,1,5,1,0,0
0,1,0,0,1,1,1,7.75,2.0,31.02,0.01,6,0.5,1.72,2,4,2,0,0
0,1,0,0,1,1,1,7.74,1.5,17.41,0.0,5,0.67,0.97,2,3,2,0,0
21,11,0,0,6,1,3,8.36,27.0,6094.62,0.08,61,0.04,338.59,24,37,4,21,0
18,9,0,0,5,1,1,6.16,28.5,5006.4,0.06,49,0.04,278.13,19,30,3,18,0
0,1,0,0,1,1,1,0.0,0.0,0.0,0.0,1,0.0,0.0,0,1,0,0,0
0,1,0,0,1,1,1,7.74,1.5,17.41,0.0,5,0.67,0.97,2,3,2,0,0
3,3,0,0,2,1,1,5.07,8.75,388.32,0.01,14,0.11,21.57,5,9,2,3,0
3,3,0,0,2,1,1,5.07,8.75,388.32,0.01,14,0.11,21.57,5,9,2,3,0
1,1,0,0,1,1,1,7.74,1.5,17.41,0.0,5,0.67,0.97,2,3,2,1,0
0,1,0,0,1,1,1,5.8,2.0,23.22,0.0,5,0.5,1.29,1,4,1,0,0
2,1,0,0,1,1,1,7.75,2.0,31.02,0.01,6,0.5,1.72,2,4,2,2,0
1,1,0,1,1,1,1,0.0,0.0,0.0,0.0,1,0.0,0.0,0,1,0,1,0
2,1,0,0,1,1,1,7.75,2.0,31.02,0.01,6,0.5,1.72,2,4,2,2,0
0,1,0,0,1,1,1,9.31,2.5,58.16,0.01,9,0.4,3.23,1,8,1,0,0
0,1,0,0,1,1,1,7.75,2.0,31.02,0.01,6,0.5,1.72,2,4,2,0,0
0,1,0,0,1,1,1,10.68,4.67,232.53,0.02,15,0.21,12.92,4,11,3,0,0
7,5,0,0,3,2,1,11.89,13.13,2048.55,0.05,35,0.08,113.81,15,20,8,7,0
5,3,0,0,2,2,1,17.22,4.08,287.09,0.02,19,0.24,15.95,7,12,6,5,0
4,3,0,0,2,2,1,11.18,5.63,353.85,0.02,17,0.18,19.66,5,12,4,4,0
0,1,0,0,1,1,1,0.0,0.0,0.0,0.0,0,0.0,0.0,0,0,0,0,0
0,1,0,0,1,1,1,6.2,2.5,38.77,0.01,6,0.4,2.15,1,5,1,0,0
2,1,0,0,1,1,1,13.2,2.5,82.5,0.01,11,0.4,4.58,5,6,4,2,0
0,1,0,0,1,1,1,11.86,3.5,145.3,0.01,12,0.29,8.07,4,8,4,0,0
0,1,0,0,1,1,1,0.0,0.0,0.0,0.0,0,0.0,0.0,0,0,0,0,0
0,1,0,0,1,1,1,0.0,0.0,0.0,0.0,0,0.0,0.0,0,0,0,0,0
0,1,0,0,1,1,1,0.0,0.0,0.0,0.0,0,0.0,0.0,0,0,0,0,0
0,1,0,0,1,1,1,7.33,4.5,148.5,0.01,11,0.22,8.25,3,8,2,0,0
8,3,0,0,2,1,1,15.07,9.75,1432.72,0.05,34,0.1,79.6,13,21,8,8,0
3,1,0,0,1,1,1,9.9,3.33,110.0,0.01,11,0.3,6.11,4,7,3,3,0
0,1,0,0,1,1,1,9.6,2.5,60.0,0.01,8,0.4,3.33,3,5,3,0,0
0,1,0,0,1,1,1,7.75,2.0,31.02,0.01,6,0.5,1.72,2,4,2,0,0
0,1,0,0,1,1,1,6.86,3.5,84.0,0.01,8,0.29,4.67,1,7,1,0,0
0,1,0,0,1,1,1,7.75,2.0,31.02,0.01,6,0.5,1.72,2,4,2,0,0
3,1,0,0,1,1,1,9.51,3.0,85.59,0.01,9,0.33,4.75,3,6,3,3,0
5,3,0,0,2,2,1,15.36,3.5,188.21,0.02,15,0.29,10.46,5,10,5,5,0
0,1,0,0,1,1,1,6.55,3.0,58.95,0.01,7,0.33,3.28,1,6,1,0,0
0,1,0,0,1,1,1,6.55,3.0,58.95,0.01,7,0.33,3.28,1,6,1,0,0
0,1,0,0,1,1,1,6.55,3.0,58.95,0.01,7,0.33,3.28,1,6,1,0,0
0,1,0,0,1,1,1,5.8,2.0,23.22,0.0,5,0.5,1.29,1,4,1,0,0
4,3,0,0,2,2,1,10.88,5.6,341.29,0.02,17,0.18,18.96,8,9,5,4,0
0,1,0,0,1,1,1,7.74,1.5,17.41,0.0,5,0.67,0.97,2,3,2,0,0
0,1,0,0,1,1,1,12.68,2.5,79.25,0.01,10,0.4,4.4,4,6,4,0,0
0,1,0,0,1,1,1,7.74,1.5,17.41,0.0,5,0.67,0.97,2,3,2,0,0
0,1,0,0,1,1,1,7.75,2.0,31.02,0.01,6,0.5,1.72,2,4,2,0,0
0,1,0,0,1,1,1,7.75,2.0,31.02,0.01,6,0.5,1.72,2,4,2,0,0
0,1,0,0,1,1,1,7.75,2.0,31.02,0.01,6,0.5,1.72,2,4,2,0,0
0,1,0,0,1,1,1,7.75,2.0,31.02,0.01,6,0.5,1.72,2,4,2,0,0
0,1,0,0,1,1,1,8.3,6.0,298.97,0.02,15,0.17,16.61,3,12,2,0,0
0,1,0,0,1,1,1,8.3,6.0,298.97,0.02,15,0.17,16.61,3,12,2,0,0
0,1,0,0,1,1,1,8.3,6.0,298.97,0.02,15,0.17,16.61,3,12,2,0,0
0,1,0,0,1,1,1,5.8,2.0,23.22,0.0,5,0.5,1.29,1,4,1,0,0
0,1,0,0,1,1,1,7.75,2.0,31.02,0.01,6,0.5,1.72,2,4,2,0,0
0,1,0,0,1,1,1,7.75,2.0,31.02,0.01,6,0.5,1.72,2,4,2,0,0
0,1,0,0,1,1,1,7.75,2.0,31.02,0.01,6,0.5,1.72,2,4,2,0,0
0,1,0,0,1,1,1,7.75,2.0,31.02,0.01,6,0.5,1.72,2,4,2,0,0
0,3,0,0,2,1,1,7.75,2.0,31.02,0.01,6,0.5,1.72,2,4,2,0,0
0,1,0,0,1,1,1,5.8,2.0,23.22,0.0,5,0.5,1.29,1,4,1,0,0
0,3,0,0,2,1,1,7.75,2.0,31.02,0.01,6,0.5,1.72,2,4,2,0,0
0,1,0,0,1,1,1,12.18,3.0,109.62,0.01,11,0.33,6.09,4,7,4,0,0
0,1,0,0,1,1,1,7.75,2.0,31.02,0.01,6,0.5,1.72,2,4,2,0,0
0,1,0,0,1,1,1,7.75,2.0,31.02,0.01,6,0.5,1.72,2,4,2,0,0
0,1,0,0,1,1,1,10.0,1.0,10.0,0.0,5,1.0,0.56,2,3,2,0,0
0,1,0,0,1,1,1,7.75,2.0,31.02,0.01,6,0.5,1.72,2,4,2,0,0
0,1,0,0,1,1,1,5.8,2.0,23.22,0.0,5,0.5,1.29,1,4,1,0,0
0,1,0,0,1,1,1,7.75,2.0,31.02,0.01,6,0.5,1.72,2,4,2,0,0
2,1,0,0,1,1,1,8.98,2.5,56.15,0.01,8,0.4,3.12,2,6,2,2,0
2,1,0,0,1,1,1,5.33,1.5,12.0,0.0,4,0.67,0.67,1,3,1,2,0
0,1,0,0,1,1,1,5.33,1.5,12.0,0.0,4,0.67,0.67,1,3,1,0,0
2,1,0,0,1,1,1,5.33,1.5,12.0,0.0,4,0.67,0.67,1,3,1,2,0
2,1,0,0,1,1,1,5.33,1.5,12.0,0.0,4,0.67,0.67,1,3,1,2,0
3,1,0,0,1,1,1,12.0,2.5,75.0,0.01,10,0.4,4.17,3,7,3,3,0
0,1,0,0,1,1,1,7.86,2.5,49.13,0.01,7,0.4,2.73,2,5,2,0,0
0,1,0,0,1,1,1,6.55,3.0,58.95,0.01,7,0.33,3.28,1,6,1,0,0
0,1,0,0,1,1,1,6.55,3.0,58.95,0.01,7,0.33,3.28,1,6,1,0,0
2,1,0,0,1,1,1,8.98,2.5,56.15,0.01,8,0.4,3.12,2,6,2,2,0
2,1,0,0,1,1,1,5.33,1.5,12.0,0.0,4,0.67,0.67,1,3,1,2,0
0,1,0,0,1,1,1,5.33,1.5,12.0,0.0,4,0.67,0.67,1,3,1,0,0
2,1,0,0,1,1,1,5.33,1.5,12.0,0.0,4,0.67,0.67,1,3,1,2,0
2,1,0,0,1,1,1,5.33,1.5,12.0,0.0,4,0.67,0.67,1,3,1,2,0
0,1,0,0,1,1,1,5.33,1.5,12.0,0.0,4,0.67,0.67,1,3,1,0,0
0,1,0,0,1,1,1,5.33,1.5,12.0,0.0,4,0.67,0.67,1,3,1,0,0
0,1,0,0,1,1,1,7.75,2.0,31.02,0.01,6,0.5,1.72,2,4,2,0,0
0,1,0,0,1,1,1,9.0,3.0,81.0,0.01,9,0.33,4.5,2,7,2,0,0
0,1,0,0,1,1,1,8.3,6.0,298.97,0.02,15,0.17,16.61,3,12,2,0,0
0,1,0,0,1,1,1,9.51,3.0,85.59,0.01,9,0.33,4.75,3,6,3,0,0
0,1,0,0,1,1,1,9.51,3.0,85.59,0.01,9,0.33,4.75,3,6,3,0,0
0,1,0,0,1,1,1,9.51,3.0,85.59,0.01,9,0.33,4.75,3,6,3,0,0
0,1,0,0,1,1,1,9.51,3.0,85.59,0.01,9,0.33,4.75,3,6,3,0,0
4,3,0,0,2,2,1,13.67,6.0,492.27,0.03,21,0.17,27.35,6,15,5,4,0
2,1,0,0,1,1,1,10.57,3.0,95.1,0.01,10,0.33,5.28,3,7,3,2,0
2,1,0,0,1,1,1,10.57,3.0,95.1,0.01,10,0.33,5.28,3,7,3,2,0
0,1,0,0,1,1,1,0.0,0.0,0.0,0.0,1,0.0,0.0,1,0,1,0,0
4,1,0,0,1,1,1,10.24,7.0,501.89,0.02,20,0.14,27.88,7,13,4,4,0
4,3,0,0,2,2,1,21.5,7.15,1099.18,0.05,35,0.14,61.07,13,22,10,4,0
8,3,0,0,2,2,1,23.46,10.29,2485.24,0.08,52,0.1,138.07,19,33,12,8,0
54,13,1,8,7,6,6,25.11,40.0,40181.42,0.33,184,0.03,2232.3,80,104,22,55,0
0,1,0,0,1,1,1,8.3,6.67,369.01,0.02,16,0.15,20.5,5,11,3,0,0
23,5,0,1,3,2,1,19.78,20.04,7940.87,0.13,80,0.05,441.16,33,47,14,23,0
0,1,0,0,1,1,1,8.6,7.5,483.97,0.02,18,0.13,26.89,5,13,3,0,0
19,5,0,3,3,3,1,19.07,10.91,2270.01,0.07,46,0.09,126.11,20,26,11,19,0
12,3,0,2,2,2,1,14.73,8.94,1176.94,0.04,31,0.11,65.39,13,18,8,12,0
12,9,0,0,5,3,3,17.46,16.55,4779.2,0.1,63,0.06,265.51,28,35,11,12,0
4,1,0,0,1,1,1,9.47,2.67,67.38,0.01,9,0.38,3.74,4,5,3,4,0
13,5,0,0,3,3,1,16.4,7.07,820.29,0.04,29,0.14,45.57,11,18,7,13,0
13,5,0,0,3,3,1,17.24,7.5,969.51,0.04,31,0.13,53.86,12,19,8,13,0
4,3,0,0,2,2,1,11.99,6.67,533.03,0.03,21,0.15,29.61,10,11,6,4,0
0,1,0,0,1,1,1,6.55,3.0,58.95,0.01,7,0.33,3.28,1,6,1,0,0
0,3,0,0,2,2,1,6.69,7.5,376.42,0.02,14,0.13,20.91,5,9,3,0,0
0,1,0,0,1,1,1,7.86,2.5,49.13,0.01,7,0.4,2.73,2,5,2,0,0
0,3,0,0,2,2,1,9.32,5.0,233.02,0.02,13,0.2,12.95,5,8,4,0,0
6,1,0,0,1,1,1,17.51,5.0,437.85,0.03,23,0.2,24.32,10,13,7,6,0
0,3,0,0,2,2,1,7.75,2.0,31.02,0.01,6,0.5,1.72,2,4,2,0,0
0,3,0,0,2,2,1,7.86,2.5,49.13,0.01,7,0.4,2.73,2,5,2,0,0
11,7,0,0,4,2,3,12.35,16.0,3162.47,0.07,45,0.06,175.69,16,29,7,11,0
3,3,0,0,2,2,1,14.28,4.0,228.44,0.02,15,0.25,12.69,6,9,6,3,0
0,1,0,0,1,1,1,0.0,0.0,0.0,0.0,1,0.0,0.0,0,1,0,0,0
2,1,0,0,1,1,1,13.5,2.0,54.0,0.01,9,0.5,3.0,4,5,4,2,0
0,1,0,0,1,1,1,7.75,2.0,31.02,0.01,6,0.5,1.72,2,4,2,0,0
0,1,0,0,1,1,1,7.75,2.0,31.02,0.01,6,0.5,1.72,2,4,2,0,0
0,1,0,0,1,1,1,7.75,2.0,31.02,0.01,6,0.5,1.72,2,4,2,0,0
0,1,0,0,1,1,1,7.74,1.5,17.41,0.0,5,0.67,0.97,2,3,2,0,0
1,1,0,0,1,1,1,7.74,1.5,17.41,0.0,5,0.67,0.97,2,3,2,1,0
0,1,0,0,1,1,1,5.8,2.0,23.22,0.0,5,0.5,1.29,1,4,1,0,0
2,1,0,0,1,1,1,7.75,2.0,31.02,0.01,6,0.5,1.72,2,4,2,2,0
1,1,0,1,1,1,1,0.0,0.0,0.0,0.0,1,0.0,0.0,0,1,0,1,0
2,1,0,0,1,1,1,7.75,2.0,31.02,0.01,6,0.5,1.72,2,4,2,2,0
0,1,0,0,1,1,1,9.31,2.5,58.16,0.01,9,0.4,3.23,1,8,1,0,0
0,1,0,0,1,1,1,7.75,2.0,31.02,0.01,6,0.5,1.72,2,4,2,0,0
0,1,0,0,1,1,1,10.68,4.67,232.53,0.02,15,0.21,12.92,4,11,3,0,0
7,5,0,0,3,2,1,11.89,13.13,2048.55,0.05,35,0.08,113.81,15,20,8,7,0
5,3,0,0,2,2,1,17.22,4.08,287.09,0.02,19,0.24,15.95,7,12,6,5,0
4,3,0,0,2,2,1,11.18,5.63,353.85,0.02,17,0.18,19.66,5,12,4,4,0
0,1,0,0,1,1,1,0.0,0.0,0.0,0.0,0,0.0,0.0,0,0,0,0,0
0,1,0,0,1,1,1,6.2,2.5,38.77,0.01,6,0.4,2.15,1,5,1,0,0
0,1,0,0,1,1,1,11.86,3.5,145.3,0.01,12,0.29,8.07,4,8,4,0,0
0,1,0,0,1,1,1,0.0,0.0,0.0,0.0,0,0.0,0.0,0,0,0,0,0
0,1,0,0,1,1,1,0.0,0.0,0.0,0.0,0,0.0,0.0,0,0,0,0,0
0,1,0,0,1,1,1,0.0,0.0,0.0,0.0,0,0.0,0.0,0,0,0,0,0
0,1,0,0,1,1,1,7.33,4.5,148.5,0.01,11,0.22,8.25,3,8,2,0,0
8,3,0,0,2,1,1,15.07,9.75,1432.72,0.05,34,0.1,79.6,13,21,8,8,0
0,1,0,0,1,1,1,9.6,2.5,60.0,0.01,8,0.4,3.33,3,5,3,0,0
0,1,0,0,1,1,1,7.75,2.0,31.02,0.01,6,0.5,1.72,2,4,2,0,0
0,1,0,0,1,1,1,6.86,3.5,84.0,0.01,8,0.29,4.67,1,7,1,0,0
0,1,0,0,1,1,1,7.75,2.0,31.02,0.01,6,0.5,1.72,2,4,2,0,0
5,3,0,0,2,1,1,11.86,4.38,227.03,0.02,15,0.23,12.61,5,10,4,5,0
4,1,0,0,1,1,1,16.0,3.0,144.0,0.02,16,0.33,8.0,6,10,4,4,0
4,1,0,0,1,1,1,16.0,3.0,144.0,0.02,16,0.33,8.0,6,10,4,4,0
4,1,0,0,1,1,1,27.12,4.28,496.22,0.04,29,0.23,27.57,11,18,9,4,0
4,1,0,0,1,1,1,27.47,1.5,61.81,0.01,13,0.67,3.43,6,7,6,4,0
4,1,0,0,1,1,1,23.8,4.0,380.74,0.03,25,0.25,21.15,8,17,7,4,0
2,1,0,0,1,1,1,5.33,1.5,12.0,0.0,4,0.67,0.67,1,3,1,2,0
2,1,0,0,1,1,1,5.33,1.5,12.0,0.0,4,0.67,0.67,1,3,1,2,0
2,1,0,0,1,1,1,5.33,1.5,12.0,0.0,4,0.67,0.67,1,3,1,2,0
2,1,0,0,1,1,1,5.33,1.5,12.0,0.0,4,0.67,0.67,1,3,1,2,0
6,3,0,0,2,2,1,15.9,5.79,532.29,0.03,23,0.17,29.57,9,14,7,6,0
20,11,0,3,6,1,6,17.54,9.33,1528.02,0.05,43,0.11,84.89,14,29,6,20,0
4,5,0,0,3,1,1,13.84,5.25,381.4,0.02,21,0.19,21.19,6,15,4,4,0
3,1,0,0,1,1,1,9.51,3.0,85.59,0.01,9,0.33,4.75,3,6,3,3,0
5,3,0,0,2,2,1,15.36,3.5,188.21,0.02,15,0.29,10.46,5,10,5,5,0
4,3,0,0,2,2,1,10.88,5.6,341.29,0.02,17,0.18,18.96,8,9,5,4,0
0,1,0,0,1,1,1,7.74,1.5,17.41,0.0,5,0.67,0.97,2,3,2,0,0
0,1,0,0,1,1,1,12.68,2.5,79.25,0.01,10,0.4,4.4,4,6,4,0,0
0,1,0,0,1,1,1,7.74,1.5,17.41,0.0,5,0.67,0.97,2,3,2,0,0
0,1,0,0,1,1,1,7.75,2.0,31.02,0.01,6,0.5,1.72,2,4,2,0,0
0,1,0,0,1,1,1,7.75,2.0,31.02,0.01,6,0.5,1.72,2,4,2,0,0
0,1,0,0,1,1,1,7.75,2.0,31.02,0.01,6,0.5,1.72,2,4,2,0,0
0,1,0,0,1,1,1,7.75,2.0,31.02,0.01,6,0.5,1.72,2,4,2,0,0
7,3,0,0,2,2,1,15.65,7.31,836.91,0.04,28,0.14,46.49,13,15,8,7,0
0,1,0,0,1,1,1,8.3,6.0,298.97,0.02,15,0.17,16.61,3,12,2,0,0
0,1,0,0,1,1,1,8.3,6.0,298.97,0.02,15,0.17,16.61,3,12,2,0,0
0,1,0,0,1,1,1,8.3,6.0,298.97,0.02,15,0.17,16.61,3,12,2,0,0
0,1,0,0,1,1,1,7.75,2.0,31.02,0.01,6,0.5,1.72,2,4,2,0,0
0,1,0,0,1,1,1,7.75,2.0,31.02,0.01,6,0.5,1.72,2,4,2,0,0
0,1,0,0,1,1,1,7.75,2.0,31.02,0.01,6,0.5,1.72,2,4,2,0,0
0,1,0,0,1,1,1,7.75,2.0,31.02,0.01,6,0.5,1.72,2,4,2,0,0
0,3,0,0,2,1,1,7.75,2.0,31.02,0.01,6,0.5,1.72,2,4,2,0,0
0,1,0,0,1,1,1,5.8,2.0,23.22,0.0,5,0.5,1.29,1,4,1,0,0
0,3,0,0,2,1,1,7.75,2.0,31.02,0.01,6,0.5,1.72,2,4,2,0,0
0,1,0,0,1,1,1,12.18,3.0,109.62,0.01,11,0.33,6.09,4,7,4,0,0
0,1,0,0,1,1,1,7.75,2.0,31.02,0.01,6,0.5,1.72,2,4,2,0,0
0,1,0,0,1,1,1,7.75,2.0,31.02,0.01,6,0.5,1.72,2,4,2,0,0
0,1,0,0,1,1,1,7.75,2.0,31.02,0.01,6,0.5,1.72,2,4,2,0,0
0,1,0,0,1,1,1,5.8,2.0,23.22,0.0,5,0.5,1.29,1,4,1,0,0
0,1,0,0,1,1,1,7.75,2.0,31.02,0.01,6,0.5,1.72,2,4,2,0,0
2,1,0,0,1,1,1,8.98,2.5,56.15,0.01,8,0.4,3.12,2,6,2,2,0
2,1,0,0,1,1,1,5.33,1.5,12.0,0.0,4,0.67,0.67,1,3,1,2,0
0,1,0,0,1,1,1,5.33,1.5,12.0,0.0,4,0.67,0.67,1,3,1,0,0
2,1,0,0,1,1,1,5.33,1.5,12.0,0.0,4,0.67,0.67,1,3,1,2,0
2,1,0,0,1,1,1,5.33,1.5,12.0,0.0,4,0.67,0.67,1,3,1,2,0
3,1,0,0,1,1,1,12.0,2.5,75.0,0.01,10,0.4,4.17,3,7,3,3,0
0,1,0,0,1,1,1,7.86,2.5,49.13,0.01,7,0.4,2.73,2,5,2,0,0
0,1,0,0,1,1,1,6.55,3.0,58.95,0.01,7,0.33,3.28,1,6,1,0,0
0,1,0,0,1,1,1,6.55,3.0,58.95,0.01,7,0.33,3.28,1,6,1,0,0
2,1,0,0,1,1,1,8.98,2.5,56.15,0.01,8,0.4,3.12,2,6,2,2,0
2,1,0,0,1,1,1,5.33,1.5,12.0,0.0,4,0.67,0.67,1,3,1,2,0
0,1,0,0,1,1,1,5.33,1.5,12.0,0.0,4,0.67,0.67,1,3,1,0,0
2,1,0,0,1,1,1,5.33,1.5,12.0,0.0,4,0.67,0.67,1,3,1,2,0
2,1,0,0,1,1,1,5.33,1.5,12.0,0.0,4,0.67,0.67,1,3,1,2,0
0,1,0,0,1,1,1,5.33,1.5,12.0,0.0,4,0.67,0.67,1,3,1,0,0
0,1,0,0,1,1,1,5.33,1.5,12.0,0.0,4,0.67,0.67,1,3,1,0,0
0,1,0,0,1,1,1,7.75,2.0,31.02,0.01,6,0.5,1.72,2,4,2,0,0
0,1,0,0,1,1,1,9.0,3.0,81.0,0.01,9,0.33,4.5,2,7,2,0,0
0,1,0,0,1,1,1,8.3,6.0,298.97,0.02,15,0.17,16.61,3,12,2,0,0
0,1,0,0,1,1,1,9.51,3.0,85.59,0.01,9,0.33,4.75,3,6,3,0,0
0,1,0,0,1,1,1,9.51,3.0,85.59,0.01,9,0.33,4.75,3,6,3,0,0
0,1,0,0,1,1,1,9.51,3.0,85.59,0.01,9,0.33,4.75,3,6,3,0,0
0,1,0,0,1,1,1,9.51,3.0,85.59,0.01,9,0.33,4.75,3,6,3,0,0
4,3,0,0,2,2,1,13.67,6.0,492.27,0.03,21,0.17,27.35,6,15,5,4,0
0,1,0,0,1,1,1,0.0,0.0,0.0,0.0,1,0.0,0.0,0,1,0,0,0
0,1,0,0,1,1,1,7.86,2.5,49.13,0.01,7,0.4,2.73,2,5,2,0,0
0,1,0,0,1,1,1,7.74,1.5,17.41,0.0,5,0.67,0.97,2,3,2,0,0
2,1,0,0,1,1,1,7.74,1.5,17.41,0.0,5,0.67,0.97,2,3,2,2,0
3,1,0,0,1,1,1,17.79,2.92,151.35,0.02,15,0.34,8.41,7,8,6,3,0
0,1,0,0,1,1,1,0.0,0.0,0.0,0.0,1,0.0,0.0,0,1,0,0,0
0,1,0,0,1,1,1,0.0,0.0,0.0,0.0,0,0.0,0.0,0,0,0,0,0
0,1,0,0,1,1,1,5.33,1.5,12.0,0.0,4,0.67,0.67,1,3,1,0,0
0,1,0,0,1,1,1,5.33,1.5,12.0,0.0,4,0.67,0.67,1,3,1,0,0
0,1,0,0,1,1,1,5.33,1.5,12.0,0.0,4,0.67,0.67,1,3,1,0,0
0,1,0,0,1,1,1,5.33,1.5,12.0,0.0,4,0.67,0.67,1,3,1,0,0
0,1,0,0,1,1,1,5.33,1.5,12.0,0.0,4,0.67,0.67,1,3,1,0,0
0,1,0,0,1,1,1,9.51,3.0,85.59,0.01,9,0.33,4.75,3,6,3,0,0
0,1,0,0,1,1,1,5.33,1.5,12.0,0.0,4,0.67,0.67,1,3,1,0,0
0,1,0,0,1,1,1,5.33,1.5,12.0,0.0,4,0.67,0.67,1,3,1,0,0
0,1,0,0,1,1,1,5.33,1.5,12.0,0.0,4,0.67,0.67,1,3,1,0,0
0,1,0,0,1,1,1,5.33,1.5,12.0,0.0,4,0.67,0.67,1,3,1,0,0
0,1,0,0,1,1,1,5.33,1.5,12.0,0.0,4,0.67,0.67,1,3,1,0,0
0,1,0,0,1,1,1,5.33,1.5,12.0,0.0,4,0.67,0.67,1,3,1,0,0
0,1,0,0,1,1,1,0.0,0.0,0.0,0.0,1,0.0,0.0,0,1,0,0,0
0,1,0,0,1,1,1,0.0,0.0,0.0,0.0,0,0.0,0.0,0,0,0,0,0
0,1,0,0,1,1,1,5.33,1.5,12.0,0.0,4,0.67,0.67,1,3,1,0,0
0,1,0,0,1,1,1,5.33,1.5,12.0,0.0,4,0.67,0.67,1,3,1,0,0
0,1,0,0,1,1,1,5.33,1.5,12.0,0.0,4,0.67,0.67,1,3,1,0,0
0,1,0,0,1,1,1,5.33,1.5,12.0,0.0,4,0.67,0.67,1,3,1,0,0
0,1,0,0,1,1,1,5.33,1.5,12.0,0.0,4,0.67,0.67,1,3,1,0,0
0,1,0,0,1,1,1,9.51,3.0,85.59,0.01,9,0.33,4.75,3,6,3,0,0
0,1,0,0,1,1,1,5.33,1.5,12.0,0.0,4,0.67,0.67,1,3,1,0,0
0,1,0,0,1,1,1,5.33,1.5,12.0,0.0,4,0.67,0.67,1,3,1,0,0
0,1,0,0,1,1,1,5.33,1.5,12.0,0.0,4,0.67,0.67,1,3,1,0,0
0,1,0,0,1,1,1,5.33,1.5,12.0,0.0,4,0.67,0.67,1,3,1,0,0
0,1,0,0,1,1,1,5.33,1.5,12.0,0.0,4,0.67,0.67,1,3,1,0,0
0,1,0,0,1,1,1,5.33,1.5,12.0,0.0,4,0.67,0.67,1,3,1,0,0
0,1,0,0,1,1,1,0.0,0.0,0.0,0.0,1,0.0,0.0,0,1,0,0,0
0,1,0,0,1,1,1,0.0,0.0,0.0,0.0,0,0.0,0.0,0,0,0,0,0
0,1,0,0,1,1,1,5.33,1.5,12.0,0.0,4,0.67,0.67,1,3,1,0,0
0,1,0,0,1,1,1,5.33,1.5,12.0,0.0,4,0.67,0.67,1,3,1,0,0
0,1,0,0,1,1,1,5.33,1.5,12.0,0.0,4,0.67,0.67,1,3,1,0,0
0,1,0,0,1,1,1,5.33,1.5,12.0,0.0,4,0.67,0.67,1,3,1,0,0
0,1,0,0,1,1,1,5.33,1.5,12.0,0.0,4,0.67,0.67,1,3,1,0,0
0,1,0,0,1,1,1,9.51,3.0,85.59,0.01,9,0.33,4.75,3,6,3,0,0
0,1,0,0,1,1,1,5.33,1.5,12.0,0.0,4,0.67,0.67,1,3,1,0,0
0,1,0,0,1,1,1,5.33,1.5,12.0,0.0,4,0.67,0.67,1,3,1,0,0
0,1,0,0,1,1,1,5.33,1.5,12.0,0.0,4,0.67,0.67,1,3,1,0,0
12,3,0,0,2,1,1,24.53,5.06,626.89,0.04,31,0.2,34.83,13,18,9,12,0
11,7,0,1,4,2,1,16.8,9.0,1361.13,0.05,37,0.11,75.62,16,21,8,11,0
0,1,0,0,1,1,1,5.33,1.5,12.0,0.0,4,0.67,0.67,1,3,1,0,0
0,1,0,0,1,1,1,5.33,1.5,12.0,0.0,4,0.67,0.67,1,3,1,0,0
0,1,0,0,1,1,1,5.33,1.5,12.0,0.0,4,0.67,0.67,1,3,1,0,0
16,5,0,2,3,3,1,39.78,6.19,1522.89,0.08,53,0.16,84.61,22,31,16,16,0
8,3,0,1,2,1,1,14.97,9.29,1290.47,0.05,34,0.11,71.69,13,21,7,8,0
14,5,1,4,3,2,1,41.92,5.25,1155.41,0.07,48,0.19,64.19,21,27,16,15,0
2,1,0,0,1,1,1,8.98,2.5,56.15,0.01,8,0.4,3.12,2,6,2,2,0
2,1,0,0,1,1,1,8.98,2.5,56.15,0.01,8,0.4,3.12,2,6,2,2,0
5,3,0,0,2,1,1,13.84,3.5,169.51,0.02,14,0.29,9.42,4,10,4,5,0
5,3,0,0,2,1,1,13.84,3.5,169.51,0.02,14,0.29,9.42,4,10,4,5,0
109,31,0,13,16,13,1,37.46,86.64,281205.63,1.08,564,0.01,15622.54,201,363,29,109,0
109,31,0,13,16,13,1,37.46,86.64,281205.63,1.08,564,0.01,15622.54,201,363,29,109,0
5,3,0,3,2,1,1,4.87,13.5,887.34,0.02,19,0.07,49.3,6,13,2,5,0
5,3,0,3,2,1,1,4.87,13.5,887.34,0.02,19,0.07,49.3,6,13,2,5,0
22,29,0,3,15,7,3,14.84,49.11,35780.79,0.24,155,0.02,1987.82,52,103,9,22,0
22,29,0,3,15,7,3,14.84,49.11,35780.79,0.24,155,0.02,1987.82,52,103,9,22,0
10,3,0,1,2,2,1,22.56,10.29,2389.65,0.08,50,0.1,132.76,19,31,12,10,0
10,3,0,1,2,2,1,22.56,10.29,2389.65,0.08,50,0.1,132.76,19,31,12,10,0
50,30,0,9,17,8,17,13.7,92.44,117120.91,0.42,247,0.01,6506.72,64,183,9,50,0
50,30,0,9,17,8,17,13.7,92.44,117120.91,0.42,247,0.01,6506.72,64,183,9,50,0
77,31,0,30,16,14,15,39.82,60.83,147362.04,0.81,419,0.02,8186.78,146,273,30,77,0
77,31,0,30,16,14,15,39.82,60.83,147362.04,0.81,419,0.02,8186.78,146,273,30,77,0
7,3,0,2,2,2,1,12.26,7.33,659.44,0.03,22,0.14,36.64,8,14,6,7,0
7,3,0,2,2,2,1,12.26,7.33,659.44,0.03,22,0.14,36.64,8,14,6,7,0
5,3,0,2,2,2,1,12.33,4.8,284.19,0.02,16,0.21,15.79,6,10,5,5,0
5,3,0,2,2,2,1,12.33,4.8,284.19,0.02,16,0.21,15.79,6,10,5,5,0
50,16,31,0,15,1,1,41.55,38.0,59998.29,0.53,247,0.03,3333.24,92,155,46,81,0
50,16,31,0,15,1,1,41.55,38.0,59998.29,0.53,247,0.03,3333.24,92,155,46,81,0
8,3,0,1,2,1,1,8.88,9.0,719.59,0.03,21,0.11,39.98,10,11,5,8,0
8,3,0,1,2,1,1,8.88,9.0,719.59,0.03,21,0.11,39.98,10,11,5,8,0
7,3,0,0,2,1,1,10.64,8.0,680.88,0.03,23,0.13,37.83,10,13,5,7,0
7,3,0,0,2,1,1,10.64,8.0,680.88,0.03,23,0.13,37.83,10,13,5,7,0
10,5,0,1,3,1,1,15.82,9.29,1364.49,0.05,34,0.11,75.81,10,24,7,10,0
10,5,0,1,3,1,1,15.82,9.29,1364.49,0.05,34,0.11,75.81,10,24,7,10,0
12,3,0,22,2,2,1,21.34,9.45,1907.34,0.07,44,0.11,105.96,16,28,11,12,0
12,3,0,22,2,2,1,21.34,9.45,1907.34,0.07,44,0.11,105.96,16,28,11,12,0
7,1,0,3,1,1,1,24.9,5.73,816.84,0.05,33,0.17,45.38,14,19,11,7,0
7,1,0,3,1,1,1,24.9,5.73,816.84,0.05,33,0.17,45.38,14,19,11,7,0
21,7,0,24,4,3,4,21.18,20.9,9250.53,0.15,87,0.05,513.91,33,54,15,21,0
21,7,0,24,4,3,4,21.18,20.9,9250.53,0.15,87,0.05,513.91,33,54,15,21,0
4,1,0,1,1,1,1,8.45,6.0,304.31,0.02,16,0.17,16.91,6,10,3,4,0
4,1,0,1,1,1,1,8.45,6.0,304.31,0.02,16,0.17,16.91,6,10,3,4,0
8,5,0,2,3,1,3,13.78,10.08,1401.32,0.05,34,0.1,77.85,11,23,6,8,0
8,5,0,2,3,1,3,13.78,10.08,1401.32,0.05,34,0.1,77.85,11,23,6,8,0
27,11,0,0,6,6,1,26.07,23.61,14532.97,0.21,120,0.04,807.39,50,70,18,27,0
27,11,0,0,6,6,1,26.07,23.61,14532.97,0.21,120,0.04,807.39,50,70,18,27,0
27,9,0,0,5,5,5,20.47,20.19,8348.16,0.14,86,0.05,463.79,35,51,13,27,0
27,9,0,0,5,5,5,20.47,20.19,8348.16,0.14,86,0.05,463.79,35,51,13,27,0
5,1,0,0,1,1,1,16.51,4.8,380.39,0.03,25,0.21,21.13,12,13,5,5,0
5,1,0,0,1,1,1,16.51,4.8,380.39,0.03,25,0.21,21.13,12,13,5,5,0
2,1,0,0,1,1,1,10.44,3.5,127.89,0.01,11,0.29,7.11,3,8,3,2,0
2,1,0,0,1,1,1,10.44,3.5,127.89,0.01,11,0.29,7.11,3,8,3,2,0
12,3,0,0,2,2,1,19.27,10.8,2248.0,0.07,49,0.09,124.89,24,25,10,12,0
12,3,0,0,2,2,1,19.27,10.8,2248.0,0.07,49,0.09,124.89,24,25,10,12,0
3,1,0,1,1,1,1,7.89,8.0,504.93,0.02,19,0.13,28.05,4,15,2,3,0
3,1,0,1,1,1,1,7.89,8.0,504.93,0.02,19,0.13,28.05,4,15,2,3,0
3,1,0,1,1,1,1,7.89,8.0,504.93,0.02,19,0.13,28.05,4,15,2,3,0
3,1,0,1,1,1,1,7.89,8.0,504.93,0.02,19,0.13,28.05,4,15,2,3,0
4,1,0,0,1,1,1,16.73,3.6,216.82,0.02,19,0.28,12.05,9,10,5,4,0
4,1,0,0,1,1,1,16.73,3.6,216.82,0.02,19,0.28,12.05,9,10,5,4,0
10,3,0,0,2,2,1,20.57,8.56,1505.78,0.06,44,0.12,83.65,22,22,9,10,0
10,3,0,0,2,2,1,20.57,8.56,1505.78,0.06,44,0.12,83.65,22,22,9,10,0
14,5,1,2,3,3,3,14.42,14.44,3005.14,0.07,49,0.07,166.95,21,28,8,15,0
14,5,1,2,3,3,3,14.42,14.44,3005.14,0.07,49,0.07,166.95,21,28,8,15,0
2,1,0,0,1,1,1,9.49,3.5,116.27,0.01,10,0.29,6.46,3,7,3,2,0
2,1,0,0,1,1,1,9.49,3.5,116.27,0.01,10,0.29,6.46,3,7,3,2,0
3,1,0,1,1,1,1,10.82,5.83,368.18,0.02,19,0.17,20.45,5,14,3,3,0
3,1,0,1,1,1,1,10.82,5.83,368.18,0.02,19,0.17,20.45,5,14,3,3,0
3,1,0,1,1,1,1,10.82,5.83,368.18,0.02,19,0.17,20.45,5,14,3,3,0
3,1,0,1,1,1,1,10.82,5.83,368.18,0.02,19,0.17,20.45,5,14,3,3,0
6,1,0,1,1,1,1,16.37,6.0,589.61,0.03,31,0.17,32.75,15,16,5,6,0
6,1,0,1,1,1,1,16.37,6.0,589.61,0.03,31,0.17,32.75,15,16,5,6,0
5,1,0,1,1,1,1,16.51,4.8,380.39,0.03,25,0.21,21.13,12,13,5,5,0
5,1,0,1,1,1,1,16.51,4.8,380.39,0.03,25,0.21,21.13,12,13,5,5,0
6,1,0,0,1,1,1,22.08,3.57,281.68,0.03,22,0.28,15.65,10,12,7,6,0
11,3,0,0,2,1,1,15.95,8.57,1172.07,0.05,35,0.12,65.11,15,20,7,11,0
4,3,0,0,2,1,1,11.52,3.75,161.94,0.01,13,0.27,9.0,5,8,4,4,0
2,1,0,0,1,1,1,7.74,1.5,17.41,0.0,5,0.67,0.97,2,3,2,2,0
8,3,1,0,2,1,1,21.22,9.17,1783.04,0.06,43,0.11,99.06,20,23,12,9,0
5,3,1,0,2,1,1,19.52,4.88,464.02,0.03,25,0.21,25.78,13,12,8,6,0
4,3,0,0,2,1,1,12.33,4.8,284.19,0.02,16,0.21,15.79,6,10,5,4,0
4,3,0,0,2,1,1,13.95,2.5,87.17,0.01,11,0.4,4.84,4,7,4,4,0
8,5,0,0,3,1,1,10.85,9.0,879.05,0.03,25,0.11,48.84,12,13,6,8,0
0,1,0,0,1,1,1,5.33,1.5,12.0,0.0,4,0.67,0.67,1,3,1,0,0
60,17,0,6,10,5,4,43.24,29.88,38605.2,0.43,217,0.03,2144.73,68,149,33,60,0
60,17,0,6,10,5,4,43.24,29.88,38605.2,0.43,217,0.03,2144.73,68,149,33,60,0
30,11,1,8,6,1,1,55.91,9.9,5485.35,0.18,114,0.1,304.74,52,62,21,31,0
4,1,0,0,1,1,1,16.5,2.0,66.0,0.01,11,0.5,3.67,4,7,4,4,0
0,1,0,0,1,1,1,7.74,1.5,17.41,0.0,5,0.67,0.97,2,3,2,0,0
0,1,0,0,1,1,1,7.74,1.5,17.41,0.0,5,0.67,0.97,2,3,2,0,0
0,1,0,0,1,1,1,7.74,1.5,17.41,0.0,5,0.67,0.97,2,3,2,0,0
0,1,0,0,1,1,1,7.74,1.5,17.41,0.0,5,0.67,0.97,2,3,2,0,0
10,3,3,2,2,2,1,43.79,3.72,605.59,0.05,36,0.27,33.64,17,19,16,13,0
0,1,0,0,1,1,1,6.2,2.5,38.77,0.01,6,0.4,2.15,1,5,1,0,0
4,3,0,0,2,1,1,5.43,7.0,266.27,0.01,12,0.14,14.79,4,8,2,4,0
0,1,0,0,1,1,1,5.33,1.5,12.0,0.0,4,0.67,0.67,1,3,1,0,0
0,1,0,0,1,1,1,5.33,1.5,12.0,0.0,4,0.67,0.67,1,3,1,0,0
3,1,0,0,1,1,1,10.38,4.0,166.05,0.01,12,0.25,9.23,3,9,3,3,0
3,3,0,0,1,1,1,13.29,3.0,119.59,0.01,12,0.33,6.64,4,8,4,3,0
3,3,0,0,1,1,1,13.29,3.0,119.59,0.01,12,0.33,6.64,4,8,4,3,0
12,6,0,0,5,2,1,25.45,9.15,2132.75,0.08,49,0.11,118.49,17,32,13,12,0
10,3,0,2,2,2,1,11.3,13.0,1910.29,0.05,34,0.08,106.13,14,20,7,10,0
8,3,0,2,2,2,1,10.08,12.0,1451.13,0.04,29,0.08,80.62,12,17,6,8,0
8,3,0,2,2,2,1,10.97,13.0,1854.11,0.05,33,0.08,103.01,14,19,7,8,0
10,3,0,2,2,2,1,11.68,12.0,1682.18,0.05,33,0.08,93.45,14,19,7,10,0
3,3,0,3,1,1,1,13.29,3.0,119.59,0.01,12,0.33,6.64,4,8,4,3,0
3,3,0,0,1,1,1,13.29,3.0,119.59,0.01,12,0.33,6.64,4,8,4,3,0
3,3,0,0,1,1,1,13.29,3.0,119.59,0.01,12,0.33,6.64,4,8,4,3,0
2,1,0,0,1,1,1,8.3,4.0,132.88,0.01,10,0.25,7.38,2,8,2,2,0
10,3,0,2,2,2,1,11.3,13.0,1910.29,0.05,34,0.08,106.13,14,20,7,10,0
5,3,0,0,2,1,1,11.56,4.8,266.43,0.02,15,0.21,14.8,6,9,5,5,0
4,1,0,0,1,1,1,8.54,4.67,186.03,0.01,12,0.21,10.33,4,8,3,4,0
2,1,0,0,1,1,1,8.0,3.0,72.0,0.01,8,0.33,4.0,2,6,2,2,0
10,3,0,2,2,2,1,9.8,15.17,2254.94,0.05,35,0.07,125.27,14,21,6,10,0
0,1,0,0,1,1,1,7.75,2.0,31.02,0.01,6,0.5,1.72,2,4,2,0,0
0,1,0,0,1,1,1,7.75,2.0,31.02,0.01,6,0.5,1.72,2,4,2,0,0
5,5,0,0,3,1,3,10.99,6.4,449.97,0.02,19,0.16,25.0,8,11,5,5,0
0,1,0,0,1,1,1,0.0,0.0,0.0,0.0,1,0.0,0.0,0,1,0,0,0
0,1,0,0,1,1,1,9.51,0.5,2.38,0.0,3,2.0,0.13,2,1,2,0,0
4,1,0,0,1,1,1,10.24,7.0,501.89,0.02,20,0.14,27.88,7,13,4,4,0
4,3,0,0,2,2,1,21.5,7.15,1099.18,0.05,35,0.14,61.07,13,22,10,4,0
8,3,0,0,2,2,1,23.46,10.29,2485.24,0.08,52,0.1,138.07,19,33,12,8,0
54,13,1,8,7,6,6,25.11,40.0,40181.42,0.33,184,0.03,2232.3,80,104,22,55,0
0,1,0,0,1,1,1,8.3,6.67,369.01,0.02,16,0.15,20.5,5,11,3,0,0
23,5,0,1,3,2,1,19.78,20.04,7940.87,0.13,80,0.05,441.16,33,47,14,23,0
0,1,0,0,1,1,1,8.6,7.5,483.97,0.02,18,0.13,26.89,5,13,3,0,0
19,5,0,3,3,3,1,19.07,10.91,2270.01,0.07,46,0.09,126.11,20,26,11,19,0
12,3,0,2,2,2,1,14.73,8.94,1176.94,0.04,31,0.11,65.39,13,18,8,12,0
12,9,0,0,5,3,3,17.46,16.55,4779.2,0.1,63,0.06,265.51,28,35,11,12,0
4,1,0,0,1,1,1,9.47,2.67,67.38,0.01,9,0.38,3.74,4,5,3,4,0
13,5,0,0,3,3,1,16.4,7.07,820.29,0.04,29,0.14,45.57,11,18,7,13,0
13,5,0,0,3,3,1,17.24,7.5,969.51,0.04,31,0.13,53.86,12,19,8,13,0
4,3,0,0,2,2,1,11.99,6.67,533.03,0.03,21,0.15,29.61,10,11,6,4,0
0,1,0,0,1,1,1,6.55,3.0,58.95,0.01,7,0.33,3.28,1,6,1,0,0
0,3,0,0,2,2,1,6.69,7.5,376.42,0.02,14,0.13,20.91,5,9,3,0,0
0,1,0,0,1,1,1,7.86,2.5,49.13,0.01,7,0.4,2.73,2,5,2,0,0
0,3,0,0,2,2,1,9.32,5.0,233.02,0.02,13,0.2,12.95,5,8,4,0,0
6,1,0,0,1,1,1,17.51,5.0,437.85,0.03,23,0.2,24.32,10,13,7,6,0
0,3,0,0,2,2,1,7.75,2.0,31.02,0.01,6,0.5,1.72,2,4,2,0,0
0,3,0,0,2,2,1,7.86,2.5,49.13,0.01,7,0.4,2.73,2,5,2,0,0
11,7,0,0,4,2,3,12.35,16.0,3162.47,0.07,45,0.06,175.69,16,29,7,11,0
3,3,0,0,2,2,1,14.28,4.0,228.44,0.02,15,0.25,12.69,6,9,6,3,0
0,1,0,0,1,1,1,0.0,0.0,0.0,0.0,1,0.0,0.0,0,1,0,0,0
2,1,0,0,1,1,1,13.5,2.0,54.0,0.01,9,0.5,3.0,4,5,4,2,0
0,1,0,0,1,1,1,7.75,2.0,31.02,0.01,6,0.5,1.72,2,4,2,0,0
0,1,0,0,1,1,1,7.75,2.0,31.02,0.01,6,0.5,1.72,2,4,2,0,0
0,1,0,0,1,1,1,7.75,2.0,31.02,0.01,6,0.5,1.72,2,4,2,0,0
0,1,0,0,1,1,1,7.74,1.5,17.41,0.0,5,0.67,0.97,2,3,2,0,0
1,1,0,0,1,1,1,7.74,1.5,17.41,0.0,5,0.67,0.97,2,3,2,1,0
0,1,0,0,1,1,1,5.8,2.0,23.22,0.0,5,0.5,1.29,1,4,1,0,0
2,1,0,0,1,1,1,7.75,2.0,31.02,0.01,6,0.5,1.72,2,4,2,2,0
1,1,0,1,1,1,1,0.0,0.0,0.0,0.0,1,0.0,0.0,0,1,0,1,0
2,1,0,0,1,1,1,7.75,2.0,31.02,0.01,6,0.5,1.72,2,4,2,2,0
0,1,0,0,1,1,1,9.31,2.5,58.16,0.01,9,0.4,3.23,1,8,1,0,0
0,1,0,0,1,1,1,7.75,2.0,31.02,0.01,6,0.5,1.72,2,4,2,0,0
0,1,0,0,1,1,1,10.68,4.67,232.53,0.02,15,0.21,12.92,4,11,3,0,0
7,5,0,0,3,2,1,11.89,13.13,2048.55,0.05,35,0.08,113.81,15,20,8,7,0
5,3,0,0,2,2,1,17.22,4.08,287.09,0.02,19,0.24,15.95,7,12,6,5,0
4,3,0,0,2,2,1,11.18,5.63,353.85,0.02,17,0.18,19.66,5,12,4,4,0
0,1,0,0,1,1,1,0.0,0.0,0.0,0.0,0,0.0,0.0,0,0,0,0,0
0,1,0,0,1,1,1,5.33,1.5,12.0,0.0,4,0.67,0.67,1,3,1,0,0
0,1,0,0,1,1,1,5.33,1.5,12.0,0.0,4,0.67,0.67,1,3,1,0,0
0,1,0,0,1,1,1,7.74,1.5,17.41,0.0,5,0.67,0.97,2,3,2,0,0
0,1,0,0,1,1,1,6.2,2.5,38.77,0.01,6,0.4,2.15,1,5,1,0,0
0,1,0,0,1,1,1,11.86,3.5,145.3,0.01,12,0.29,8.07,4,8,4,0,0
0,1,0,0,1,1,1,0.0,0.0,0.0,0.0,0,0.0,0.0,0,0,0,0,0
0,1,0,0,1,1,1,0.0,0.0,0.0,0.0,0,0.0,0.0,0,0,0,0,0
0,1,0,0,1,1,1,0.0,0.0,0.0,0.0,0,0.0,0.0,0,0,0,0,0
0,1,0,0,1,1,1,7.33,4.5,148.5,0.01,11,0.22,8.25,3,8,2,0,0
8,3,0,0,2,1,1,15.07,9.75,1432.72,0.05,34,0.1,79.6,13,21,8,8,0
0,1,0,0,1,1,1,9.6,2.5,60.0,0.01,8,0.4,3.33,3,5,3,0,0
0,1,0,0,1,1,1,7.75,2.0,31.02,0.01,6,0.5,1.72,2,4,2,0,0
0,1,0,0,1,1,1,6.86,3.5,84.0,0.01,8,0.29,4.67,1,7,1,0,0
0,1,0,0,1,1,1,7.75,2.0,31.02,0.01,6,0.5,1.72,2,4,2,0,0
0,1,0,0,1,1,1,7.74,1.5,17.41,0.0,5,0.67,0.97,2,3,2,0,0
0,1,0,0,1,1,1,5.33,1.5,12.0,0.0,4,0.67,0.67,1,3,1,0,0
0,1,0,0,1,1,1,5.33,1.5,12.0,0.0,4,0.67,0.67,1,3,1,0,0
0,1,0,0,1,1,1,8.3,6.0,298.97,0.02,15,0.17,16.61,3,12,2,0,0
0,1,0,0,1,1,1,8.3,6.0,298.97,0.02,15,0.17,16.61,3,12,2,0,0
0,1,0,0,1,1,1,8.3,6.0,298.97,0.02,15,0.17,16.61,3,12,2,0,0
3,1,0,0,1,1,1,9.51,3.0,85.59,0.01,9,0.33,4.75,3,6,3,3,0
5,3,0,0,2,2,1,15.36,3.5,188.21,0.02,15,0.29,10.46,5,10,5,5,0
4,3,0,0,2,2,1,10.88,5.6,341.29,0.02,17,0.18,18.96,8,9,5,4,0
0,1,0,0,1,1,1,7.74,1.5,17.41,0.0,5,0.67,0.97,2,3,2,0,0
2,1,0,0,1,1,1,7.35,8.0,470.48,0.02,17,0.13,26.14,6,11,3,2,0
0,1,0,0,1,1,1,12.68,2.5,79.25,0.01,10,0.4,4.4,4,6,4,0,0
0,1,0,0,1,1,1,7.74,1.5,17.41,0.0,5,0.67,0.97,2,3,2,0,0
0,1,0,0,1,1,1,7.75,2.0,31.02,0.01,6,0.5,1.72,2,4,2,0,0
0,1,0,0,1,1,1,7.75,2.0,31.02,0.01,6,0.5,1.72,2,4,2,0,0
0,1,0,0,1,1,1,7.75,2.0,31.02,0.01,6,0.5,1.72,2,4,2,0,0
0,1,0,0,1,1,1,7.75,2.0,31.02,0.01,6,0.5,1.72,2,4,2,0,0
2,1,0,0,1,1,1,7.81,9.0,632.78,0.02,19,0.11,35.15,8,11,4,2,0
0,1,0,0,1,1,1,7.75,2.0,31.02,0.01,6,0.5,1.72,2,4,2,0,0
0,1,0,0,1,1,1,7.75,2.0,31.02,0.01,6,0.5,1.72,2,4,2,0,0
0,1,0,0,1,1,1,7.75,2.0,31.02,0.01,6,0.5,1.72,2,4,2,0,0
0,1,0,0,1,1,1,7.75,2.0,31.02,0.01,6,0.5,1.72,2,4,2,0,0
0,3,0,0,2,1,1,7.75,2.0,31.02,0.01,6,0.5,1.72,2,4,2,0,0
0,1,0,0,1,1,1,5.8,2.0,23.22,0.0,5,0.5,1.29,1,4,1,0,0
0,3,0,0,2,1,1,7.75,2.0,31.02,0.01,6,0.5,1.72,2,4,2,0,0
0,1,0,0,1,1,1,12.18,3.0,109.62,0.01,11,0.33,6.09,4,7,4,0,0
0,1,0,0,1,1,1,7.75,2.0,31.02,0.01,6,0.5,1.72,2,4,2,0,0
0,1,0,0,1,1,1,7.75,2.0,31.02,0.01,6,0.5,1.72,2,4,2,0,0
0,1,0,0,1,1,1,7.75,2.0,31.02,0.01,6,0.5,1.72,2,4,2,0,0
0,1,0,0,1,1,1,5.8,2.0,23.22,0.0,5,0.5,1.29,1,4,1,0,0
0,1,0,0,1,1,1,7.75,2.0,31.02,0.01,6,0.5,1.72,2,4,2,0,0
2,1,0,0,1,1,1,8.98,2.5,56.15,0.01,8,0.4,3.12,2,6,2,2,0
2,1,0,0,1,1,1,5.33,1.5,12.0,0.0,4,0.67,0.67,1,3,1,2,0
0,1,0,0,1,1,1,5.33,1.5,12.0,0.0,4,0.67,0.67,1,3,1,0,0
2,1,0,0,1,1,1,5.33,1.5,12.0,0.0,4,0.67,0.67,1,3,1,2,0
2,1,0,0,1,1,1,5.33,1.5,12.0,0.0,4,0.67,0.67,1,3,1,2,0
3,1,0,0,1,1,1,12.0,2.5,75.0,0.01,10,0.4,4.17,3,7,3,3,0
0,1,0,0,1,1,1,7.86,2.5,49.13,0.01,7,0.4,2.73,2,5,2,0,0
0,1,0,0,1,1,1,6.55,3.0,58.95,0.01,7,0.33,3.28,1,6,1,0,0
0,1,0,0,1,1,1,6.55,3.0,58.95,0.01,7,0.33,3.28,1,6,1,0,0
2,1,0,0,1,1,1,8.98,2.5,56.15,0.01,8,0.4,3.12,2,6,2,2,0
2,1,0,0,1,1,1,5.33,1.5,12.0,0.0,4,0.67,0.67,1,3,1,2,0
0,1,0,0,1,1,1,5.33,1.5,12.0,0.0,4,0.67,0.67,1,3,1,0,0
2,1,0,0,1,1,1,5.33,1.5,12.0,0.0,4,0.67,0.67,1,3,1,2,0
2,1,0,0,1,1,1,5.33,1.5,12.0,0.0,4,0.67,0.67,1,3,1,2,0
0,1,0,0,1,1,1,5.33,1.5,12.0,0.0,4,0.67,0.67,1,3,1,0,0
0,1,0,0,1,1,1,5.33,1.5,12.0,0.0,4,0.67,0.67,1,3,1,0,0
0,1,0,0,1,1,1,7.75,2.0,31.02,0.01,6,0.5,1.72,2,4,2,0,0
0,1,0,0,1,1,1,9.0,3.0,81.0,0.01,9,0.33,4.5,2,7,2,0,0
0,1,0,0,1,1,1,8.3,6.0,298.97,0.02,15,0.17,16.61,3,12,2,0,0
0,1,0,0,1,1,1,9.51,3.0,85.59,0.01,9,0.33,4.75,3,6,3,0,0
0,1,0,0,1,1,1,9.51,3.0,85.59,0.01,9,0.33,4.75,3,6,3,0,0
0,1,0,0,1,1,1,9.51,3.0,85.59,0.01,9,0.33,4.75,3,6,3,0,0
0,1,0,0,1,1,1,9.51,3.0,85.59,0.01,9,0.33,4.75,3,6,3,0,0
4,3,0,0,2,2,1,13.67,6.0,492.27,0.03,21,0.17,27.35,6,15,5,4,0
0,1,0,0,1,1,1,9.83,2.0,39.3,0.01,7,0.5,2.18,3,4,3,0,0
0,1,0,0,1,1,1,0.0,0.0,0.0,0.0,1,0.0,0.0,0,1,0,0,0
0,1,0,0,1,1,1,5.33,1.5,12.0,0.0,4,0.67,0.67,1,3,1,0,0
4,3,0,0,2,1,1,11.52,3.75,161.94,0.01,13,0.27,9.0,5,8,4,4,0
0,1,0,0,1,1,1,0.0,0.0,0.0,0.0,1,0.0,0.0,0,1,0,0,0
4,1,0,0,1,1,1,10.24,7.0,501.89,0.02,20,0.14,27.88,7,13,4,4,0
4,3,0,0,2,2,1,21.5,7.15,1099.18,0.05,35,0.14,61.07,13,22,10,4,0
8,3,0,0,2,2,1,23.46,10.29,2485.24,0.08,52,0.1,138.07,19,33,12,8,0
54,13,1,8,7,6,6,25.11,40.0,40181.42,0.33,184,0.03,2232.3,80,104,22,55,0
0,1,0,0,1,1,1,8.3,6.67,369.01,0.02,16,0.15,20.5,5,11,3,0,0
23,5,0,1,3,2,1,19.78,20.04,7940.87,0.13,80,0.05,441.16,33,47,14,23,0
0,1,0,0,1,1,1,8.6,7.5,483.97,0.02,18,0.13,26.89,5,13,3,0,0
19,5,0,3,3,3,1,19.07,10.91,2270.01,0.07,46,0.09,126.11,20,26,11,19,0
12,3,0,2,2,2,1,14.73,8.94,1176.94,0.04,31,0.11,65.39,13,18,8,12,0
12,9,0,0,5,3,3,17.46,16.55,4779.2,0.1,63,0.06,265.51,28,35,11,12,0
4,1,0,0,1,1,1,9.47,2.67,67.38,0.01,9,0.38,3.74,4,5,3,4,0
13,5,0,0,3,3,1,16.4,7.07,820.29,0.04,29,0.14,45.57,11,18,7,13,0
13,5,0,0,3,3,1,17.24,7.5,969.51,0.04,31,0.13,53.86,12,19,8,13,0
4,3,0,0,2,2,1,11.99,6.67,533.03,0.03,21,0.15,29.61,10,11,6,4,0
0,1,0,0,1,1,1,6.55,3.0,58.95,0.01,7,0.33,3.28,1,6,1,0,0
0,3,0,0,2,2,1,6.69,7.5,376.42,0.02,14,0.13,20.91,5,9,3,0,0
0,1,0,0,1,1,1,7.86,2.5,49.13,0.01,7,0.4,2.73,2,5,2,0,0
0,3,0,0,2,2,1,9.32,5.0,233.02,0.02,13,0.2,12.95,5,8,4,0,0
6,1,0,0,1,1,1,17.51,5.0,437.85,0.03,23,0.2,24.32,10,13,7,6,0
0,3,0,0,2,2,1,7.75,2.0,31.02,0.01,6,0.5,1.72,2,4,2,0,0
0,3,0,0,2,2,1,7.86,2.5,49.13,0.01,7,0.4,2.73,2,5,2,0,0
11,7,0,0,4,2,3,12.35,16.0,3162.47,0.07,45,0.06,175.69,16,29,7,11,0
3,3,0,0,2,2,1,14.28,4.0,228.44,0.02,15,0.25,12.69,6,9,6,3,0
0,1,0,0,1,1,1,0.0,0.0,0.0,0.0,1,0.0,0.0,0,1,0,0,0
2,1,0,0,1,1,1,13.5,2.0,54.0,0.01,9,0.5,3.0,4,5,4,2,0
0,1,0,0,1,1,1,7.75,2.0,31.02,0.01,6,0.5,1.72,2,4,2,0,0
0,1,0,0,1,1,1,7.75,2.0,31.02,0.01,6,0.5,1.72,2,4,2,0,0
0,1,0,0,1,1,1,7.75,2.0,31.02,0.01,6,0.5,1.72,2,4,2,0,0
0,1,0,0,1,1,1,7.74,1.5,17.41,0.0,5,0.67,0.97,2,3,2,0,0
1,1,0,0,1,1,1,7.74,1.5,17.41,0.0,5,0.67,0.97,2,3,2,1,0
0,1,0,0,1,1,1,5.8,2.0,23.22,0.0,5,0.5,1.29,1,4,1,0,0
2,1,0,0,1,1,1,7.75,2.0,31.02,0.01,6,0.5,1.72,2,4,2,2,0
1,1,0,1,1,1,1,0.0,0.0,0.0,0.0,1,0.0,0.0,0,1,0,1,0
2,1,0,0,1,1,1,7.75,2.0,31.02,0.01,6,0.5,1.72,2,4,2,2,0
0,1,0,0,1,1,1,9.31,2.5,58.16,0.01,9,0.4,3.23,1,8,1,0,0
0,1,0,0,1,1,1,7.75,2.0,31.02,0.01,6,0.5,1.72,2,4,2,0,0
0,1,0,0,1,1,1,10.68,4.67,232.53,0.02,15,0.21,12.92,4,11,3,0,0
7,5,0,0,3,2,1,11.89,13.13,2048.55,0.05,35,0.08,113.81,15,20,8,7,0
5,3,0,0,2,2,1,17.22,4.08,287.09,0.02,19,0.24,15.95,7,12,6,5,0
4,3,0,0,2,2,1,11.18,5.63,353.85,0.02,17,0.18,19.66,5,12,4,4,0
0,1,0,0,1,1,1,0.0,0.0,0.0,0.0,0,0.0,0.0,0,0,0,0,0
0,1,0,0,1,1,1,6.2,2.5,38.77,0.01,6,0.4,2.15,1,5,1,0,0
0,1,0,0,1,1,1,11.86,3.5,145.3,0.01,12,0.29,8.07,4,8,4,0,0
0,1,0,0,1,1,1,0.0,0.0,0.0,0.0,0,0.0,0.0,0,0,0,0,0
0,1,0,0,1,1,1,0.0,0.0,0.0,0.0,0,0.0,0.0,0,0,0,0,0
0,1,0,0,1,1,1,0.0,0.0,0.0,0.0,0,0.0,0.0,0,0,0,0,0
0,1,0,0,1,1,1,7.33,4.5,148.5,0.01,11,0.22,8.25,3,8,2,0,0
8,3,0,0,2,1,1,15.07,9.75,1432.72,0.05,34,0.1,79.6,13,21,8,8,0
0,1,0,0,1,1,1,9.6,2.5,60.0,0.01,8,0.4,3.33,3,5,3,0,0
0,1,0,0,1,1,1,7.75,2.0,31.02,0.01,6,0.5,1.72,2,4,2,0,0
0,1,0,0,1,1,1,6.86,3.5,84.0,0.01,8,0.29,4.67,1,7,1,0,0
0,1,0,0,1,1,1,7.75,2.0,31.02,0.01,6,0.5,1.72,2,4,2,0,0
0,1,0,0,1,1,1,8.3,6.0,298.97,0.02,15,0.17,16.61,3,12,2,0,0
0,1,0,0,1,1,1,8.3,6.0,298.97,0.02,15,0.17,16.61,3,12,2,0,0
0,1,0,0,1,1,1,8.3,6.0,298.97,0.02,15,0.17,16.61,3,12,2,0,0
3,1,0,0,1,1,1,9.51,3.0,85.59,0.01,9,0.33,4.75,3,6,3,3,0
5,3,0,0,2,2,1,15.36,3.5,188.21,0.02,15,0.29,10.46,5,10,5,5,0
4,3,0,0,2,2,1,10.88,5.6,341.29,0.02,17,0.18,18.96,8,9,5,4,0
0,1,0,0,1,1,1,7.74,1.5,17.41,0.0,5,0.67,0.97,2,3,2,0,0
0,1,0,0,1,1,1,12.68,2.5,79.25,0.01,10,0.4,4.4,4,6,4,0,0
0,1,0,0,1,1,1,7.74,1.5,17.41,0.0,5,0.67,0.97,2,3,2,0,0
0,1,0,0,1,1,1,7.75,2.0,31.02,0.01,6,0.5,1.72,2,4,2,0,0
0,1,0,0,1,1,1,7.75,2.0,31.02,0.01,6,0.5,1.72,2,4,2,0,0
0,1,0,0,1,1,1,7.75,2.0,31.02,0.01,6,0.5,1.72,2,4,2,0,0
0,1,0,0,1,1,1,7.75,2.0,31.02,0.01,6,0.5,1.72,2,4,2,0,0
0,1,0,0,1,1,1,7.75,2.0,31.02,0.01,6,0.5,1.72,2,4,2,0,0
0,1,0,0,1,1,1,7.75,2.0,31.02,0.01,6,0.5,1.72,2,4,2,0,0
0,1,0,0,1,1,1,7.75,2.0,31.02,0.01,6,0.5,1.72,2,4,2,0,0
0,1,0,0,1,1,1,7.75,2.0,31.02,0.01,6,0.5,1.72,2,4,2,0,0
0,3,0,0,2,1,1,7.75,2.0,31.02,0.01,6,0.5,1.72,2,4,2,0,0
0,1,0,0,1,1,1,5.8,2.0,23.22,0.0,5,0.5,1.29,1,4,1,0,0
0,3,0,0,2,1,1,7.75,2.0,31.02,0.01,6,0.5,1.72,2,4,2,0,0
0,1,0,0,1,1,1,12.18,3.0,109.62,0.01,11,0.33,6.09,4,7,4,0,0
0,1,0,0,1,1,1,7.75,2.0,31.02,0.01,6,0.5,1.72,2,4,2,0,0
0,1,0,0,1,1,1,7.75,2.0,31.02,0.01,6,0.5,1.72,2,4,2,0,0
0,1,0,0,1,1,1,7.75,2.0,31.02,0.01,6,0.5,1.72,2,4,2,0,0
0,1,0,0,1,1,1,5.8,2.0,23.22,0.0,5,0.5,1.29,1,4,1,0,0
0,1,0,0,1,1,1,7.75,2.0,31.02,0.01,6,0.5,1.72,2,4,2,0,0
2,1,0,0,1,1,1,8.98,2.5,56.15,0.01,8,0.4,3.12,2,6,2,2,0
2,1,0,0,1,1,1,5.33,1.5,12.0,0.0,4,0.67,0.67,1,3,1,2,0
0,1,0,0,1,1,1,5.33,1.5,12.0,0.0,4,0.67,0.67,1,3,1,0,0
2,1,0,0,1,1,1,5.33,1.5,12.0,0.0,4,0.67,0.67,1,3,1,2,0
2,1,0,0,1,1,1,5.33,1.5,12.0,0.0,4,0.67,0.67,1,3,1,2,0
3,1,0,0,1,1,1,12.0,2.5,75.0,0.01,10,0.4,4.17,3,7,3,3,0
0,1,0,0,1,1,1,7.86,2.5,49.13,0.01,7,0.4,2.73,2,5,2,0,0
0,1,0,0,1,1,1,6.55,3.0,58.95,0.01,7,0.33,3.28,1,6,1,0,0
0,1,0,0,1,1,1,6.55,3.0,58.95,0.01,7,0.33,3.28,1,6,1,0,0
2,1,0,0,1,1,1,8.98,2.5,56.15,0.01,8,0.4,3.12,2,6,2,2,0
2,1,0,0,1,1,1,5.33,1.5,12.0,0.0,4,0.67,0.67,1,3,1,2,0
0,1,0,0,1,1,1,5.33,1.5,12.0,0.0,4,0.67,0.67,1,3,1,0,0
2,1,0,0,1,1,1,5.33,1.5,12.0,0.0,4,0.67,0.67,1,3,1,2,0
2,1,0,0,1,1,1,5.33,1.5,12.0,0.0,4,0.67,0.67,1,3,1,2,0
0,1,0,0,1,1,1,5.33,1.5,12.0,0.0,4,0.67,0.67,1,3,1,0,0
0,1,0,0,1,1,1,5.33,1.5,12.0,0.0,4,0.67,0.67,1,3,1,0,0
0,1,0,0,1,1,1,7.75,2.0,31.02,0.01,6,0.5,1.72,2,4,2,0,0
0,1,0,0,1,1,1,9.0,3.0,81.0,0.01,9,0.33,4.5,2,7,2,0,0
0,1,0,0,1,1,1,8.3,6.0,298.97,0.02,15,0.17,16.61,3,12,2,0,0
0,1,0,0,1,1,1,9.51,3.0,85.59,0.01,9,0.33,4.75,3,6,3,0,0
0,1,0,0,1,1,1,9.51,3.0,85.59,0.01,9,0.33,4.75,3,6,3,0,0
0,1,0,0,1,1,1,9.51,3.0,85.59,0.01,9,0.33,4.75,3,6,3,0,0
0,1,0,0,1,1,1,9.51,3.0,85.59,0.01,9,0.33,4.75,3,6,3,0,0
4,3,0,0,2,2,1,13.67,6.0,492.27,0.03,21,0.17,27.35,6,15,5,4,0
0,1,0,0,1,1,1,5.33,1.5,12.0,0.0,4,0.67,0.67,1,3,1,0,0
0,1,0,0,1,1,1,5.33,1.5,12.0,0.0,4,0.67,0.67,1,3,1,0,0
0,1,0,0,1,1,1,5.33,1.5,12.0,0.0,4,0.67,0.67,1,3,1,0,0
0,1,0,0,1,1,1,5.33,1.5,12.0,0.0,4,0.67,0.67,1,3,1,0,0
0,1,0,0,1,1,1,7.86,2.5,49.13,0.01,7,0.4,2.73,2,5,2,0,0
0,1,0,0,1,1,1,7.86,2.5,49.13,0.01,7,0.4,2.73,2,5,2,0,0
0,1,0,0,1,1,1,0.0,0.0,0.0,0.0,0,0.0,0.0,0,0,0,0,0
11,5,1,0,3,3,1,28.47,5.6,892.7,0.05,39,0.18,49.59,16,23,10,12,0
0,1,0,0,1,1,1,5.33,1.5,12.0,0.0,4,0.67,0.67,1,3,1,0,0
12,1,2,2,1,1,1,71.33,5.02,1798.8,0.12,73,0.2,99.93,33,40,23,14,0
2,1,0,0,1,1,1,7.35,8.0,470.48,0.02,17,0.13,26.14,6,11,3,2,0
2,1,0,0,1,1,1,7.81,9.0,632.78,0.02,19,0.11,35.15,8,11,4,2,0
0,1,0,0,1,1,1,5.33,1.5,12.0,0.0,4,0.67,0.67,1,3,1,0,0
0,1,0,0,1,1,1,5.33,1.5,12.0,0.0,4,0.67,0.67,1,3,1,0,0
0,1,0,0,1,1,1,5.33,1.5,12.0,0.0,4,0.67,0.67,1,3,1,0,0
0,1,0,0,1,1,1,5.33,1.5,12.0,0.0,4,0.67,0.67,1,3,1,0,0
0,1,0,0,1,1,1,5.33,1.5,12.0,0.0,4,0.67,0.67,1,3,1,0,0
0,1,0,0,1,1,1,7.74,1.5,17.41,0.0,5,0.67,0.97,2,3,2,0,0
0,1,0,0,1,1,1,5.33,1.5,12.0,0.0,4,0.67,0.67,1,3,1,0,0
2,1,0,0,1,1,1,7.35,8.0,470.48,0.02,17,0.13,26.14,6,11,3,2,0
2,1,0,0,1,1,1,7.81,9.0,632.78,0.02,19,0.11,35.15,8,11,4,2,0
0,1,0,0,1,1,1,5.33,1.5,12.0,0.0,4,0.67,0.67,1,3,1,0,0
0,1,0,0,1,1,1,5.33,1.5,12.0,0.0,4,0.67,0.67,1,3,1,0,0
0,1,0,0,1,1,1,5.33,1.5,12.0,0.0,4,0.67,0.67,1,3,1,0,0
0,1,0,0,1,1,1,5.33,1.5,12.0,0.0,4,0.67,0.67,1,3,1,0,0
0,1,0,0,1,1,1,5.33,1.5,12.0,0.0,4,0.67,0.67,1,3,1,0,0
0,1,0,0,1,1,1,7.74,1.5,17.41,0.0,5,0.67,0.97,2,3,2,0,0
4,1,0,0,1,1,1,10.24,7.0,501.89,0.02,20,0.14,27.88,7,13,4,4,0
4,3,0,0,2,2,1,21.5,7.15,1099.18,0.05,35,0.14,61.07,13,22,10,4,0
8,3,0,0,2,2,1,23.46,10.29,2485.24,0.08,52,0.1,138.07,19,33,12,8,0
54,13,1,8,7,6,6,25.11,40.0,40181.42,0.33,184,0.03,2232.3,80,104,22,55,0
0,1,0,0,1,1,1,8.3,6.67,369.01,0.02,16,0.15,20.5,5,11,3,0,0
23,5,0,1,3,2,1,19.78,20.04,7940.87,0.13,80,0.05,441.16,33,47,14,23,0
0,1,0,0,1,1,1,8.6,7.5,483.97,0.02,18,0.13,26.89,5,13,3,0,0
19,5,0,3,3,3,1,19.07,10.91,2270.01,0.07,46,0.09,126.11,20,26,11,19,0
12,3,0,2,2,2,1,14.73,8.94,1176.94,0.04,31,0.11,65.39,13,18,8,12,0
12,9,0,0,5,3,3,17.46,16.55,4779.2,0.1,63,0.06,265.51,28,35,11,12,0
4,1,0,0,1,1,1,9.47,2.67,67.38,0.01,9,0.38,3.74,4,5,3,4,0
13,5,0,0,3,3,1,16.4,7.07,820.29,0.04,29,0.14,45.57,11,18,7,13,0
13,5,0,0,3,3,1,17.24,7.5,969.51,0.04,31,0.13,53.86,12,19,8,13,0
4,3,0,0,2,2,1,11.99,6.67,533.03,0.03,21,0.15,29.61,10,11,6,4,0
0,1,0,0,1,1,1,6.55,3.0,58.95,0.01,7,0.33,3.28,1,6,1,0,0
0,3,0,0,2,2,1,6.69,7.5,376.42,0.02,14,0.13,20.91,5,9,3,0,0
0,1,0,0,1,1,1,7.86,2.5,49.13,0.01,7,0.4,2.73,2,5,2,0,0
0,3,0,0,2,2,1,9.32,5.0,233.02,0.02,13,0.2,12.95,5,8,4,0,0
6,1,0,0,1,1,1,17.51,5.0,437.85,0.03,23,0.2,24.32,10,13,7,6,0
0,3,0,0,2,2,1,7.75,2.0,31.02,0.01,6,0.5,1.72,2,4,2,0,0
0,3,0,0,2,2,1,7.86,2.5,49.13,0.01,7,0.4,2.73,2,5,2,0,0
11,7,0,0,4,2,3,12.35,16.0,3162.47,0.07,45,0.06,175.69,16,29,7,11,0
3,3,0,0,2,2,1,14.28,4.0,228.44,0.02,15,0.25,12.69,6,9,6,3,0
0,1,0,0,1,1,1,0.0,0.0,0.0,0.0,1,0.0,0.0,0,1,0,0,0
2,1,0,0,1,1,1,13.5,2.0,54.0,0.01,9,0.5,3.0,4,5,4,2,0
0,1,0,0,1,1,1,7.75,2.0,31.02,0.01,6,0.5,1.72,2,4,2,0,0
0,1,0,0,1,1,1,7.75,2.0,31.02,0.01,6,0.5,1.72,2,4,2,0,0
0,1,0,0,1,1,1,7.75,2.0,31.02,0.01,6,0.5,1.72,2,4,2,0,0
0,1,0,0,1,1,1,7.74,1.5,17.41,0.0,5,0.67,0.97,2,3,2,0,0
1,1,0,0,1,1,1,7.74,1.5,17.41,0.0,5,0.67,0.97,2,3,2,1,0
0,1,0,0,1,1,1,5.8,2.0,23.22,0.0,5,0.5,1.29,1,4,1,0,0
2,1,0,0,1,1,1,7.75,2.0,31.02,0.01,6,0.5,1.72,2,4,2,2,0
1,1,0,1,1,1,1,0.0,0.0,0.0,0.0,1,0.0,0.0,0,1,0,1,0
2,1,0,0,1,1,1,7.75,2.0,31.02,0.01,6,0.5,1.72,2,4,2,2,0
0,1,0,0,1,1,1,9.31,2.5,58.16,0.01,9,0.4,3.23,1,8,1,0,0
0,1,0,0,1,1,1,7.75,2.0,31.02,0.01,6,0.5,1.72,2,4,2,0,0
0,1,0,0,1,1,1,10.68,4.67,232.53,0.02,15,0.21,12.92,4,11,3,0,0
7,5,0,0,3,2,1,11.89,13.13,2048.55,0.05,35,0.08,113.81,15,20,8,7,0
5,3,0,0,2,2,1,17.22,4.08,287.09,0.02,19,0.24,15.95,7,12,6,5,0
4,3,0,0,2,2,1,11.18,5.63,353.85,0.02,17,0.18,19.66,5,12,4,4,0
0,1,0,0,1,1,1,0.0,0.0,0.0,0.0,0,0.0,0.0,0,0,0,0,0
0,1,0,0,1,1,1,6.2,2.5,38.77,0.01,6,0.4,2.15,1,5,1,0,0
0,1,0,0,1,1,1,11.86,3.5,145.3,0.01,12,0.29,8.07,4,8,4,0,0
0,1,0,0,1,1,1,0.0,0.0,0.0,0.0,0,0.0,0.0,0,0,0,0,0
0,1,0,0,1,1,1,0.0,0.0,0.0,0.0,0,0.0,0.0,0,0,0,0,0
0,1,0,0,1,1,1,0.0,0.0,0.0,0.0,0,0.0,0.0,0,0,0,0,0
0,1,0,0,1,1,1,7.33,4.5,148.5,0.01,11,0.22,8.25,3,8,2,0,0
8,3,0,0,2,1,1,15.07,9.75,1432.72,0.05,34,0.1,79.6,13,21,8,8,0
0,1,0,0,1,1,1,9.6,2.5,60.0,0.01,8,0.4,3.33,3,5,3,0,0
0,1,0,0,1,1,1,7.75,2.0,31.02,0.01,6,0.5,1.72,2,4,2,0,0
0,1,0,0,1,1,1,6.86,3.5,84.0,0.01,8,0.29,4.67,1,7,1,0,0
0,1,0,0,1,1,1,7.75,2.0,31.02,0.01,6,0.5,1.72,2,4,2,0,0
0,1,0,0,1,1,1,8.3,6.0,298.97,0.02,15,0.17,16.61,3,12,2,0,0
0,1,0,0,1,1,1,8.3,6.0,298.97,0.02,15,0.17,16.61,3,12,2,0,0
0,1,0,0,1,1,1,8.3,6.0,298.97,0.02,15,0.17,16.61,3,12,2,0,0
3,1,0,0,1,1,1,9.51,3.0,85.59,0.01,9,0.33,4.75,3,6,3,3,0
5,3,0,0,2,2,1,15.36,3.5,188.21,0.02,15,0.29,10.46,5,10,5,5,0
4,3,0,0,2,2,1,10.88,5.6,341.29,0.02,17,0.18,18.96,8,9,5,4,0
0,1,0,0,1,1,1,7.74,1.5,17.41,0.0,5,0.67,0.97,2,3,2,0,0
0,1,0,0,1,1,1,12.68,2.5,79.25,0.01,10,0.4,4.4,4,6,4,0,0
0,1,0,0,1,1,1,7.74,1.5,17.41,0.0,5,0.67,0.97,2,3,2,0,0
0,1,0,0,1,1,1,7.75,2.0,31.02,0.01,6,0.5,1.72,2,4,2,0,0
0,1,0,0,1,1,1,7.75,2.0,31.02,0.01,6,0.5,1.72,2,4,2,0,0
0,1,0,0,1,1,1,7.75,2.0,31.02,0.01,6,0.5,1.72,2,4,2,0,0
0,1,0,0,1,1,1,7.75,2.0,31.02,0.01,6,0.5,1.72,2,4,2,0,0
0,1,0,0,1,1,1,7.75,2.0,31.02,0.01,6,0.5,1.72,2,4,2,0,0
0,1,0,0,1,1,1,7.75,2.0,31.02,0.01,6,0.5,1.72,2,4,2,0,0
0,1,0,0,1,1,1,7.75,2.0,31.02,0.01,6,0.5,1.72,2,4,2,0,0
0,1,0,0,1,1,1,7.75,2.0,31.02,0.01,6,0.5,1.72,2,4,2,0,0
0,3,0,0,2,1,1,7.75,2.0,31.02,0.01,6,0.5,1.72,2,4,2,0,0
0,1,0,0,1,1,1,5.8,2.0,23.22,0.0,5,0.5,1.29,1,4,1,0,0
0,3,0,0,2,1,1,7.75,2.0,31.02,0.01,6,0.5,1.72,2,4,2,0,0
0,1,0,0,1,1,1,12.18,3.0,109.62,0.01,11,0.33,6.09,4,7,4,0,0
0,1,0,0,1,1,1,7.75,2.0,31.02,0.01,6,0.5,1.72,2,4,2,0,0
0,1,0,0,1,1,1,7.75,2.0,31.02,0.01,6,0.5,1.72,2,4,2,0,0
0,1,0,0,1,1,1,7.75,2.0,31.02,0.01,6,0.5,1.72,2,4,2,0,0
0,1,0,0,1,1,1,5.8,2.0,23.22,0.0,5,0.5,1.29,1,4,1,0,0
0,1,0,0,1,1,1,7.75,2.0,31.02,0.01,6,0.5,1.72,2,4,2,0,0
2,1,0,0,1,1,1,8.98,2.5,56.15,0.01,8,0.4,3.12,2,6,2,2,0
2,1,0,0,1,1,1,5.33,1.5,12.0,0.0,4,0.67,0.67,1,3,1,2,0
0,1,0,0,1,1,1,5.33,1.5,12.0,0.0,4,0.67,0.67,1,3,1,0,0
2,1,0,0,1,1,1,5.33,1.5,12.0,0.0,4,0.67,0.67,1,3,1,2,0
2,1,0,0,1,1,1,5.33,1.5,12.0,0.0,4,0.67,0.67,1,3,1,2,0
3,1,0,0,1,1,1,12.0,2.5,75.0,0.01,10,0.4,4.17,3,7,3,3,0
0,1,0,0,1,1,1,7.86,2.5,49.13,0.01,7,0.4,2.73,2,5,2,0,0
0,1,0,0,1,1,1,6.55,3.0,58.95,0.01,7,0.33,3.28,1,6,1,0,0
0,1,0,0,1,1,1,6.55,3.0,58.95,0.01,7,0.33,3.28,1,6,1,0,0
2,1,0,0,1,1,1,8.98,2.5,56.15,0.01,8,0.4,3.12,2,6,2,2,0
2,1,0,0,1,1,1,5.33,1.5,12.0,0.0,4,0.67,0.67,1,3,1,2,0
0,1,0,0,1,1,1,5.33,1.5,12.0,0.0,4,0.67,0.67,1,3,1,0,0
2,1,0,0,1,1,1,5.33,1.5,12.0,0.0,4,0.67,0.67,1,3,1,2,0
2,1,0,0,1,1,1,5.33,1.5,12.0,0.0,4,0.67,0.67,1,3,1,2,0
0,1,0,0,1,1,1,5.33,1.5,12.0,0.0,4,0.67,0.67,1,3,1,0,0
0,1,0,0,1,1,1,5.33,1.5,12.0,0.0,4,0.67,0.67,1,3,1,0,0
0,1,0,0,1,1,1,7.75,2.0,31.02,0.01,6,0.5,1.72,2,4,2,0,0
0,1,0,0,1,1,1,9.0,3.0,81.0,0.01,9,0.33,4.5,2,7,2,0,0
0,1,0,0,1,1,1,8.3,6.0,298.97,0.02,15,0.17,16.61,3,12,2,0,0
0,1,0,0,1,1,1,9.51,3.0,85.59,0.01,9,0.33,4.75,3,6,3,0,0
0,1,0,0,1,1,1,9.51,3.0,85.59,0.01,9,0.33,4.75,3,6,3,0,0
0,1,0,0,1,1,1,9.51,3.0,85.59,0.01,9,0.33,4.75,3,6,3,0,0
0,1,0,0,1,1,1,9.51,3.0,85.59,0.01,9,0.33,4.75,3,6,3,0,0
4,3,0,0,2,2,1,13.67,6.0,492.27,0.03,21,0.17,27.35,6,15,5,4,0
1,1,0,0,1,1,1,0.0,0.0,0.0,0.0,1,0.0,0.0,0,1,0,1,0
0,1,0,0,1,1,1,18.0,1.5,40.5,0.01,9,0.67,2.25,5,4,5,0,0
2,1,0,0,1,1,1,13.93,1.0,13.93,0.0,6,1.0,0.77,3,3,3,2,0
0,1,0,0,1,1,1,5.8,2.0,23.22,0.0,5,0.5,1.29,1,4,1,0,0
0,1,0,0,1,1,1,5.8,2.0,23.22,0.0,5,0.5,1.29,1,4,1,0,0
1,1,1,0,1,1,1,4.75,1.0,4.75,0.0,3,1.0,0.26,1,2,1,2,0
0,1,0,0,1,1,1,5.33,1.5,12.0,0.0,4,0.67,0.67,1,3,1,0,0
0,1,0,0,1,1,1,5.33,1.5,12.0,0.0,4,0.67,0.67,1,3,1,0,0
0,1,0,0,1,1,1,5.33,1.5,12.0,0.0,4,0.67,0.67,1,3,1,0,0
4,3,0,0,2,1,1,11.52,3.75,161.94,0.01,13,0.27,9.0,5,8,4,4,0
0,1,0,0,1,1,1,5.33,1.5,12.0,0.0,4,0.67,0.67,1,3,1,0,0
0,1,0,0,1,1,1,5.8,2.0,23.22,0.0,5,0.5,1.29,1,4,1,0,0
30,1,0,6,1,1,1,118.82,9.29,10262.23,0.37,191,0.11,570.12,95,96,46,30,0
0,1,0,0,1,1,1,0.0,0.0,0.0,0.0,1,0.0,0.0,0,1,0,0,0
2,1,0,1,1,1,1,5.33,1.5,12.0,0.0,4,0.67,0.67,1,3,1,2,0
18,3,0,7,1,1,1,49.61,12.63,7915.95,0.21,129,0.08,439.78,48,81,19,18,0
6,3,0,3,2,1,1,17.41,3.5,213.21,0.02,16,0.29,11.85,7,9,7,6,0
0,1,0,0,1,1,1,5.33,1.5,12.0,0.0,4,0.67,0.67,1,3,1,0,0
0,1,0,0,1,1,1,5.33,1.5,12.0,0.0,4,0.67,0.67,1,3,1,0,0
0,1,0,0,1,1,1,18.0,1.5,40.5,0.01,9,0.67,2.25,5,4,5,0,0
0,1,0,0,1,1,1,5.8,2.0,23.22,0.0,5,0.5,1.29,1,4,1,0,0
0,1,0,0,1,1,1,5.8,2.0,23.22,0.0,5,0.5,1.29,1,4,1,0,0
1,1,1,0,1,1,1,4.75,1.0,4.75,0.0,3,1.0,0.26,1,2,1,2,0
0,1,0,0,1,1,1,5.33,1.5,12.0,0.0,4,0.67,0.67,1,3,1,0,0
0,1,0,0,1,1,1,5.33,1.5,12.0,0.0,4,0.67,0.67,1,3,1,0,0
0,1,0,0,1,1,1,5.33,1.5,12.0,0.0,4,0.67,0.67,1,3,1,0,0
4,3,0,0,2,1,1,11.52,3.75,161.94,0.01,13,0.27,9.0,5,8,4,4,0
0,1,0,0,1,1,1,5.33,1.5,12.0,0.0,4,0.67,0.67,1,3,1,0,0
0,1,0,0,1,1,1,5.8,2.0,23.22,0.0,5,0.5,1.29,1,4,1,0,0
0,1,0,0,1,1,1,0.0,0.0,0.0,0.0,1,0.0,0.0,0,1,0,0,0
4,1,0,0,1,1,1,10.24,7.0,501.89,0.02,20,0.14,27.88,7,13,4,4,0
4,3,0,0,2,2,1,21.5,7.15,1099.18,0.05,35,0.14,61.07,13,22,10,4,0
8,3,0,0,2,2,1,23.46,10.29,2485.24,0.08,52,0.1,138.07,19,33,12,8,0
54,13,1,8,7,6,6,25.11,40.0,40181.42,0.33,184,0.03,2232.3,80,104,22,55,0
0,1,0,0,1,1,1,8.3,6.67,369.01,0.02,16,0.15,20.5,5,11,3,0,0
23,5,0,1,3,2,1,19.78,20.04,7940.87,0.13,80,0.05,441.16,33,47,14,23,0
0,1,0,0,1,1,1,8.6,7.5,483.97,0.02,18,0.13,26.89,5,13,3,0,0
19,5,0,3,3,3,1,19.07,10.91,2270.01,0.07,46,0.09,126.11,20,26,11,19,0
12,3,0,2,2,2,1,14.73,8.94,1176.94,0.04,31,0.11,65.39,13,18,8,12,0
12,9,0,0,5,3,3,17.46,16.55,4779.2,0.1,63,0.06,265.51,28,35,11,12,0
4,1,0,0,1,1,1,9.47,2.67,67.38,0.01,9,0.38,3.74,4,5,3,4,0
13,5,0,0,3,3,1,16.4,7.07,820.29,0.04,29,0.14,45.57,11,18,7,13,0
13,5,0,0,3,3,1,17.24,7.5,969.51,0.04,31,0.13,53.86,12,19,8,13,0
4,3,0,0,2,2,1,11.99,6.67,533.03,0.03,21,0.15,29.61,10,11,6,4,0
0,1,0,0,1,1,1,6.55,3.0,58.95,0.01,7,0.33,3.28,1,6,1,0,0
0,3,0,0,2,2,1,6.69,7.5,376.42,0.02,14,0.13,20.91,5,9,3,0,0
0,1,0,0,1,1,1,7.86,2.5,49.13,0.01,7,0.4,2.73,2,5,2,0,0
0,3,0,0,2,2,1,9.32,5.0,233.02,0.02,13,0.2,12.95,5,8,4,0,0
6,1,0,0,1,1,1,17.51,5.0,437.85,0.03,23,0.2,24.32,10,13,7,6,0
0,3,0,0,2,2,1,7.75,2.0,31.02,0.01,6,0.5,1.72,2,4,2,0,0
0,3,0,0,2,2,1,7.86,2.5,49.13,0.01,7,0.4,2.73,2,5,2,0,0
11,7,0,0,4,2,3,12.35,16.0,3162.47,0.07,45,0.06,175.69,16,29,7,11,0
3,3,0,0,2,2,1,14.28,4.0,228.44,0.02,15,0.25,12.69,6,9,6,3,0
0,1,0,0,1,1,1,0.0,0.0,0.0,0.0,1,0.0,0.0,0,1,0,0,0
2,1,0,0,1,1,1,13.5,2.0,54.0,0.01,9,0.5,3.0,4,5,4,2,0
0,1,0,0,1,1,1,7.75,2.0,31.02,0.01,6,0.5,1.72,2,4,2,0,0
0,1,0,0,1,1,1,7.75,2.0,31.02,0.01,6,0.5,1.72,2,4,2,0,0
0,1,0,0,1,1,1,7.75,2.0,31.02,0.01,6,0.5,1.72,2,4,2,0,0
0,1,0,0,1,1,1,7.74,1.5,17.41,0.0,5,0.67,0.97,2,3,2,0,0
1,1,0,0,1,1,1,7.74,1.5,17.41,0.0,5,0.67,0.97,2,3,2,1,0
0,1,0,0,1,1,1,5.8,2.0,23.22,0.0,5,0.5,1.29,1,4,1,0,0
2,1,0,0,1,1,1,7.75,2.0,31.02,0.01,6,0.5,1.72,2,4,2,2,0
1,1,0,1,1,1,1,0.0,0.0,0.0,0.0,1,0.0,0.0,0,1,0,1,0
2,1,0,0,1,1,1,7.75,2.0,31.02,0.01,6,0.5,1.72,2,4,2,2,0
0,1,0,0,1,1,1,9.31,2.5,58.16,0.01,9,0.4,3.23,1,8,1,0,0
0,1,0,0,1,1,1,7.75,2.0,31.02,0.01,6,0.5,1.72,2,4,2,0,0
0,1,0,0,1,1,1,10.68,4.67,232.53,0.02,15,0.21,12.92,4,11,3,0,0
7,5,0,0,3,2,1,11.89,13.13,2048.55,0.05,35,0.08,113.81,15,20,8,7,0
5,3,0,0,2,2,1,17.22,4.08,287.09,0.02,19,0.24,15.95,7,12,6,5,0
4,3,0,0,2,2,1,11.18,5.63,353.85,0.02,17,0.18,19.66,5,12,4,4,0
0,1,0,0,1,1,1,0.0,0.0,0.0,0.0,0,0.0,0.0,0,0,0,0,0
0,1,0,0,1,1,1,6.2,2.5,38.77,0.01,6,0.4,2.15,1,5,1,0,0
0,1,0,0,1,1,1,11.86,3.5,145.3,0.01,12,0.29,8.07,4,8,4,0,0
0,1,0,0,1,1,1,0.0,0.0,0.0,0.0,0,0.0,0.0,0,0,0,0,0
0,1,0,0,1,1,1,0.0,0.0,0.0,0.0,0,0.0,0.0,0,0,0,0,0
0,1,0,0,1,1,1,0.0,0.0,0.0,0.0,0,0.0,0.0,0,0,0,0,0
0,1,0,0,1,1,1,7.33,4.5,148.5,0.01,11,0.22,8.25,3,8,2,0,0
8,3,0,0,2,1,1,15.07,9.75,1432.72,0.05,34,0.1,79.6,13,21,8,8,0
0,1,0,0,1,1,1,9.6,2.5,60.0,0.01,8,0.4,3.33,3,5,3,0,0
0,1,0,0,1,1,1,7.75,2.0,31.02,0.01,6,0.5,1.72,2,4,2,0,0
0,1,0,0,1,1,1,6.86,3.5,84.0,0.01,8,0.29,4.67,1,7,1,0,0
0,1,0,0,1,1,1,7.75,2.0,31.02,0.01,6,0.5,1.72,2,4,2,0,0
0,1,0,0,1,1,1,8.3,6.0,298.97,0.02,15,0.17,16.61,3,12,2,0,0
0,1,0,0,1,1,1,8.3,6.0,298.97,0.02,15,0.17,16.61,3,12,2,0,0
0,1,0,0,1,1,1,8.3,6.0,298.97,0.02,15,0.17,16.61,3,12,2,0,0
0,1,0,0,1,1,1,18.0,1.5,40.5,0.01,9,0.67,2.25,5,4,5,0,0
3,1,0,0,1,1,1,9.51,3.0,85.59,0.01,9,0.33,4.75,3,6,3,3,0
5,3,0,0,2,2,1,15.36,3.5,188.21,0.02,15,0.29,10.46,5,10,5,5,0
4,3,0,0,2,2,1,10.88,5.6,341.29,0.02,17,0.18,18.96,8,9,5,4,0
0,1,0,0,1,1,1,7.74,1.5,17.41,0.0,5,0.67,0.97,2,3,2,0,0
0,1,0,0,1,1,1,12.68,2.5,79.25,0.01,10,0.4,4.4,4,6,4,0,0
0,1,0,0,1,1,1,7.74,1.5,17.41,0.0,5,0.67,0.97,2,3,2,0,0
0,1,0,0,1,1,1,7.75,2.0,31.02,0.01,6,0.5,1.72,2,4,2,0,0
0,1,0,0,1,1,1,7.75,2.0,31.02,0.01,6,0.5,1.72,2,4,2,0,0
0,1,0,0,1,1,1,5.8,2.0,23.22,0.0,5,0.5,1.29,1,4,1,0,0
0,1,0,0,1,1,1,5.8,2.0,23.22,0.0,5,0.5,1.29,1,4,1,0,0
0,1,0,0,1,1,1,7.75,2.0,31.02,0.01,6,0.5,1.72,2,4,2,0,0
0,1,0,0,1,1,1,7.75,2.0,31.02,0.01,6,0.5,1.72,2,4,2,0,0
0,1,0,0,1,1,1,5.33,1.5,12.0,0.0,4,0.67,0.67,1,3,1,0,0
0,1,0,0,1,1,1,5.33,1.5,12.0,0.0,4,0.67,0.67,1,3,1,0,0
0,1,0,0,1,1,1,5.33,1.5,12.0,0.0,4,0.67,0.67,1,3,1,0,0
4,3,0,0,2,1,1,11.52,3.75,161.94,0.01,13,0.27,9.0,5,8,4,4,0
0,1,0,0,1,1,1,5.33,1.5,12.0,0.0,4,0.67,0.67,1,3,1,0,0
0,1,0,0,1,1,1,7.75,2.0,31.02,0.01,6,0.5,1.72,2,4,2,0,0
0,1,0,0,1,1,1,7.75,2.0,31.02,0.01,6,0.5,1.72,2,4,2,0,0
0,1,0,0,1,1,1,5.8,2.0,23.22,0.0,5,0.5,1.29,1,4,1,0,0
0,1,0,0,1,1,1,7.75,2.0,31.02,0.01,6,0.5,1.72,2,4,2,0,0
0,1,0,0,1,1,1,7.75,2.0,31.02,0.01,6,0.5,1.72,2,4,2,0,0
0,3,0,0,2,1,1,7.75,2.0,31.02,0.01,6,0.5,1.72,2,4,2,0,0
0,1,0,0,1,1,1,5.8,2.0,23.22,0.0,5,0.5,1.29,1,4,1,0,0
0,3,0,0,2,1,1,7.75,2.0,31.02,0.01,6,0.5,1.72,2,4,2,0,0
0,1,0,0,1,1,1,12.18,3.0,109.62,0.01,11,0.33,6.09,4,7,4,0,0
0,1,0,0,1,1,1,7.75,2.0,31.02,0.01,6,0.5,1.72,2,4,2,0,0
0,1,0,0,1,1,1,7.75,2.0,31.02,0.01,6,0.5,1.72,2,4,2,0,0
0,1,0,0,1,1,1,0.0,0.0,0.0,0.0,1,0.0,0.0,0,1,0,0,0
0,1,0,0,1,1,1,7.75,2.0,31.02,0.01,6,0.5,1.72,2,4,2,0,0
0,1,0,0,1,1,1,5.8,2.0,23.22,0.0,5,0.5,1.29,1,4,1,0,0
0,1,0,0,1,1,1,7.75,2.0,31.02,0.01,6,0.5,1.72,2,4,2,0,0
2,1,0,0,1,1,1,8.98,2.5,56.15,0.01,8,0.4,3.12,2,6,2,2,0
2,1,0,0,1,1,1,5.33,1.5,12.0,0.0,4,0.67,0.67,1,3,1,2,0
0,1,0,0,1,1,1,5.33,1.5,12.0,0.0,4,0.67,0.67,1,3,1,0,0
2,1,0,0,1,1,1,5.33,1.5,12.0,0.0,4,0.67,0.67,1,3,1,2,0
2,1,0,0,1,1,1,5.33,1.5,12.0,0.0,4,0.67,0.67,1,3,1,2,0
3,1,0,0,1,1,1,12.0,2.5,75.0,0.01,10,0.4,4.17,3,7,3,3,0
0,1,0,0,1,1,1,7.86,2.5,49.13,0.01,7,0.4,2.73,2,5,2,0,0
0,1,0,0,1,1,1,6.55,3.0,58.95,0.01,7,0.33,3.28,1,6,1,0,0
0,1,0,0,1,1,1,6.55,3.0,58.95,0.01,7,0.33,3.28,1,6,1,0,0
2,1,0,0,1,1,1,8.98,2.5,56.15,0.01,8,0.4,3.12,2,6,2,2,0
2,1,0,0,1,1,1,5.33,1.5,12.0,0.0,4,0.67,0.67,1,3,1,2,0
0,1,0,0,1,1,1,5.33,1.5,12.0,0.0,4,0.67,0.67,1,3,1,0,0
2,1,0,0,1,1,1,5.33,1.5,12.0,0.0,4,0.67,0.67,1,3,1,2,0
2,1,0,0,1,1,1,5.33,1.5,12.0,0.0,4,0.67,0.67,1,3,1,2,0
0,1,0,0,1,1,1,5.33,1.5,12.0,0.0,4,0.67,0.67,1,3,1,0,0
0,1,0,0,1,1,1,5.33,1.5,12.0,0.0,4,0.67,0.67,1,3,1,0,0
0,1,0,0,1,1,1,7.75,2.0,31.02,0.01,6,0.5,1.72,2,4,2,0,0
0,1,0,0,1,1,1,9.0,3.0,81.0,0.01,9,0.33,4.5,2,7,2,0,0
0,1,0,0,1,1,1,8.3,6.0,298.97,0.02,15,0.17,16.61,3,12,2,0,0
0,1,0,0,1,1,1,9.51,3.0,85.59,0.01,9,0.33,4.75,3,6,3,0,0
0,1,0,0,1,1,1,9.51,3.0,85.59,0.01,9,0.33,4.75,3,6,3,0,0
0,1,0,0,1,1,1,9.51,3.0,85.59,0.01,9,0.33,4.75,3,6,3,0,0
0,1,0,0,1,1,1,9.51,3.0,85.59,0.01,9,0.33,4.75,3,6,3,0,0
4,3,0,0,2,2,1,13.67,6.0,492.27,0.03,21,0.17,27.35,6,15,5,4,0
1,1,1,0,1,1,1,4.75,1.0,4.75,0.0,3,1.0,0.26,1,2,1,2,0
0,1,0,0,1,1,1,18.0,1.5,40.5,0.01,9,0.67,2.25,5,4,5,0,0
0,1,0,0,1,1,1,5.33,1.5,12.0,0.0,4,0.67,0.67,1,3,1,0,0
0,1,0,0,1,1,1,5.33,1.5,12.0,0.0,4,0.67,0.67,1,3,1,0,0
0,1,0,0,1,1,1,5.33,1.5,12.0,0.0,4,0.67,0.67,1,3,1,0,0
4,3,0,0,2,1,1,11.52,3.75,161.94,0.01,13,0.27,9.0,5,8,4,4,0
0,1,0,0,1,1,1,5.33,1.5,12.0,0.0,4,0.67,0.67,1,3,1,0,0
0,1,0,0,1,1,1,5.8,2.0,23.22,0.0,5,0.5,1.29,1,4,1,0,0
0,1,0,0,1,1,1,0.0,0.0,0.0,0.0,1,0.0,0.0,0,1,0,0,0
0,1,0,0,1,1,1,0.0,0.0,0.0,0.0,1,0.0,0.0,0,1,0,0,0
0,1,0,0,1,1,1,0.0,0.0,0.0,0.0,1,0.0,0.0,0,1,0,0,0
0,1,0,0,1,1,1,0.0,0.0,0.0,0.0,1,0.0,0.0,0,1,0,0,0
0,1,0,0,1,1,1,0.0,0.0,0.0,0.0,1,0.0,0.0,0,1,0,0,0
4,1,0,0,1,1,1,10.24,7.0,501.89,0.02,20,0.14,27.88,7,13,4,4,0
4,3,0,0,2,2,1,21.5,7.15,1099.18,0.05,35,0.14,61.07,13,22,10,4,0
8,3,0,0,2,2,1,23.46,10.29,2485.24,0.08,52,0.1,138.07,19,33,12,8,0
54,13,1,8,7,6,6,25.11,40.0,40181.42,0.33,184,0.03,2232.3,80,104,22,55,0
0,1,0,0,1,1,1,8.3,6.67,369.01,0.02,16,0.15,20.5,5,11,3,0,0
23,5,0,1,3,2,1,19.78,20.04,7940.87,0.13,80,0.05,441.16,33,47,14,23,0
0,1,0,0,1,1,1,8.6,7.5,483.97,0.02,18,0.13,26.89,5,13,3,0,0
19,5,0,3,3,3,1,19.07,10.91,2270.01,0.07,46,0.09,126.11,20,26,11,19,0
12,3,0,2,2,2,1,14.73,8.94,1176.94,0.04,31,0.11,65.39,13,18,8,12,0
12,9,0,0,5,3,3,17.46,16.55,4779.2,0.1,63,0.06,265.51,28,35,11,12,0
4,1,0,0,1,1,1,9.47,2.67,67.38,0.01,9,0.38,3.74,4,5,3,4,0
13,5,0,0,3,3,1,16.4,7.07,820.29,0.04,29,0.14,45.57,11,18,7,13,0
13,5,0,0,3,3,1,17.24,7.5,969.51,0.04,31,0.13,53.86,12,19,8,13,0
4,3,0,0,2,2,1,11.99,6.67,533.03,0.03,21,0.15,29.61,10,11,6,4,0
0,1,0,0,1,1,1,6.55,3.0,58.95,0.01,7,0.33,3.28,1,6,1,0,0
0,3,0,0,2,2,1,6.69,7.5,376.42,0.02,14,0.13,20.91,5,9,3,0,0
0,1,0,0,1,1,1,7.86,2.5,49.13,0.01,7,0.4,2.73,2,5,2,0,0
0,3,0,0,2,2,1,9.32,5.0,233.02,0.02,13,0.2,12.95,5,8,4,0,0
6,1,0,0,1,1,1,17.51,5.0,437.85,0.03,23,0.2,24.32,10,13,7,6,0
0,3,0,0,2,2,1,7.75,2.0,31.02,0.01,6,0.5,1.72,2,4,2,0,0
0,3,0,0,2,2,1,7.86,2.5,49.13,0.01,7,0.4,2.73,2,5,2,0,0
11,7,0,0,4,2,3,12.35,16.0,3162.47,0.07,45,0.06,175.69,16,29,7,11,0
3,3,0,0,2,2,1,14.28,4.0,228.44,0.02,15,0.25,12.69,6,9,6,3,0
0,1,0,0,1,1,1,0.0,0.0,0.0,0.0,1,0.0,0.0,0,1,0,0,0
2,1,0,0,1,1,1,13.5,2.0,54.0,0.01,9,0.5,3.0,4,5,4,2,0
0,1,0,0,1,1,1,7.75,2.0,31.02,0.01,6,0.5,1.72,2,4,2,0,0
0,1,0,0,1,1,1,7.75,2.0,31.02,0.01,6,0.5,1.72,2,4,2,0,0
0,1,0,0,1,1,1,7.75,2.0,31.02,0.01,6,0.5,1.72,2,4,2,0,0
0,1,0,0,1,1,1,7.74,1.5,17.41,0.0,5,0.67,0.97,2,3,2,0,0
1,1,0,0,1,1,1,7.74,1.5,17.41,0.0,5,0.67,0.97,2,3,2,1,0
0,1,0,0,1,1,1,5.8,2.0,23.22,0.0,5,0.5,1.29,1,4,1,0,0
2,1,0,0,1,1,1,7.75,2.0,31.02,0.01,6,0.5,1.72,2,4,2,2,0
1,1,0,1,1,1,1,0.0,0.0,0.0,0.0,1,0.0,0.0,0,1,0,1,0
2,1,0,0,1,1,1,7.75,2.0,31.02,0.01,6,0.5,1.72,2,4,2,2,0
0,1,0,0,1,1,1,9.31,2.5,58.16,0.01,9,0.4,3.23,1,8,1,0,0
0,1,0,0,1,1,1,7.75,2.0,31.02,0.01,6,0.5,1.72,2,4,2,0,0
0,1,0,0,1,1,1,10.68,4.67,232.53,0.02,15,0.21,12.92,4,11,3,0,0
7,5,0,0,3,2,1,11.89,13.13,2048.55,0.05,35,0.08,113.81,15,20,8,7,0
5,3,0,0,2,2,1,17.22,4.08,287.09,0.02,19,0.24,15.95,7,12,6,5,0
4,3,0,0,2,2,1,11.18,5.63,353.85,0.02,17,0.18,19.66,5,12,4,4,0
0,1,0,0,1,1,1,0.0,0.0,0.0,0.0,0,0.0,0.0,0,0,0,0,0
0,1,0,0,1,1,1,6.2,2.5,38.77,0.01,6,0.4,2.15,1,5,1,0,0
0,1,0,0,1,1,1,11.86,3.5,145.3,0.01,12,0.29,8.07,4,8,4,0,0
0,1,0,0,1,1,1,0.0,0.0,0.0,0.0,0,0.0,0.0,0,0,0,0,0
0,1,0,0,1,1,1,0.0,0.0,0.0,0.0,0,0.0,0.0,0,0,0,0,0
0,1,0,0,1,1,1,0.0,0.0,0.0,0.0,0,0.0,0.0,0,0,0,0,0
0,1,0,0,1,1,1,7.33,4.5,148.5,0.01,11,0.22,8.25,3,8,2,0,0
8,3,0,0,2,1,1,15.07,9.75,1432.72,0.05,34,0.1,79.6,13,21,8,8,0
0,1,0,0,1,1,1,9.6,2.5,60.0,0.01,8,0.4,3.33,3,5,3,0,0
0,1,0,0,1,1,1,7.75,2.0,31.02,0.01,6,0.5,1.72,2,4,2,0,0
0,1,0,0,1,1,1,6.86,3.5,84.0,0.01,8,0.29,4.67,1,7,1,0,0
0,1,0,0,1,1,1,7.75,2.0,31.02,0.01,6,0.5,1.72,2,4,2,0,0
0,1,0,0,1,1,1,8.3,6.0,298.97,0.02,15,0.17,16.61,3,12,2,0,0
0,1,0,0,1,1,1,8.3,6.0,298.97,0.02,15,0.17,16.61,3,12,2,0,0
0,1,0,0,1,1,1,8.3,6.0,298.97,0.02,15,0.17,16.61,3,12,2,0,0
1,1,0,0,1,1,1,0.0,0.0,0.0,0.0,1,0.0,0.0,0,1,0,1,0
2,1,0,2,1,1,1,3.96,2.0,15.85,0.0,5,0.5,0.88,2,3,1,2,0
6,3,0,0,2,1,1,12.68,2.5,79.25,0.01,10,0.4,4.4,4,6,4,6,0
6,3,0,0,2,1,1,12.68,2.5,79.25,0.01,10,0.4,4.4,4,6,4,6,0
9,3,0,0,2,2,1,10.0,4.5,202.5,0.02,15,0.22,11.25,3,12,2,9,0
9,3,0,0,2,2,1,10.0,4.5,202.5,0.02,15,0.22,11.25,3,12,2,9,0
7,1,0,0,1,1,1,22.95,5.06,586.44,0.04,29,0.2,32.58,13,16,9,7,0
7,1,0,0,1,1,1,22.95,5.06,586.44,0.04,29,0.2,32.58,13,16,9,7,0
9,3,0,0,2,2,1,10.0,4.5,202.5,0.02,15,0.22,11.25,3,12,2,9,0
9,3,0,0,2,2,1,10.0,4.5,202.5,0.02,15,0.22,11.25,3,12,2,9,0
3,1,0,0,1,1,1,9.51,3.0,85.59,0.01,9,0.33,4.75,3,6,3,3,0
5,3,0,0,2,2,1,15.36,3.5,188.21,0.02,15,0.29,10.46,5,10,5,5,0
4,3,0,0,2,2,1,10.88,5.6,341.29,0.02,17,0.18,18.96,8,9,5,4,0
0,1,0,0,1,1,1,7.74,1.5,17.41,0.0,5,0.67,0.97,2,3,2,0,0
0,1,0,0,1,1,1,12.68,2.5,79.25,0.01,10,0.4,4.4,4,6,4,0,0
0,1,0,0,1,1,1,7.74,1.5,17.41,0.0,5,0.67,0.97,2,3,2,0,0
0,1,0,0,1,1,1,7.75,2.0,31.02,0.01,6,0.5,1.72,2,4,2,0,0
0,1,0,0,1,1,1,7.75,2.0,31.02,0.01,6,0.5,1.72,2,4,2,0,0
0,1,0,0,1,1,1,7.75,2.0,31.02,0.01,6,0.5,1.72,2,4,2,0,0
0,1,0,0,1,1,1,7.75,2.0,31.02,0.01,6,0.5,1.72,2,4,2,0,0
7,3,0,0,2,2,1,15.65,7.31,836.91,0.04,28,0.14,46.49,13,15,8,7,0
0,1,0,0,1,1,1,7.75,2.0,31.02,0.01,6,0.5,1.72,2,4,2,0,0
0,1,0,0,1,1,1,7.75,2.0,31.02,0.01,6,0.5,1.72,2,4,2,0,0
0,1,0,0,1,1,1,7.75,2.0,31.02,0.01,6,0.5,1.72,2,4,2,0,0
0,1,0,0,1,1,1,7.75,2.0,31.02,0.01,6,0.5,1.72,2,4,2,0,0
0,3,0,0,2,1,1,7.75,2.0,31.02,0.01,6,0.5,1.72,2,4,2,0,0
0,1,0,0,1,1,1,5.8,2.0,23.22,0.0,5,0.5,1.29,1,4,1,0,0
0,3,0,0,2,1,1,7.75,2.0,31.02,0.01,6,0.5,1.72,2,4,2,0,0
0,1,0,0,1,1,1,12.18,3.0,109.62,0.01,11,0.33,6.09,4,7,4,0,0
0,1,0,0,1,1,1,7.75,2.0,31.02,0.01,6,0.5,1.72,2,4,2,0,0
0,1,0,0,1,1,1,7.75,2.0,31.02,0.01,6,0.5,1.72,2,4,2,0,0
0,1,0,0,1,1,1,7.75,2.0,31.02,0.01,6,0.5,1.72,2,4,2,0,0
0,1,0,0,1,1,1,5.8,2.0,23.22,0.0,5,0.5,1.29,1,4,1,0,0
0,1,0,0,1,1,1,7.75,2.0,31.02,0.01,6,0.5,1.72,2,4,2,0,0
2,1,0,0,1,1,1,8.98,2.5,56.15,0.01,8,0.4,3.12,2,6,2,2,0
2,1,0,0,1,1,1,5.33,1.5,12.0,0.0,4,0.67,0.67,1,3,1,2,0
0,1,0,0,1,1,1,5.33,1.5,12.0,0.0,4,0.67,0.67,1,3,1,0,0
2,1,0,0,1,1,1,5.33,1.5,12.0,0.0,4,0.67,0.67,1,3,1,2,0
2,1,0,0,1,1,1,5.33,1.5,12.0,0.0,4,0.67,0.67,1,3,1,2,0
3,1,0,0,1,1,1,12.0,2.5,75.0,0.01,10,0.4,4.17,3,7,3,3,0
0,1,0,0,1,1,1,7.86,2.5,49.13,0.01,7,0.4,2.73,2,5,2,0,0
0,1,0,0,1,1,1,6.55,3.0,58.95,0.01,7,0.33,3.28,1,6,1,0,0
0,1,0,0,1,1,1,6.55,3.0,58.95,0.01,7,0.33,3.28,1,6,1,0,0
2,1,0,0,1,1,1,8.98,2.5,56.15,0.01,8,0.4,3.12,2,6,2,2,0
2,1,0,0,1,1,1,5.33,1.5,12.0,0.0,4,0.67,0.67,1,3,1,2,0
0,1,0,0,1,1,1,5.33,1.5,12.0,0.0,4,0.67,0.67,1,3,1,0,0
2,1,0,0,1,1,1,5.33,1.5,12.0,0.0,4,0.67,0.67,1,3,1,2,0
2,1,0,0,1,1,1,5.33,1.5,12.0,0.0,4,0.67,0.67,1,3,1,2,0
0,1,0,0,1,1,1,5.33,1.5,12.0,0.0,4,0.67,0.67,1,3,1,0,0
0,1,0,0,1,1,1,5.33,1.5,12.0,0.0,4,0.67,0.67,1,3,1,0,0
0,1,0,0,1,1,1,7.75,2.0,31.02,0.01,6,0.5,1.72,2,4,2,0,0
0,1,0,0,1,1,1,9.0,3.0,81.0,0.01,9,0.33,4.5,2,7,2,0,0
0,1,0,0,1,1,1,8.3,6.0,298.97,0.02,15,0.17,16.61,3,12,2,0,0
0,1,0,0,1,1,1,9.51,3.0,85.59,0.01,9,0.33,4.75,3,6,3,0,0
0,1,0,0,1,1,1,9.51,3.0,85.59,0.01,9,0.33,4.75,3,6,3,0,0
0,1,0,0,1,1,1,9.51,3.0,85.59,0.01,9,0.33,4.75,3,6,3,0,0
0,1,0,0,1,1,1,9.51,3.0,85.59,0.01,9,0.33,4.75,3,6,3,0,0
4,3,0,0,2,2,1,13.67,6.0,492.27,0.03,21,0.17,27.35,6,15,5,4,0
0,1,0,0,1,1,1,5.33,1.5,12.0,0.0,4,0.67,0.67,1,3,1,0,0
0,1,0,0,1,1,1,5.33,1.5,12.0,0.0,4,0.67,0.67,1,3,1,0,0
4,1,0,0,1,1,1,10.24,7.0,501.89,0.02,20,0.14,27.88,7,13,4,4,0
4,3,0,0,2,2,1,21.5,7.15,1099.18,0.05,35,0.14,61.07,13,22,10,4,0
8,3,0,0,2,2,1,23.46,10.29,2485.24,0.08,52,0.1,138.07,19,33,12,8,0
54,13,1,8,7,6,6,25.11,40.0,40181.42,0.33,184,0.03,2232.3,80,104,22,55,0
0,1,0,0,1,1,1,8.3,6.67,369.01,0.02,16,0.15,20.5,5,11,3,0,0
23,5,0,1,3,2,1,19.78,20.04,7940.87,0.13,80,0.05,441.16,33,47,14,23,0
0,1,0,0,1,1,1,8.6,7.5,483.97,0.02,18,0.13,26.89,5,13,3,0,0
19,5,0,3,3,3,1,19.07,10.91,2270.01,0.07,46,0.09,126.11,20,26,11,19,0
12,3,0,2,2,2,1,14.73,8.94,1176.94,0.04,31,0.11,65.39,13,18,8,12,0
12,9,0,0,5,3,3,17.46,16.55,4779.2,0.1,63,0.06,265.51,28,35,11,12,0
4,1,0,0,1,1,1,9.47,2.67,67.38,0.01,9,0.38,3.74,4,5,3,4,0
13,5,0,0,3,3,1,16.4,7.07,820.29,0.04,29,0.14,45.57,11,18,7,13,0
13,5,0,0,3,3,1,17.24,7.5,969.51,0.04,31,0.13,53.86,12,19,8,13,0
4,3,0,0,2,2,1,11.99,6.67,533.03,0.03,21,0.15,29.61,10,11,6,4,0
0,1,0,0,1,1,1,6.55,3.0,58.95,0.01,7,0.33,3.28,1,6,1,0,0
0,3,0,0,2,2,1,6.69,7.5,376.42,0.02,14,0.13,20.91,5,9,3,0,0
0,1,0,0,1,1,1,7.86,2.5,49.13,0.01,7,0.4,2.73,2,5,2,0,0
0,3,0,0,2,2,1,9.32,5.0,233.02,0.02,13,0.2,12.95,5,8,4,0,0
6,1,0,0,1,1,1,17.51,5.0,437.85,0.03,23,0.2,24.32,10,13,7,6,0
0,3,0,0,2,2,1,7.75,2.0,31.02,0.01,6,0.5,1.72,2,4,2,0,0
0,3,0,0,2,2,1,7.86,2.5,49.13,0.01,7,0.4,2.73,2,5,2,0,0
11,7,0,0,4,2,3,12.35,16.0,3162.47,0.07,45,0.06,175.69,16,29,7,11,0
3,3,0,0,2,2,1,14.28,4.0,228.44,0.02,15,0.25,12.69,6,9,6,3,0
0,1,0,0,1,1,1,0.0,0.0,0.0,0.0,1,0.0,0.0,0,1,0,0,0
2,1,0,0,1,1,1,13.5,2.0,54.0,0.01,9,0.5,3.0,4,5,4,2,0
0,1,0,0,1,1,1,7.75,2.0,31.02,0.01,6,0.5,1.72,2,4,2,0,0
0,1,0,0,1,1,1,7.75,2.0,31.02,0.01,6,0.5,1.72,2,4,2,0,0
0,1,0,0,1,1,1,7.75,2.0,31.02,0.01,6,0.5,1.72,2,4,2,0,0
0,1,0,0,1,1,1,7.74,1.5,17.41,0.0,5,0.67,0.97,2,3,2,0,0
1,1,0,0,1,1,1,7.74,1.5,17.41,0.0,5,0.67,0.97,2,3,2,1,0
0,1,0,0,1,1,1,5.8,2.0,23.22,0.0,5,0.5,1.29,1,4,1,0,0
2,1,0,0,1,1,1,7.75,2.0,31.02,0.01,6,0.5,1.72,2,4,2,2,0
1,1,0,1,1,1,1,0.0,0.0,0.0,0.0,1,0.0,0.0,0,1,0,1,0
2,1,0,0,1,1,1,7.75,2.0,31.02,0.01,6,0.5,1.72,2,4,2,2,0
0,1,0,0,1,1,1,9.31,2.5,58.16,0.01,9,0.4,3.23,1,8,1,0,0
5,1,0,2,1,1,1,22.19,2.0,88.76,0.01,14,0.5,4.93,5,9,5,5,0
0,1,0,0,1,1,1,7.75,2.0,31.02,0.01,6,0.5,1.72,2,4,2,0,0
0,1,0,0,1,1,1,10.68,4.67,232.53,0.02,15,0.21,12.92,4,11,3,0,0
7,5,0,0,3,2,1,11.89,13.13,2048.55,0.05,35,0.08,113.81,15,20,8,7,0
5,3,0,0,2,2,1,17.22,4.08,287.09,0.02,19,0.24,15.95,7,12,6,5,0
4,3,0,0,2,2,1,11.18,5.63,353.85,0.02,17,0.18,19.66,5,12,4,4,0
0,1,0,0,1,1,1,0.0,0.0,0.0,0.0,0,0.0,0.0,0,0,0,0,0
0,1,0,0,1,1,1,6.2,2.5,38.77,0.01,6,0.4,2.15,1,5,1,0,0
0,1,0,0,1,1,1,11.86,3.5,145.3,0.01,12,0.29,8.07,4,8,4,0,0
0,1,0,0,1,1,1,0.0,0.0,0.0,0.0,0,0.0,0.0,0,0,0,0,0
0,1,0,0,1,1,1,0.0,0.0,0.0,0.0,0,0.0,0.0,0,0,0,0,0
0,1,0,0,1,1,1,0.0,0.0,0.0,0.0,0,0.0,0.0,0,0,0,0,0
0,1,0,0,1,1,1,5.33,1.5,12.0,0.0,4,0.67,0.67,1,3,1,0,0
0,1,0,0,1,1,1,7.33,4.5,148.5,0.01,11,0.22,8.25,3,8,2,0,0
8,3,0,0,2,1,1,15.07,9.75,1432.72,0.05,34,0.1,79.6,13,21,8,8,0
0,1,0,0,1,1,1,9.6,2.5,60.0,0.01,8,0.4,3.33,3,5,3,0,0
0,1,0,0,1,1,1,7.75,2.0,31.02,0.01,6,0.5,1.72,2,4,2,0,0
0,1,0,0,1,1,1,6.86,3.5,84.0,0.01,8,0.29,4.67,1,7,1,0,0
0,1,0,0,1,1,1,7.75,2.0,31.02,0.01,6,0.5,1.72,2,4,2,0,0
0,1,0,0,1,1,1,8.3,6.0,298.97,0.02,15,0.17,16.61,3,12,2,0,0
0,1,0,0,1,1,1,8.3,6.0,298.97,0.02,15,0.17,16.61,3,12,2,0,0
0,1,0,0,1,1,1,8.3,6.0,298.97,0.02,15,0.17,16.61,3,12,2,0,0
0,1,0,0,1,1,1,9.83,2.0,39.3,0.01,7,0.5,2.18,3,4,3,0,0
0,1,0,0,1,1,1,0.0,0.0,0.0,0.0,1,0.0,0.0,0,1,0,0,0
15,9,4,3,5,2,4,38.41,12.48,5980.45,0.16,92,0.08,332.25,41,51,23,19,0
3,1,0,0,1,1,1,9.51,3.0,85.59,0.01,9,0.33,4.75,3,6,3,3,0
5,3,0,0,2,2,1,15.36,3.5,188.21,0.02,15,0.29,10.46,5,10,5,5,0
4,3,0,0,2,2,1,10.88,5.6,341.29,0.02,17,0.18,18.96,8,9,5,4,0
0,1,0,0,1,1,1,7.74,1.5,17.41,0.0,5,0.67,0.97,2,3,2,0,0
0,1,0,0,1,1,1,12.68,2.5,79.25,0.01,10,0.4,4.4,4,6,4,0,0
0,1,0,0,1,1,1,7.74,1.5,17.41,0.0,5,0.67,0.97,2,3,2,0,0
0,1,0,0,1,1,1,7.75,2.0,31.02,0.01,6,0.5,1.72,2,4,2,0,0
0,1,0,0,1,1,1,7.75,2.0,31.02,0.01,6,0.5,1.72,2,4,2,0,0
0,1,0,0,1,1,1,7.75,2.0,31.02,0.01,6,0.5,1.72,2,4,2,0,0
0,1,0,0,1,1,1,7.75,2.0,31.02,0.01,6,0.5,1.72,2,4,2,0,0
0,1,0,0,1,1,1,5.33,1.5,12.0,0.0,4,0.67,0.67,1,3,1,0,0
0,1,0,0,1,1,1,5.33,1.5,12.0,0.0,4,0.67,0.67,1,3,1,0,0
0,1,0,0,1,1,1,5.33,1.5,12.0,0.0,4,0.67,0.67,1,3,1,0,0
0,1,0,0,1,1,1,5.33,1.5,12.0,0.0,4,0.67,0.67,1,3,1,0,0
0,1,0,0,1,1,1,5.33,1.5,12.0,0.0,4,0.67,0.67,1,3,1,0,0
0,1,0,0,1,1,1,5.33,1.5,12.0,0.0,4,0.67,0.67,1,3,1,0,0
4,3,0,0,2,1,1,11.52,3.75,161.94,0.01,13,0.27,9.0,5,8,4,4,0
0,1,0,0,1,1,1,5.33,1.5,12.0,0.0,4,0.67,0.67,1,3,1,0,0
0,1,0,0,1,1,1,5.33,1.5,12.0,0.0,4,0.67,0.67,1,3,1,0,0
0,1,0,0,1,1,1,5.33,1.5,12.0,0.0,4,0.67,0.67,1,3,1,0,0
0,1,0,0,1,1,1,9.51,3.0,85.59,0.01,9,0.33,4.75,3,6,3,0,0
0,1,0,0,1,1,1,5.33,1.5,12.0,0.0,4,0.67,0.67,1,3,1,0,0
0,1,0,0,1,1,1,5.33,1.5,12.0,0.0,4,0.67,0.67,1,3,1,0,0
0,1,0,0,1,1,1,5.33,1.5,12.0,0.0,4,0.67,0.67,1,3,1,0,0
0,1,0,0,1,1,1,5.33,1.5,12.0,0.0,4,0.67,0.67,1,3,1,0,0
0,1,0,0,1,1,1,5.33,1.5,12.0,0.0,4,0.67,0.67,1,3,1,0,0
0,1,0,0,1,1,1,7.75,2.0,31.02,0.01,6,0.5,1.72,2,4,2,0,0
0,1,0,0,1,1,1,7.75,2.0,31.02,0.01,6,0.5,1.72,2,4,2,0,0
0,1,0,0,1,1,1,7.75,2.0,31.02,0.01,6,0.5,1.72,2,4,2,0,0
0,1,0,0,1,1,1,7.75,2.0,31.02,0.01,6,0.5,1.72,2,4,2,0,0
0,3,0,0,2,1,1,7.75,2.0,31.02,0.01,6,0.5,1.72,2,4,2,0,0
0,1,0,0,1,1,1,5.8,2.0,23.22,0.0,5,0.5,1.29,1,4,1,0,0
0,3,0,0,2,1,1,7.75,2.0,31.02,0.01,6,0.5,1.72,2,4,2,0,0
0,1,0,0,1,1,1,12.18,3.0,109.62,0.01,11,0.33,6.09,4,7,4,0,0
0,1,0,0,1,1,1,7.75,2.0,31.02,0.01,6,0.5,1.72,2,4,2,0,0
0,1,0,0,1,1,1,7.75,2.0,31.02,0.01,6,0.5,1.72,2,4,2,0,0
0,1,0,0,1,1,1,0.0,0.0,0.0,0.0,1,0.0,0.0,0,1,0,0,0
0,1,0,0,1,1,1,7.75,2.0,31.02,0.01,6,0.5,1.72,2,4,2,0,0
0,1,0,0,1,1,1,5.8,2.0,23.22,0.0,5,0.5,1.29,1,4,1,0,0
0,1,0,0,1,1,1,7.75,2.0,31.02,0.01,6,0.5,1.72,2,4,2,0,0
2,1,0,0,1,1,1,8.98,2.5,56.15,0.01,8,0.4,3.12,2,6,2,2,0
2,1,0,0,1,1,1,5.33,1.5,12.0,0.0,4,0.67,0.67,1,3,1,2,0
0,1,0,0,1,1,1,5.33,1.5,12.0,0.0,4,0.67,0.67,1,3,1,0,0
2,1,0,0,1,1,1,5.33,1.5,12.0,0.0,4,0.67,0.67,1,3,1,2,0
2,1,0,0,1,1,1,5.33,1.5,12.0,0.0,4,0.67,0.67,1,3,1,2,0
3,1,0,0,1,1,1,12.0,2.5,75.0,0.01,10,0.4,4.17,3,7,3,3,0
0,1,0,0,1,1,1,7.86,2.5,49.13,0.01,7,0.4,2.73,2,5,2,0,0
0,1,0,0,1,1,1,6.55,3.0,58.95,0.01,7,0.33,3.28,1,6,1,0,0
0,1,0,0,1,1,1,6.55,3.0,58.95,0.01,7,0.33,3.28,1,6,1,0,0
2,1,0,0,1,1,1,8.98,2.5,56.15,0.01,8,0.4,3.12,2,6,2,2,0
2,1,0,0,1,1,1,5.33,1.5,12.0,0.0,4,0.67,0.67,1,3,1,2,0
0,1,0,0,1,1,1,5.33,1.5,12.0,0.0,4,0.67,0.67,1,3,1,0,0
2,1,0,0,1,1,1,5.33,1.5,12.0,0.0,4,0.67,0.67,1,3,1,2,0
2,1,0,0,1,1,1,5.33,1.5,12.0,0.0,4,0.67,0.67,1,3,1,2,0
0,1,0,0,1,1,1,5.33,1.5,12.0,0.0,4,0.67,0.67,1,3,1,0,0
0,1,0,0,1,1,1,5.33,1.5,12.0,0.0,4,0.67,0.67,1,3,1,0,0
0,1,0,0,1,1,1,7.75,2.0,31.02,0.01,6,0.5,1.72,2,4,2,0,0
0,1,0,0,1,1,1,9.0,3.0,81.0,0.01,9,0.33,4.5,2,7,2,0,0
0,1,0,0,1,1,1,8.3,6.0,298.97,0.02,15,0.17,16.61,3,12,2,0,0
0,1,0,0,1,1,1,7.74,1.5,17.41,0.0,5,0.67,0.97,2,3,2,0,0
0,1,0,0,1,1,1,9.51,3.0,85.59,0.01,9,0.33,4.75,3,6,3,0,0
0,1,0,0,1,1,1,9.51,3.0,85.59,0.01,9,0.33,4.75,3,6,3,0,0
0,1,0,0,1,1,1,9.51,3.0,85.59,0.01,9,0.33,4.75,3,6,3,0,0
0,1,0,0,1,1,1,9.51,3.0,85.59,0.01,9,0.33,4.75,3,6,3,0,0
4,3,0,0,2,2,1,13.67,6.0,492.27,0.03,21,0.17,27.35,6,15,5,4,0
0,1,0,0,1,1,1,5.33,1.5,12.0,0.0,4,0.67,0.67,1,3,1,0,0
0,1,0,0,1,1,1,5.33,1.5,12.0,0.0,4,0.67,0.67,1,3,1,0,0
0,1,0,0,1,1,1,5.33,1.5,12.0,0.0,4,0.67,0.67,1,3,1,0,0
0,1,0,0,1,1,1,5.33,1.5,12.0,0.0,4,0.67,0.67,1,3,1,0,0
0,1,0,0,1,1,1,5.33,1.5,12.0,0.0,4,0.67,0.67,1,3,1,0,0
0,1,0,0,1,1,1,5.33,1.5,12.0,0.0,4,0.67,0.67,1,3,1,0,0
0,1,0,0,1,1,1,5.33,1.5,12.0,0.0,4,0.67,0.67,1,3,1,0,0
0,1,0,0,1,1,1,5.33,1.5,12.0,0.0,4,0.67,0.67,1,3,1,0,0
0,1,0,0,1,1,1,5.33,1.5,12.0,0.0,4,0.67,0.67,1,3,1,0,0
0,1,0,0,1,1,1,9.51,3.0,85.59,0.01,9,0.33,4.75,3,6,3,0,0
0,1,0,0,1,1,1,5.33,1.5,12.0,0.0,4,0.67,0.67,1,3,1,0,0
0,1,0,0,1,1,1,5.33,1.5,12.0,0.0,4,0.67,0.67,1,3,1,0,0
0,1,0,0,1,1,1,5.33,1.5,12.0,0.0,4,0.67,0.67,1,3,1,0,0
0,1,0,0,1,1,1,5.33,1.5,12.0,0.0,4,0.67,0.67,1,3,1,0,0
0,1,0,0,1,1,1,5.33,1.5,12.0,0.0,4,0.67,0.67,1,3,1,0,0
0,1,0,0,1,1,1,7.74,1.5,17.41,0.0,5,0.67,0.97,2,3,2,0,0
11,1,2,3,1,1,1,43.68,4.9,1048.86,0.07,48,0.2,58.27,21,27,15,13,0
0,1,0,0,1,1,1,5.33,1.5,12.0,0.0,4,0.67,0.67,1,3,1,0,0
0,1,0,0,1,1,1,9.83,2.0,39.3,0.01,7,0.5,2.18,3,4,3,0,0
0,1,0,0,1,1,1,0.0,0.0,0.0,0.0,1,0.0,0.0,0,1,0,0,0
31,7,2,15,1,1,1,67.41,13.9,13032.61,0.31,160,0.07,724.03,73,87,42,33,0
0,1,0,0,1,1,1,5.33,1.5,12.0,0.0,4,0.67,0.67,1,3,1,0,0
0,1,0,0,1,1,1,5.33,1.5,12.0,0.0,4,0.67,0.67,1,3,1,0,0
0,1,0,0,1,1,1,5.33,1.5,12.0,0.0,4,0.67,0.67,1,3,1,0,0
0,1,0,0,1,1,1,5.33,1.5,12.0,0.0,4,0.67,0.67,1,3,1,0,0
0,1,0,0,1,1,1,5.33,1.5,12.0,0.0,4,0.67,0.67,1,3,1,0,0
0,1,0,0,1,1,1,5.33,1.5,12.0,0.0,4,0.67,0.67,1,3,1,0,0
4,3,0,0,2,1,1,11.52,3.75,161.94,0.01,13,0.27,9.0,5,8,4,4,0
0,1,0,0,1,1,1,5.33,1.5,12.0,0.0,4,0.67,0.67,1,3,1,0,0
0,1,0,0,1,1,1,5.33,1.5,12.0,0.0,4,0.67,0.67,1,3,1,0,0
0,1,0,0,1,1,1,5.33,1.5,12.0,0.0,4,0.67,0.67,1,3,1,0,0
0,1,0,0,1,1,1,9.51,3.0,85.59,0.01,9,0.33,4.75,3,6,3,0,0
0,1,0,0,1,1,1,5.33,1.5,12.0,0.0,4,0.67,0.67,1,3,1,0,0
0,1,0,0,1,1,1,5.33,1.5,12.0,0.0,4,0.67,0.67,1,3,1,0,0
0,1,0,0,1,1,1,5.33,1.5,12.0,0.0,4,0.67,0.67,1,3,1,0,0
0,1,0,0,1,1,1,5.33,1.5,12.0,0.0,4,0.67,0.67,1,3,1,0,0
0,1,0,0,1,1,1,5.33,1.5,12.0,0.0,4,0.67,0.67,1,3,1,0,0
0,1,0,0,1,1,1,0.0,0.0,0.0,0.0,1,0.0,0.0,0,1,0,0,0
88,13,4,15,7,5,1,240.62,13.87,46307.36,1.11,480,0.07,2572.63,218,262,110,92,0
0,1,0,0,1,1,1,7.74,1.5,17.41,0.0,5,0.67,0.97,2,3,2,0,0
2,1,0,0,1,1,1,5.8,2.0,23.22,0.0,5,0.5,1.29,1,4,1,2,0
0,1,0,0,1,1,1,5.33,1.5,12.0,0.0,4,0.67,0.67,1,3,1,0,0
0,1,0,0,1,1,1,9.83,2.0,39.3,0.01,7,0.5,2.18,3,4,3,0,0
0,1,0,0,1,1,1,0.0,0.0,0.0,0.0,1,0.0,0.0,0,1,0,0,0
0,1,0,0,1,1,1,5.33,1.5,12.0,0.0,4,0.67,0.67,1,3,1,0,0
0,1,0,0,1,1,1,5.33,1.5,12.0,0.0,4,0.67,0.67,1,3,1,0,0
0,1,0,0,1,1,1,5.33,1.5,12.0,0.0,4,0.67,0.67,1,3,1,0,0
0,1,0,0,1,1,1,5.33,1.5,12.0,0.0,4,0.67,0.67,1,3,1,0,0
0,1,0,0,1,1,1,5.33,1.5,12.0,0.0,4,0.67,0.67,1,3,1,0,0
0,1,0,0,1,1,1,5.33,1.5,12.0,0.0,4,0.67,0.67,1,3,1,0,0
4,3,0,0,2,1,1,11.52,3.75,161.94,0.01,13,0.27,9.0,5,8,4,4,0
0,1,0,0,1,1,1,5.33,1.5,12.0,0.0,4,0.67,0.67,1,3,1,0,0
0,1,0,0,1,1,1,5.33,1.5,12.0,0.0,4,0.67,0.67,1,3,1,0,0
0,1,0,0,1,1,1,5.33,1.5,12.0,0.0,4,0.67,0.67,1,3,1,0,0
0,1,0,0,1,1,1,9.51,3.0,85.59,0.01,9,0.33,4.75,3,6,3,0,0
0,1,0,0,1,1,1,5.33,1.5,12.0,0.0,4,0.67,0.67,1,3,1,0,0
0,1,0,0,1,1,1,5.33,1.5,12.0,0.0,4,0.67,0.67,1,3,1,0,0
0,1,0,0,1,1,1,5.33,1.5,12.0,0.0,4,0.67,0.67,1,3,1,0,0
0,1,0,0,1,1,1,5.33,1.5,12.0,0.0,4,0.67,0.67,1,3,1,0,0
0,1,0,0,1,1,1,5.33,1.5,12.0,0.0,4,0.67,0.67,1,3,1,0,0
0,1,0,0,1,1,1,0.0,0.0,0.0,0.0,1,0.0,0.0,0,1,0,0,0
0,1,0,0,1,1,1,7.74,1.5,17.41,0.0,5,0.67,0.97,2,3,2,0,0
12,3,0,0,2,1,1,24.53,5.06,626.89,0.04,31,0.2,34.83,13,18,9,12,0
0,1,0,0,1,1,1,5.33,1.5,12.0,0.0,4,0.67,0.67,1,3,1,0,0
10,7,0,1,4,2,1,16.47,8.44,1172.59,0.05,34,0.12,65.14,15,19,8,10,0
15,5,0,2,3,3,1,35.66,6.3,1415.38,0.07,49,0.16,78.63,21,28,15,15,0
0,1,0,0,1,1,1,9.83,2.0,39.3,0.01,7,0.5,2.18,3,4,3,0,0
0,1,0,0,1,1,1,0.0,0.0,0.0,0.0,1,0.0,0.0,0,1,0,0,0
0,1,0,0,1,1,1,5.33,1.5,12.0,0.0,4,0.67,0.67,1,3,1,0,0
0,1,0,0,1,1,1,5.33,1.5,12.0,0.0,4,0.67,0.67,1,3,1,0,0
0,1,0,0,1,1,1,5.33,1.5,12.0,0.0,4,0.67,0.67,1,3,1,0,0
0,1,0,0,1,1,1,5.33,1.5,12.0,0.0,4,0.67,0.67,1,3,1,0,0
0,1,0,0,1,1,1,5.33,1.5,12.0,0.0,4,0.67,0.67,1,3,1,0,0
0,1,0,0,1,1,1,5.33,1.5,12.0,0.0,4,0.67,0.67,1,3,1,0,0
4,3,0,0,2,1,1,11.52,3.75,161.94,0.01,13,0.27,9.0,5,8,4,4,0
0,1,0,0,1,1,1,5.33,1.5,12.0,0.0,4,0.67,0.67,1,3,1,0,0
0,1,0,0,1,1,1,5.33,1.5,12.0,0.0,4,0.67,0.67,1,3,1,0,0
0,1,0,0,1,1,1,5.33,1.5,12.0,0.0,4,0.67,0.67,1,3,1,0,0
0,1,0,0,1,1,1,9.51,3.0,85.59,0.01,9,0.33,4.75,3,6,3,0,0
0,1,0,0,1,1,1,5.33,1.5,12.0,0.0,4,0.67,0.67,1,3,1,0,0
0,1,0,0,1,1,1,5.33,1.5,12.0,0.0,4,0.67,0.67,1,3,1,0,0
0,1,0,0,1,1,1,5.33,1.5,12.0,0.0,4,0.67,0.67,1,3,1,0,0
0,1,0,0,1,1,1,5.33,1.5,12.0,0.0,4,0.67,0.67,1,3,1,0,0
0,1,0,0,1,1,1,5.33,1.5,12.0,0.0,4,0.67,0.67,1,3,1,0,0
8,3,0,1,2,1,1,17.45,8.13,1151.94,0.05,34,0.12,64.0,13,21,8,8,0
0,1,0,0,1,1,1,0.0,0.0,0.0,0.0,1,0.0,0.0,0,1,0,0,0
0,1,0,0,1,1,1,7.74,1.5,17.41,0.0,5,0.67,0.97,2,3,2,0,0
13,5,1,4,3,2,1,38.17,5.33,1085.65,0.07,45,0.19,60.31,20,25,15,14,0
4,1,0,0,1,1,1,10.24,7.0,501.89,0.02,20,0.14,27.88,7,13,4,4,0
4,3,0,0,2,2,1,21.5,7.15,1099.18,0.05,35,0.14,61.07,13,22,10,4,0
8,3,0,0,2,2,1,23.46,10.29,2485.24,0.08,52,0.1,138.07,19,33,12,8,0
54,13,1,8,7,6,6,25.11,40.0,40181.42,0.33,184,0.03,2232.3,80,104,22,55,0
0,1,0,0,1,1,1,8.3,6.67,369.01,0.02,16,0.15,20.5,5,11,3,0,0
23,5,0,1,3,2,1,19.78,20.04,7940.87,0.13,80,0.05,441.16,33,47,14,23,0
0,1,0,0,1,1,1,8.6,7.5,483.97,0.02,18,0.13,26.89,5,13,3,0,0
19,5,0,3,3,3,1,19.07,10.91,2270.01,0.07,46,0.09,126.11,20,26,11,19,0
12,3,0,2,2,2,1,14.73,8.94,1176.94,0.04,31,0.11,65.39,13,18,8,12,0
12,9,0,0,5,3,3,17.46,16.55,4779.2,0.1,63,0.06,265.51,28,35,11,12,0
4,1,0,0,1,1,1,9.47,2.67,67.38,0.01,9,0.38,3.74,4,5,3,4,0
13,5,0,0,3,3,1,16.4,7.07,820.29,0.04,29,0.14,45.57,11,18,7,13,0
13,5,0,0,3,3,1,17.24,7.5,969.51,0.04,31,0.13,53.86,12,19,8,13,0
4,3,0,0,2,2,1,11.99,6.67,533.03,0.03,21,0.15,29.61,10,11,6,4,0
0,1,0,0,1,1,1,6.55,3.0,58.95,0.01,7,0.33,3.28,1,6,1,0,0
0,3,0,0,2,2,1,6.69,7.5,376.42,0.02,14,0.13,20.91,5,9,3,0,0
0,1,0,0,1,1,1,7.86,2.5,49.13,0.01,7,0.4,2.73,2,5,2,0,0
0,3,0,0,2,2,1,9.32,5.0,233.02,0.02,13,0.2,12.95,5,8,4,0,0
6,1,0,0,1,1,1,17.51,5.0,437.85,0.03,23,0.2,24.32,10,13,7,6,0
0,3,0,0,2,2,1,7.75,2.0,31.02,0.01,6,0.5,1.72,2,4,2,0,0
0,3,0,0,2,2,1,7.86,2.5,49.13,0.01,7,0.4,2.73,2,5,2,0,0
11,7,0,0,4,2,3,12.35,16.0,3162.47,0.07,45,0.06,175.69,16,29,7,11,0
6,1,0,0,1,1,1,11.81,6.75,538.15,0.03,24,0.15,29.9,9,15,4,6,0
10,3,0,0,2,2,1,13.4,7.0,656.36,0.03,24,0.14,36.46,7,17,5,10,0
3,3,0,0,2,2,1,14.28,4.0,228.44,0.02,15,0.25,12.69,6,9,6,3,0
0,1,0,0,1,1,1,0.0,0.0,0.0,0.0,1,0.0,0.0,0,1,0,0,0
2,1,0,0,1,1,1,13.5,2.0,54.0,0.01,9,0.5,3.0,4,5,4,2,0
0,1,0,0,1,1,1,7.75,2.0,31.02,0.01,6,0.5,1.72,2,4,2,0,0
0,1,0,0,1,1,1,7.75,2.0,31.02,0.01,6,0.5,1.72,2,4,2,0,0
0,1,0,0,1,1,1,6.2,2.5,38.77,0.01,6,0.4,2.15,1,5,1,0,0
0,1,0,0,1,1,1,6.2,2.5,38.77,0.01,6,0.4,2.15,1,5,1,0,0
0,1,0,0,1,1,1,6.2,2.5,38.77,0.01,6,0.4,2.15,1,5,1,0,0
0,1,0,0,1,1,1,7.75,2.0,31.02,0.01,6,0.5,1.72,2,4,2,0,0
0,1,0,0,1,1,1,7.74,1.5,17.41,0.0,5,0.67,0.97,2,3,2,0,0
21,11,0,0,6,1,3,8.36,27.0,6094.62,0.08,61,0.04,338.59,24,37,4,21,0
18,9,0,0,5,1,1,6.16,28.5,5006.4,0.06,49,0.04,278.13,19,30,3,18,0
0,1,0,0,1,1,1,0.0,0.0,0.0,0.0,1,0.0,0.0,0,1,0,0,0
0,1,0,0,1,1,1,7.74,1.5,17.41,0.0,5,0.67,0.97,2,3,2,0,0
3,3,0,0,2,1,1,5.07,8.75,388.32,0.01,14,0.11,21.57,5,9,2,3,0
3,3,0,0,2,1,1,5.07,8.75,388.32,0.01,14,0.11,21.57,5,9,2,3,0
1,1,0,0,1,1,1,7.74,1.5,17.41,0.0,5,0.67,0.97,2,3,2,1,0
0,1,0,0,1,1,1,5.8,2.0,23.22,0.0,5,0.5,1.29,1,4,1,0,0
2,1,0,0,1,1,1,7.75,2.0,31.02,0.01,6,0.5,1.72,2,4,2,2,0
1,1,0,1,1,1,1,0.0,0.0,0.0,0.0,1,0.0,0.0,0,1,0,1,0
2,1,0,0,1,1,1,7.75,2.0,31.02,0.01,6,0.5,1.72,2,4,2,2,0
0,1,0,0,1,1,1,9.31,2.5,58.16,0.01,9,0.4,3.23,1,8,1,0,0
0,1,0,0,1,1,1,7.75,2.0,31.02,0.01,6,0.5,1.72,2,4,2,0,0
0,1,0,0,1,1,1,10.68,4.67,232.53,0.02,15,0.21,12.92,4,11,3,0,0
7,5,0,0,3,2,1,11.89,13.13,2048.55,0.05,35,0.08,113.81,15,20,8,7,0
5,3,0,0,2,2,1,17.22,4.08,287.09,0.02,19,0.24,15.95,7,12,6,5,0
4,3,0,0,2,2,1,11.18,5.63,353.85,0.02,17,0.18,19.66,5,12,4,4,0
0,1,0,0,1,1,1,0.0,0.0,0.0,0.0,0,0.0,0.0,0,0,0,0,0
0,1,0,0,1,1,1,6.2,2.5,38.77,0.01,6,0.4,2.15,1,5,1,0,0
0,1,0,0,1,1,1,11.86,3.5,145.3,0.01,12,0.29,8.07,4,8,4,0,0
0,1,0,0,1,1,1,0.0,0.0,0.0,0.0,0,0.0,0.0,0,0,0,0,0
0,1,0,0,1,1,1,0.0,0.0,0.0,0.0,0,0.0,0.0,0,0,0,0,0
0,1,0,0,1,1,1,0.0,0.0,0.0,0.0,0,0.0,0.0,0,0,0,0,0
0,1,0,0,1,1,1,7.33,4.5,148.5,0.01,11,0.22,8.25,3,8,2,0,0
8,3,0,0,2,1,1,15.07,9.75,1432.72,0.05,34,0.1,79.6,13,21,8,8,0
3,1,0,0,1,1,1,9.9,3.33,110.0,0.01,11,0.3,6.11,4,7,3,3,0
0,1,0,0,1,1,1,9.6,2.5,60.0,0.01,8,0.4,3.33,3,5,3,0,0
0,1,0,0,1,1,1,7.75,2.0,31.02,0.01,6,0.5,1.72,2,4,2,0,0
0,1,0,0,1,1,1,6.86,3.5,84.0,0.01,8,0.29,4.67,1,7,1,0,0
0,1,0,0,1,1,1,7.75,2.0,31.02,0.01,6,0.5,1.72,2,4,2,0,0
0,1,0,0,1,1,1,8.3,6.0,298.97,0.02,15,0.17,16.61,3,12,2,0,0
0,1,0,0,1,1,1,8.3,6.0,298.97,0.02,15,0.17,16.61,3,12,2,0,0
0,1,0,0,1,1,1,8.3,6.0,298.97,0.02,15,0.17,16.61,3,12,2,0,0
88,39,1,0,1,1,1,40.51,42.24,72273.19,0.57,257,0.02,4015.18,101,156,55,89,0
3,1,0,0,1,1,1,9.51,3.0,85.59,0.01,9,0.33,4.75,3,6,3,3,0
5,3,0,0,2,2,1,15.36,3.5,188.21,0.02,15,0.29,10.46,5,10,5,5,0
0,1,0,0,1,1,1,6.55,3.0,58.95,0.01,7,0.33,3.28,1,6,1,0,0
0,1,0,0,1,1,1,6.55,3.0,58.95,0.01,7,0.33,3.28,1,6,1,0,0
0,1,0,0,1,1,1,6.55,3.0,58.95,0.01,7,0.33,3.28,1,6,1,0,0
0,1,0,0,1,1,1,5.8,2.0,23.22,0.0,5,0.5,1.29,1,4,1,0,0
4,3,0,0,2,2,1,10.88,5.6,341.29,0.02,17,0.18,18.96,8,9,5,4,0
0,1,0,0,1,1,1,7.74,1.5,17.41,0.0,5,0.67,0.97,2,3,2,0,0
0,1,0,0,1,1,1,12.68,2.5,79.25,0.01,10,0.4,4.4,4,6,4,0,0
0,1,0,0,1,1,1,7.74,1.5,17.41,0.0,5,0.67,0.97,2,3,2,0,0
0,1,0,0,1,1,1,7.75,2.0,31.02,0.01,6,0.5,1.72,2,4,2,0,0
0,1,0,0,1,1,1,7.75,2.0,31.02,0.01,6,0.5,1.72,2,4,2,0,0
0,1,0,0,1,1,1,7.75,2.0,31.02,0.01,6,0.5,1.72,2,4,2,0,0
0,1,0,0,1,1,1,7.75,2.0,31.02,0.01,6,0.5,1.72,2,4,2,0,0
44,22,0,0,12,7,4,20.62,44.69,41183.85,0.31,158,0.02,2287.99,65,93,24,44,0
0,1,0,0,1,1,1,5.8,2.0,23.22,0.0,5,0.5,1.29,1,4,1,0,0
0,1,0,0,1,1,1,7.75,2.0,31.02,0.01,6,0.5,1.72,2,4,2,0,0
0,1,0,0,1,1,1,7.75,2.0,31.02,0.01,6,0.5,1.72,2,4,2,0,0
0,1,0,0,1,1,1,7.75,2.0,31.02,0.01,6,0.5,1.72,2,4,2,0,0
0,1,0,0,1,1,1,7.75,2.0,31.02,0.01,6,0.5,1.72,2,4,2,0,0
0,3,0,0,2,1,1,7.75,2.0,31.02,0.01,6,0.5,1.72,2,4,2,0,0
0,1,0,0,1,1,1,5.8,2.0,23.22,0.0,5,0.5,1.29,1,4,1,0,0
0,3,0,0,2,1,1,7.75,2.0,31.02,0.01,6,0.5,1.72,2,4,2,0,0
0,1,0,0,1,1,1,12.18,3.0,109.62,0.01,11,0.33,6.09,4,7,4,0,0
0,1,0,0,1,1,1,7.75,2.0,31.02,0.01,6,0.5,1.72,2,4,2,0,0
0,1,0,0,1,1,1,7.75,2.0,31.02,0.01,6,0.5,1.72,2,4,2,0,0
0,1,0,0,1,1,1,10.0,1.0,10.0,0.0,5,1.0,0.56,2,3,2,0,0
0,1,0,0,1,1,1,7.75,2.0,31.02,0.01,6,0.5,1.72,2,4,2,0,0
0,1,0,0,1,1,1,5.8,2.0,23.22,0.0,5,0.5,1.29,1,4,1,0,0
0,1,0,0,1,1,1,7.75,2.0,31.02,0.01,6,0.5,1.72,2,4,2,0,0
2,1,0,0,1,1,1,8.98,2.5,56.15,0.01,8,0.4,3.12,2,6,2,2,0
2,1,0,0,1,1,1,5.33,1.5,12.0,0.0,4,0.67,0.67,1,3,1,2,0
0,1,0,0,1,1,1,5.33,1.5,12.0,0.0,4,0.67,0.67,1,3,1,0,0
2,1,0,0,1,1,1,5.33,1.5,12.0,0.0,4,0.67,0.67,1,3,1,2,0
2,1,0,0,1,1,1,5.33,1.5,12.0,0.0,4,0.67,0.67,1,3,1,2,0
3,1,0,0,1,1,1,12.0,2.5,75.0,0.01,10,0.4,4.17,3,7,3,3,0
0,1,0,0,1,1,1,7.86,2.5,49.13,0.01,7,0.4,2.73,2,5,2,0,0
0,1,0,0,1,1,1,6.55,3.0,58.95,0.01,7,0.33,3.28,1,6,1,0,0
0,1,0,0,1,1,1,6.55,3.0,58.95,0.01,7,0.33,3.28,1,6,1,0,0
2,1,0,0,1,1,1,8.98,2.5,56.15,0.01,8,0.4,3.12,2,6,2,2,0
2,1,0,0,1,1,1,5.33,1.5,12.0,0.0,4,0.67,0.67,1,3,1,2,0
0,1,0,0,1,1,1,5.33,1.5,12.0,0.0,4,0.67,0.67,1,3,1,0,0
2,1,0,0,1,1,1,5.33,1.5,12.0,0.0,4,0.67,0.67,1,3,1,2,0
2,1,0,0,1,1,1,5.33,1.5,12.0,0.0,4,0.67,0.67,1,3,1,2,0
0,1,0,0,1,1,1,5.33,1.5,12.0,0.0,4,0.67,0.67,1,3,1,0,0
0,1,0,0,1,1,1,5.33,1.5,12.0,0.0,4,0.67,0.67,1,3,1,0,0
0,1,0,0,1,1,1,7.75,2.0,31.02,0.01,6,0.5,1.72,2,4,2,0,0
0,1,0,0,1,1,1,9.0,3.0,81.0,0.01,9,0.33,4.5,2,7,2,0,0
0,1,0,0,1,1,1,8.3,6.0,298.97,0.02,15,0.17,16.61,3,12,2,0,0
0,1,0,0,1,1,1,9.51,3.0,85.59,0.01,9,0.33,4.75,3,6,3,0,0
0,1,0,0,1,1,1,9.51,3.0,85.59,0.01,9,0.33,4.75,3,6,3,0,0
0,1,0,0,1,1,1,9.51,3.0,85.59,0.01,9,0.33,4.75,3,6,3,0,0
0,1,0,0,1,1,1,9.51,3.0,85.59,0.01,9,0.33,4.75,3,6,3,0,0
4,3,0,0,2,2,1,13.67,6.0,492.27,0.03,21,0.17,27.35,6,15,5,4,0
2,1,0,0,1,1,1,10.57,3.0,95.1,0.01,10,0.33,5.28,3,7,3,2,0
2,1,0,0,1,1,1,10.57,3.0,95.1,0.01,10,0.33,5.28,3,7,3,2,0
0,1,0,0,1,1,1,0.0,0.0,0.0,0.0,1,0.0,0.0,1,0,1,0,0
3,1,0,0,1,1,1,10.8,2.5,67.5,0.01,9,0.4,3.75,3,6,3,3,0
3,1,0,0,1,1,1,10.8,2.5,67.5,0.01,9,0.4,3.75,3,6,3,3,0
3,1,0,0,1,1,1,10.8,2.5,67.5,0.01,9,0.4,3.75,3,6,3,3,0
3,1,0,0,1,1,1,10.8,2.5,67.5,0.01,9,0.4,3.75,3,6,3,3,0
22,5,0,1,3,3,1,25.59,17.06,7451.42,0.15,89,0.06,413.97,39,50,16,22,0
25,7,0,1,4,4,4,38.11,16.12,9915.63,0.2,118,0.06,550.87,53,65,23,25,0
6,1,0,0,1,1,1,13.45,5.4,392.3,0.02,21,0.19,21.79,9,12,5,6,0
6,1,0,0,1,1,1,13.45,5.4,392.3,0.02,21,0.19,21.79,9,12,5,6,0
42,13,0,2,7,5,1,68.41,12.36,10456.49,0.28,154,0.08,580.92,68,86,33,42,0
42,13,0,2,7,5,1,68.41,12.36,10456.49,0.28,154,0.08,580.92,68,86,33,42,0
27,9,0,0,5,5,1,38.02,17.63,11820.23,0.22,138,0.06,656.68,67,71,19,27,0
8,1,0,5,1,1,1,22.09,14.95,4936.79,0.11,73,0.07,274.27,23,50,10,8,0
8,1,0,5,1,1,1,22.09,14.95,4936.79,0.11,73,0.07,274.27,23,50,10,8,0
8,3,0,4,2,1,1,16.42,8.13,1084.18,0.04,32,0.12,60.23,13,19,8,8,0
8,3,0,4,2,1,1,16.42,8.13,1084.18,0.04,32,0.12,60.23,13,19,8,8,0
41,7,0,11,4,4,1,19.0,84.0,134074.57,0.53,296,0.01,7448.59,126,170,18,41,0
41,7,0,11,4,4,1,19.0,84.0,134074.57,0.53,296,0.01,7448.59,126,170,18,41,0
15,3,0,12,2,2,1,23.41,13.0,3956.07,0.1,64,0.08,219.78,28,36,14,15,0
15,3,0,12,2,2,1,23.41,13.0,3956.07,0.1,64,0.08,219.78,28,36,14,15,0
50,7,0,7,4,4,1,21.93,88.91,173356.49,0.65,353,0.01,9630.92,163,190,22,50,0
50,7,0,7,4,4,1,21.93,88.91,173356.49,0.65,353,0.01,9630.92,163,190,22,50,0
50,25,0,9,1,1,1,29.29,39.74,46258.22,0.39,194,0.03,2569.9,58,136,27,50,0
50,25,0,9,1,1,1,29.29,39.74,46258.22,0.39,194,0.03,2569.9,58,136,27,50,0
151,72,9,11,1,1,1,78.62,45.39,161970.4,1.19,514,0.02,8998.36,211,303,86,160,0
151,72,9,11,1,1,1,77.57,45.92,163597.93,1.19,514,0.02,9088.77,211,303,85,160,0
47,15,1,1,1,1,1,33.46,31.67,33562.86,0.35,185,0.03,1864.6,61,124,26,48,0
47,15,1,1,1,1,1,33.46,31.67,33562.86,0.35,185,0.03,1864.6,61,124,26,48,0
16,15,0,0,1,1,1,21.5,25.33,13797.14,0.18,101,0.04,766.51,38,63,18,16,0
16,15,0,0,1,1,1,21.5,25.33,13797.14,0.18,101,0.04,766.51,38,63,18,16,0
8,5,0,0,1,1,1,17.83,12.6,2830.76,0.07,49,0.08,157.26,18,31,10,8,0
8,5,0,0,1,1,1,17.83,12.6,2830.76,0.07,49,0.08,157.26,18,31,10,8,0
9,5,0,0,3,3,1,14.69,11.7,2011.18,0.06,38,0.09,111.73,18,20,10,9,0
9,5,0,0,3,3,1,14.69,11.7,2011.18,0.06,38,0.09,111.73,18,20,10,9,0
2,1,0,0,1,1,1,9.83,2.0,39.3,0.01,7,0.5,2.18,3,4,3,2,0
2,1,0,0,1,1,1,9.83,2.0,39.3,0.01,7,0.5,2.18,3,4,3,2,0
7,3,0,0,2,1,1,16.0,6.5,676.0,0.03,26,0.15,37.56,13,13,8,7,0
7,3,0,0,2,1,1,16.0,6.5,676.0,0.03,26,0.15,37.56,13,13,8,7,0
4,1,0,0,1,1,1,10.24,7.0,501.89,0.02,20,0.14,27.88,7,13,4,4,0
4,3,0,0,2,2,1,21.5,7.15,1099.18,0.05,35,0.14,61.07,13,22,10,4,0
8,3,0,0,2,2,1,23.46,10.29,2485.24,0.08,52,0.1,138.07,19,33,12,8,0
54,13,1,8,7,6,6,25.11,40.0,40181.42,0.33,184,0.03,2232.3,80,104,22,55,0
0,1,0,0,1,1,1,8.3,6.67,369.01,0.02,16,0.15,20.5,5,11,3,0,0
23,5,0,1,3,2,1,19.78,20.04,7940.87,0.13,80,0.05,441.16,33,47,14,23,0
0,1,0,0,1,1,1,8.6,7.5,483.97,0.02,18,0.13,26.89,5,13,3,0,0
19,5,0,3,3,3,1,19.07,10.91,2270.01,0.07,46,0.09,126.11,20,26,11,19,0
12,3,0,2,2,2,1,14.73,8.94,1176.94,0.04,31,0.11,65.39,13,18,8,12,0
12,9,0,0,5,3,3,17.46,16.55,4779.2,0.1,63,0.06,265.51,28,35,11,12,0
4,1,0,0,1,1,1,9.47,2.67,67.38,0.01,9,0.38,3.74,4,5,3,4,0
13,5,0,0,3,3,1,16.4,7.07,820.29,0.04,29,0.14,45.57,11,18,7,13,0
13,5,0,0,3,3,1,17.24,7.5,969.51,0.04,31,0.13,53.86,12,19,8,13,0
4,3,0,0,2,2,1,11.99,6.67,533.03,0.03,21,0.15,29.61,10,11,6,4,0
0,1,0,0,1,1,1,6.55,3.0,58.95,0.01,7,0.33,3.28,1,6,1,0,0
0,3,0,0,2,2,1,6.69,7.5,376.42,0.02,14,0.13,20.91,5,9,3,0,0
0,1,0,0,1,1,1,7.86,2.5,49.13,0.01,7,0.4,2.73,2,5,2,0,0
0,3,0,0,2,2,1,9.32,5.0,233.02,0.02,13,0.2,12.95,5,8,4,0,0
6,1,0,0,1,1,1,17.51,5.0,437.85,0.03,23,0.2,24.32,10,13,7,6,0
0,3,0,0,2,2,1,7.75,2.0,31.02,0.01,6,0.5,1.72,2,4,2,0,0
0,3,0,0,2,2,1,7.86,2.5,49.13,0.01,7,0.4,2.73,2,5,2,0,0
11,7,0,0,4,2,3,12.35,16.0,3162.47,0.07,45,0.06,175.69,16,29,7,11,0
3,3,0,0,2,2,1,14.28,4.0,228.44,0.02,15,0.25,12.69,6,9,6,3,0
0,1,0,0,1,1,1,0.0,0.0,0.0,0.0,1,0.0,0.0,0,1,0,0,0
2,1,0,0,1,1,1,13.5,2.0,54.0,0.01,9,0.5,3.0,4,5,4,2,0
0,1,0,0,1,1,1,7.75,2.0,31.02,0.01,6,0.5,1.72,2,4,2,0,0
0,1,0,0,1,1,1,7.75,2.0,31.02,0.01,6,0.5,1.72,2,4,2,0,0
0,1,0,0,1,1,1,7.75,2.0,31.02,0.01,6,0.5,1.72,2,4,2,0,0
0,1,0,0,1,1,1,7.74,1.5,17.41,0.0,5,0.67,0.97,2,3,2,0,0
1,1,0,0,1,1,1,7.74,1.5,17.41,0.0,5,0.67,0.97,2,3,2,1,0
0,1,0,0,1,1,1,5.8,2.0,23.22,0.0,5,0.5,1.29,1,4,1,0,0
2,1,0,0,1,1,1,7.75,2.0,31.02,0.01,6,0.5,1.72,2,4,2,2,0
1,1,0,1,1,1,1,0.0,0.0,0.0,0.0,1,0.0,0.0,0,1,0,1,0
2,1,0,0,1,1,1,7.75,2.0,31.02,0.01,6,0.5,1.72,2,4,2,2,0
0,1,0,0,1,1,1,9.31,2.5,58.16,0.01,9,0.4,3.23,1,8,1,0,0
0,1,0,0,1,1,1,7.75,2.0,31.02,0.01,6,0.5,1.72,2,4,2,0,0
0,1,0,0,1,1,1,10.68,4.67,232.53,0.02,15,0.21,12.92,4,11,3,0,0
7,5,0,0,3,2,1,11.89,13.13,2048.55,0.05,35,0.08,113.81,15,20,8,7,0
5,3,0,0,2,2,1,17.22,4.08,287.09,0.02,19,0.24,15.95,7,12,6,5,0
4,3,0,0,2,2,1,11.18,5.63,353.85,0.02,17,0.18,19.66,5,12,4,4,0
0,1,0,0,1,1,1,0.0,0.0,0.0,0.0,0,0.0,0.0,0,0,0,0,0
0,1,0,0,1,1,1,6.2,2.5,38.77,0.01,6,0.4,2.15,1,5,1,0,0
0,1,0,0,1,1,1,11.86,3.5,145.3,0.01,12,0.29,8.07,4,8,4,0,0
0,1,0,0,1,1,1,0.0,0.0,0.0,0.0,0,0.0,0.0,0,0,0,0,0
0,1,0,0,1,1,1,0.0,0.0,0.0,0.0,0,0.0,0.0,0,0,0,0,0
0,1,0,0,1,1,1,0.0,0.0,0.0,0.0,0,0.0,0.0,0,0,0,0,0
0,1,0,0,1,1,1,7.33,4.5,148.5,0.01,11,0.22,8.25,3,8,2,0,0
8,3,0,0,2,1,1,15.07,9.75,1432.72,0.05,34,0.1,79.6,13,21,8,8,0
0,1,0,0,1,1,1,9.6,2.5,60.0,0.01,8,0.4,3.33,3,5,3,0,0
0,1,0,0,1,1,1,7.75,2.0,31.02,0.01,6,0.5,1.72,2,4,2,0,0
0,1,0,0,1,1,1,6.86,3.5,84.0,0.01,8,0.29,4.67,1,7,1,0,0
0,1,0,0,1,1,1,7.75,2.0,31.02,0.01,6,0.5,1.72,2,4,2,0,0
2,1,0,0,1,1,1,6.2,2.5,38.77,0.01,6,0.4,2.15,1,5,1,2,0
0,1,0,0,1,1,1,8.3,6.0,298.97,0.02,15,0.17,16.61,3,12,2,0,0
0,1,0,0,1,1,1,8.3,6.0,298.97,0.02,15,0.17,16.61,3,12,2,0,0
0,1,0,0,1,1,1,8.3,6.0,298.97,0.02,15,0.17,16.61,3,12,2,0,0
0,1,0,0,1,1,1,7.75,2.0,31.02,0.01,6,0.5,1.72,2,4,2,0,0
0,1,0,0,1,1,1,7.75,2.0,31.02,0.01,6,0.5,1.72,2,4,2,0,0
2,1,0,1,1,1,1,5.8,2.0,23.22,0.0,5,0.5,1.29,1,4,1,2,0
2,1,0,0,1,1,1,5.33,1.5,12.0,0.0,4,0.67,0.67,1,3,1,2,0
2,1,0,1,1,1,1,5.8,2.0,23.22,0.0,5,0.5,1.29,1,4,1,2,0
2,1,0,0,1,1,1,5.33,1.5,12.0,0.0,4,0.67,0.67,1,3,1,2,0
2,1,0,0,1,1,1,5.33,1.5,12.0,0.0,4,0.67,0.67,1,3,1,2,0
5,1,0,2,1,1,1,9.21,11.25,1165.64,0.03,28,0.09,64.76,10,18,4,5,0
3,1,0,1,1,1,1,9.3,3.75,130.75,0.01,11,0.27,7.26,6,5,4,3,0
13,5,0,5,3,2,1,13.41,19.29,4988.19,0.09,58,0.05,277.12,18,40,7,13,0
2,1,0,0,1,1,1,5.33,1.5,12.0,0.0,4,0.67,0.67,1,3,1,2,0
2,1,0,0,1,1,1,7.74,1.5,17.41,0.0,5,0.67,0.97,2,3,2,2,0
5,5,0,2,3,1,3,12.6,6.67,560.0,0.03,21,0.15,31.11,8,13,6,5,0
2,1,0,0,1,1,1,7.74,1.5,17.41,0.0,5,0.67,0.97,2,3,2,2,0
3,1,0,0,1,1,1,9.51,3.0,85.59,0.01,9,0.33,4.75,3,6,3,3,0
5,3,0,0,2,2,1,15.36,3.5,188.21,0.02,15,0.29,10.46,5,10,5,5,0
4,3,0,0,2,2,1,10.88,5.6,341.29,0.02,17,0.18,18.96,8,9,5,4,0
0,1,0,0,1,1,1,7.74,1.5,17.41,0.0,5,0.67,0.97,2,3,2,0,0
0,1,0,0,1,1,1,12.68,2.5,79.25,0.01,10,0.4,4.4,4,6,4,0,0
0,1,0,0,1,1,1,7.74,1.5,17.41,0.0,5,0.67,0.97,2,3,2,0,0
0,1,0,0,1,1,1,7.75,2.0,31.02,0.01,6,0.5,1.72,2,4,2,0,0
0,1,0,0,1,1,1,7.75,2.0,31.02,0.01,6,0.5,1.72,2,4,2,0,0
0,1,0,0,1,1,1,7.75,2.0,31.02,0.01,6,0.5,1.72,2,4,2,0,0
0,1,0,0,1,1,1,7.75,2.0,31.02,0.01,6,0.5,1.72,2,4,2,0,0
0,1,0,0,1,1,1,7.75,2.0,31.02,0.01,6,0.5,1.72,2,4,2,0,0
0,1,0,0,1,1,1,7.75,2.0,31.02,0.01,6,0.5,1.72,2,4,2,0,0
0,3,0,0,2,1,1,7.75,2.0,31.02,0.01,6,0.5,1.72,2,4,2,0,0
0,1,0,0,1,1,1,5.8,2.0,23.22,0.0,5,0.5,1.29,1,4,1,0,0
0,3,0,0,2,1,1,7.75,2.0,31.02,0.01,6,0.5,1.72,2,4,2,0,0
0,1,0,0,1,1,1,12.18,3.0,109.62,0.01,11,0.33,6.09,4,7,4,0,0
0,1,0,0,1,1,1,7.75,2.0,31.02,0.01,6,0.5,1.72,2,4,2,0,0
0,1,0,0,1,1,1,7.75,2.0,31.02,0.01,6,0.5,1.72,2,4,2,0,0
0,1,0,0,1,1,1,7.75,2.0,31.02,0.01,6,0.5,1.72,2,4,2,0,0
0,1,0,0,1,1,1,5.8,2.0,23.22,0.0,5,0.5,1.29,1,4,1,0,0
0,1,0,0,1,1,1,7.75,2.0,31.02,0.01,6,0.5,1.72,2,4,2,0,0
2,1,0,0,1,1,1,8.98,2.5,56.15,0.01,8,0.4,3.12,2,6,2,2,0
2,1,0,0,1,1,1,5.33,1.5,12.0,0.0,4,0.67,0.67,1,3,1,2,0
0,1,0,0,1,1,1,5.33,1.5,12.0,0.0,4,0.67,0.67,1,3,1,0,0
2,1,0,0,1,1,1,5.33,1.5,12.0,0.0,4,0.67,0.67,1,3,1,2,0
2,1,0,0,1,1,1,5.33,1.5,12.0,0.0,4,0.67,0.67,1,3,1,2,0
3,1,0,0,1,1,1,12.0,2.5,75.0,0.01,10,0.4,4.17,3,7,3,3,0
0,1,0,0,1,1,1,7.86,2.5,49.13,0.01,7,0.4,2.73,2,5,2,0,0
0,1,0,0,1,1,1,6.55,3.0,58.95,0.01,7,0.33,3.28,1,6,1,0,0
0,1,0,0,1,1,1,6.55,3.0,58.95,0.01,7,0.33,3.28,1,6,1,0,0
2,1,0,0,1,1,1,8.98,2.5,56.15,0.01,8,0.4,3.12,2,6,2,2,0
2,1,0,0,1,1,1,5.33,1.5,12.0,0.0,4,0.67,0.67,1,3,1,2,0
0,1,0,0,1,1,1,5.33,1.5,12.0,0.0,4,0.67,0.67,1,3,1,0,0
2,1,0,0,1,1,1,5.33,1.5,12.0,0.0,4,0.67,0.67,1,3,1,2,0
2,1,0,0,1,1,1,5.33,1.5,12.0,0.0,4,0.67,0.67,1,3,1,2,0
0,1,0,0,1,1,1,5.33,1.5,12.0,0.0,4,0.67,0.67,1,3,1,0,0
0,1,0,0,1,1,1,5.33,1.5,12.0,0.0,4,0.67,0.67,1,3,1,0,0
0,1,0,0,1,1,1,7.75,2.0,31.02,0.01,6,0.5,1.72,2,4,2,0,0
2,1,0,0,1,1,1,6.2,2.5,38.77,0.01,6,0.4,2.15,1,5,1,2,0
0,1,0,0,1,1,1,9.0,3.0,81.0,0.01,9,0.33,4.5,2,7,2,0,0
0,1,0,0,1,1,1,8.3,6.0,298.97,0.02,15,0.17,16.61,3,12,2,0,0
2,1,0,0,1,1,1,5.33,1.5,12.0,0.0,4,0.67,0.67,1,3,1,2,0
0,1,0,0,1,1,1,9.51,3.0,85.59,0.01,9,0.33,4.75,3,6,3,0,0
0,1,0,0,1,1,1,9.51,3.0,85.59,0.01,9,0.33,4.75,3,6,3,0,0
0,1,0,0,1,1,1,9.51,3.0,85.59,0.01,9,0.33,4.75,3,6,3,0,0
0,1,0,0,1,1,1,9.51,3.0,85.59,0.01,9,0.33,4.75,3,6,3,0,0
4,3,0,0,2,2,1,13.67,6.0,492.27,0.03,21,0.17,27.35,6,15,5,4,0
2,1,0,0,1,1,1,9.97,4.0,159.45,0.01,12,0.25,8.86,2,10,2,2,0
2,1,0,0,1,1,1,7.86,2.5,49.13,0.01,7,0.4,2.73,2,5,2,2,0
2,1,0,0,1,1,1,6.2,2.5,38.77,0.01,6,0.4,2.15,1,5,1,2,0
4,1,0,0,1,1,1,10.28,4.38,196.76,0.01,13,0.23,10.93,5,8,4,4,0
20,3,0,0,2,2,1,34.09,11.0,4124.71,0.12,78,0.09,229.15,34,44,17,20,0
2,1,0,0,1,1,1,7.74,1.5,17.41,0.0,5,0.67,0.97,2,3,2,2,0
2,1,0,0,1,1,1,7.74,1.5,17.41,0.0,5,0.67,0.97,2,3,2,2,0
2,1,0,0,1,1,1,5.8,2.0,23.22,0.0,5,0.5,1.29,1,4,1,2,0
2,1,0,0,1,1,1,5.8,2.0,23.22,0.0,5,0.5,1.29,1,4,1,2,0
36,11,0,0,1,1,1,46.81,15.83,11734.74,0.25,132,0.06,651.93,50,82,30,36,0
36,11,0,0,1,1,1,46.81,15.83,11734.74,0.25,132,0.06,651.93,50,82,30,36,0
0,3,0,0,1,1,1,0.0,0.0,0.0,0.0,0,0.0,0.0,0,0,0,0,0
0,3,0,0,1,1,1,0.0,0.0,0.0,0.0,0,0.0,0.0,0,0,0,0,0
2,1,1,0,1,1,1,11.23,2.0,44.92,0.01,8,0.5,2.5,3,5,3,3,0
2,1,1,0,1,1,1,11.23,2.0,44.92,0.01,8,0.5,2.5,3,5,3,3,0
9,3,0,0,2,2,1,15.23,6.0,548.26,0.03,24,0.17,30.46,9,15,6,9,0
9,3,0,0,2,2,1,15.23,6.0,548.26,0.03,24,0.17,30.46,9,15,6,9,0
8,3,0,0,2,2,1,11.56,6.4,473.66,0.02,20,0.16,26.31,8,12,5,8,0
8,3,0,0,2,2,1,11.56,6.4,473.66,0.02,20,0.16,26.31,8,12,5,8,0
0,1,0,0,1,1,1,5.33,1.5,12.0,0.0,4,0.67,0.67,1,3,1,0,0
0,1,0,0,1,1,1,5.33,1.5,12.0,0.0,4,0.67,0.67,1,3,1,0,0
10,5,1,1,3,3,3,31.45,4.77,716.47,0.05,36,0.21,39.8,15,21,11,11,0
10,5,1,1,3,3,3,31.45,4.77,716.47,0.05,36,0.21,39.8,15,21,11,11,0
14,7,1,1,4,4,3,31.39,6.33,1259.12,0.07,46,0.16,69.95,19,27,12,15,0
14,7,1,1,4,4,3,31.39,6.33,1259.12,0.07,46,0.16,69.95,19,27,12,15,0
8,5,0,1,3,3,3,14.72,5.6,461.74,0.03,23,0.18,25.65,8,15,5,8,0
8,5,0,1,3,3,3,14.72,5.6,461.74,0.03,23,0.18,25.65,8,15,5,8,0
0,1,0,0,1,1,1,5.33,1.5,12.0,0.0,4,0.67,0.67,1,3,1,0,0
0,1,0,0,1,1,1,5.33,1.5,12.0,0.0,4,0.67,0.67,1,3,1,0,0
0,1,0,0,1,1,1,5.33,1.5,12.0,0.0,4,0.67,0.67,1,3,1,0,0
0,1,0,0,1,1,1,5.33,1.5,12.0,0.0,4,0.67,0.67,1,3,1,0,0
3,1,0,0,1,1,1,11.23,2.0,44.92,0.01,8,0.5,2.5,3,5,3,3,0
3,1,0,0,1,1,1,11.23,2.0,44.92,0.01,8,0.5,2.5,3,5,3,3,0
3,1,0,0,1,1,1,11.23,2.0,44.92,0.01,8,0.5,2.5,3,5,3,3,0
3,1,0,0,1,1,1,11.23,2.0,44.92,0.01,8,0.5,2.5,3,5,3,3,0
12,5,0,0,3,1,1,15.81,10.08,1607.39,0.05,39,0.1,89.3,11,28,6,12,0
3,1,0,0,1,1,1,9.47,2.67,67.38,0.01,9,0.38,3.74,4,5,3,3,0
6,3,0,0,2,2,1,12.55,4.5,254.13,0.02,17,0.22,14.12,6,11,4,6,0
5,1,0,0,1,1,1,20.8,3.2,213.02,0.02,21,0.31,11.83,8,13,5,5,0
13,3,0,0,2,1,1,5.57,34.83,6763.77,0.06,51,0.03,375.76,19,32,3,13,0
14,3,0,0,2,1,1,12.34,17.5,3780.0,0.07,54,0.06,210.0,21,33,6,14,0
2,1,0,0,1,1,1,13.77,4.38,263.5,0.02,19,0.23,14.64,7,12,4,2,0
2,1,0,0,1,1,1,13.29,3.0,119.59,0.01,12,0.33,6.64,4,8,4,2,0
22,9,0,0,5,1,1,14.87,23.83,8446.49,0.12,82,0.04,469.25,39,43,9,22,0
14,3,0,4,2,2,1,53.95,7.04,2676.52,0.13,76,0.14,148.7,36,40,23,14,0
23,5,0,2,3,2,1,53.0,9.73,5018.51,0.17,99,0.1,278.81,46,53,26,23,0
33,7,6,4,4,4,1,78.33,9.89,7664.53,0.26,138,0.1,425.81,61,77,37,39,0
37,11,1,5,6,5,1,49.34,20.83,21414.62,0.34,177,0.05,1189.7,75,102,36,38,0
16,5,0,2,3,3,1,41.09,4.67,894.86,0.06,43,0.21,49.71,20,23,15,16,0
14,3,0,2,2,2,1,51.13,7.36,2772.55,0.13,76,0.14,154.03,36,40,22,14,0
23,5,0,2,3,2,1,53.0,9.73,5018.51,0.17,99,0.1,278.81,46,53,26,23,0
2,3,0,0,2,2,1,9.6,2.5,60.0,0.01,8,0.4,3.33,3,5,3,2,0
2,3,0,0,2,2,1,9.6,2.5,60.0,0.01,8,0.4,3.33,3,5,3,2,0
7,1,0,0,1,1,1,38.44,2.25,194.59,0.03,25,0.44,10.81,12,13,8,7,0
7,1,0,0,1,1,1,44.81,2.0,179.25,0.03,25,0.5,9.96,12,13,9,7,0
0,1,0,0,1,1,1,5.33,1.5,12.0,0.0,4,0.67,0.67,1,3,1,0,0
0,1,0,0,1,1,1,5.33,1.5,12.0,0.0,4,0.67,0.67,1,3,1,0,0
0,1,0,0,1,1,1,5.33,1.5,12.0,0.0,4,0.67,0.67,1,3,1,0,0
0,1,0,0,1,1,1,5.33,1.5,12.0,0.0,4,0.67,0.67,1,3,1,0,0
30,7,0,0,6,1,1,44.38,11.05,5420.93,0.16,99,0.09,301.16,35,64,19,30,0
30,7,0,0,6,1,1,44.38,11.05,5420.93,0.16,99,0.09,301.16,35,64,19,30,0
3,5,0,0,3,1,3,8.96,6.0,322.65,0.02,15,0.17,17.92,6,9,4,3,0
3,5,0,0,3,1,3,8.96,6.0,322.65,0.02,15,0.17,17.92,6,9,4,3,0
38,20,18,2,14,9,1,26.41,40.71,43778.46,0.36,186,0.02,2432.14,73,113,26,56,0
38,20,18,2,14,1,1,25.56,37.92,36744.08,0.32,170,0.03,2041.34,65,105,24,56,0
38,20,18,2,14,1,1,25.56,37.92,36744.08,0.32,170,0.03,2041.34,65,105,24,56,0
38,20,18,2,14,9,1,26.41,40.71,43778.46,0.36,186,0.02,2432.14,73,113,26,56,0
38,20,18,2,14,1,1,25.56,37.92,36744.08,0.32,170,0.03,2041.34,65,105,24,56,0
38,20,18,2,14,9,1,26.41,40.71,43778.46,0.36,186,0.02,2432.14,73,113,26,56,0
3,3,6,0,2,1,1,20.56,7.56,1173.56,0.05,38,0.13,65.2,17,21,9,9,0
3,3,6,0,2,1,1,20.56,7.56,1173.56,0.05,38,0.13,65.2,17,21,9,9,0
3,3,6,0,2,1,1,20.56,7.56,1173.56,0.05,38,0.13,65.2,17,21,9,9,0
3,3,6,0,2,1,1,20.56,7.56,1173.56,0.05,38,0.13,65.2,17,21,9,9,0
3,3,6,0,2,1,1,20.56,7.56,1173.56,0.05,38,0.13,65.2,17,21,9,9,0
3,3,6,0,2,1,1,20.56,7.56,1173.56,0.05,38,0.13,65.2,17,21,9,9,0
2,1,2,0,1,1,1,8.43,5.33,239.85,0.01,13,0.19,13.33,4,9,3,4,0
2,1,2,0,1,1,1,8.43,5.33,239.85,0.01,13,0.19,13.33,4,9,3,4,0
2,1,2,0,1,1,1,8.43,5.33,239.85,0.01,13,0.19,13.33,4,9,3,4,0
2,1,2,0,1,1,1,8.43,5.33,239.85,0.01,13,0.19,13.33,4,9,3,4,0
2,1,2,0,1,1,1,8.43,5.33,239.85,0.01,13,0.19,13.33,4,9,3,4,0
2,1,2,0,1,1,1,8.43,5.33,239.85,0.01,13,0.19,13.33,4,9,3,4,0
7,3,1,0,2,1,1,4.86,10.5,535.5,0.02,17,0.1,29.75,7,10,2,8,0
7,3,1,0,2,1,1,4.86,10.5,535.5,0.02,17,0.1,29.75,7,10,2,8,0
10,1,0,21,1,1,1,49.26,3.17,494.0,0.05,39,0.32,27.44,19,20,12,10,0
10,1,0,21,1,1,1,64.25,2.25,325.25,0.05,37,0.44,18.07,18,19,12,10,0
0,1,0,0,1,1,1,5.33,1.5,12.0,0.0,4,0.67,0.67,1,3,1,0,0
0,1,0,0,1,1,1,5.33,1.5,12.0,0.0,4,0.67,0.67,1,3,1,0,0
0,1,0,0,1,1,1,7.74,1.5,17.41,0.0,5,0.67,0.97,2,3,2,0,0
0,1,0,0,1,1,1,7.74,1.5,17.41,0.0,5,0.67,0.97,2,3,2,0,0
0,1,0,0,1,1,1,5.33,1.5,12.0,0.0,4,0.67,0.67,1,3,1,0,0
4,3,0,0,2,1,1,11.52,3.75,161.94,0.01,13,0.27,9.0,5,8,4,4,0
0,1,0,0,1,1,1,0.0,0.0,0.0,0.0,1,0.0,0.0,0,1,0,0,0
0,1,0,0,1,1,1,5.33,1.5,12.0,0.0,4,0.67,0.67,1,3,1,0,0
0,1,0,0,1,1,1,7.74,1.5,17.41,0.0,5,0.67,0.97,2,3,2,0,0
0,1,0,0,1,1,1,5.33,1.5,12.0,0.0,4,0.67,0.67,1,3,1,0,0
0,1,0,0,1,1,1,7.74,1.5,17.41,0.0,5,0.67,0.97,2,3,2,0,0
0,1,0,0,1,1,1,5.33,1.5,12.0,0.0,4,0.67,0.67,1,3,1,0,0
0,1,0,0,1,1,1,7.74,1.5,17.41,0.0,5,0.67,0.97,2,3,2,0,0
0,1,0,0,1,1,1,5.33,1.5,12.0,0.0,4,0.67,0.67,1,3,1,0,0
0,1,0,0,1,1,1,7.74,1.5,17.41,0.0,5,0.67,0.97,2,3,2,0,0
17,3,0,0,2,2,1,27.58,9.64,2564.3,0.09,58,0.1,142.46,27,31,14,17,0
17,3,0,0,2,2,1,27.58,9.64,2564.3,0.09,58,0.1,142.46,27,31,14,17,0
5,3,2,1,2,1,1,16.6,5.57,515.41,0.03,25,0.18,28.63,13,12,7,7,0
5,3,2,1,2,1,1,22.54,4.33,423.25,0.03,25,0.23,23.51,13,12,9,7,0
3,1,1,10,1,1,1,21.59,2.0,86.37,0.01,13,0.5,4.8,6,7,6,4,0
3,1,1,10,1,1,1,21.59,2.0,86.37,0.01,13,0.5,4.8,6,7,6,4,0
40,18,16,0,17,1,1,30.49,25.0,19056.29,0.25,138,0.04,1058.68,50,88,23,56,0
24,10,8,0,9,1,1,34.46,10.83,4043.92,0.12,74,0.09,224.66,26,48,18,32,0
8,3,10,4,2,1,1,37.47,6.46,1564.54,0.08,57,0.15,86.92,28,29,13,18,0
7,1,0,2,1,1,1,24.59,4.05,405.89,0.03,27,0.25,22.55,13,14,8,7,0
29,25,27,9,13,3,10,30.98,35.81,39723.42,0.37,202,0.03,2206.86,98,104,26,56,0
12,11,14,3,6,2,6,24.93,19.09,9090.19,0.16,98,0.05,505.01,47,51,16,26,0
4,1,0,0,1,1,1,10.24,7.0,501.89,0.02,20,0.14,27.88,7,13,4,4,0
4,1,0,0,1,1,1,10.24,7.0,501.89,0.02,20,0.14,27.88,7,13,4,4,0
4,3,0,0,2,2,1,21.5,7.15,1099.18,0.05,35,0.14,61.07,13,22,10,4,0
4,3,0,0,2,2,1,21.5,7.15,1099.18,0.05,35,0.14,61.07,13,22,10,4,0
8,3,0,0,2,2,1,23.46,10.29,2485.24,0.08,52,0.1,138.07,19,33,12,8,0
8,3,0,0,2,2,1,23.46,10.29,2485.24,0.08,52,0.1,138.07,19,33,12,8,0
54,13,1,8,7,6,6,25.11,40.0,40181.42,0.33,184,0.03,2232.3,80,104,22,55,0
54,13,1,8,7,6,6,25.11,40.0,40181.42,0.33,184,0.03,2232.3,80,104,22,55,0
0,1,0,0,1,1,1,8.3,6.67,369.01,0.02,16,0.15,20.5,5,11,3,0,0
0,1,0,0,1,1,1,8.3,6.67,369.01,0.02,16,0.15,20.5,5,11,3,0,0
23,5,0,1,3,2,1,19.78,20.04,7940.87,0.13,80,0.05,441.16,33,47,14,23,0
23,5,0,1,3,2,1,19.78,20.04,7940.87,0.13,80,0.05,441.16,33,47,14,23,0
0,1,0,0,1,1,1,8.6,7.5,483.97,0.02,18,0.13,26.89,5,13,3,0,0
0,1,0,0,1,1,1,8.6,7.5,483.97,0.02,18,0.13,26.89,5,13,3,0,0
19,5,0,3,3,3,1,19.07,10.91,2270.01,0.07,46,0.09,126.11,20,26,11,19,0
19,5,0,3,3,3,1,19.07,10.91,2270.01,0.07,46,0.09,126.11,20,26,11,19,0
12,3,0,2,2,2,1,14.73,8.94,1176.94,0.04,31,0.11,65.39,13,18,8,12,0
12,3,0,2,2,2,1,14.73,8.94,1176.94,0.04,31,0.11,65.39,13,18,8,12,0
12,9,0,0,5,3,3,17.46,16.55,4779.2,0.1,63,0.06,265.51,28,35,11,12,0
12,9,0,0,5,3,3,17.46,16.55,4779.2,0.1,63,0.06,265.51,28,35,11,12,0
4,1,0,0,1,1,1,9.47,2.67,67.38,0.01,9,0.38,3.74,4,5,3,4,0
4,1,0,0,1,1,1,9.47,2.67,67.38,0.01,9,0.38,3.74,4,5,3,4,0
13,5,0,0,3,3,1,16.4,7.07,820.29,0.04,29,0.14,45.57,11,18,7,13,0
13,5,0,0,3,3,1,16.4,7.07,820.29,0.04,29,0.14,45.57,11,18,7,13,0
13,5,0,0,3,3,1,17.24,7.5,969.51,0.04,31,0.13,53.86,12,19,8,13,0
13,5,0,0,3,3,1,17.24,7.5,969.51,0.04,31,0.13,53.86,12,19,8,13,0
4,3,0,0,2,2,1,11.99,6.67,533.03,0.03,21,0.15,29.61,10,11,6,4,0
4,3,0,0,2,2,1,11.99,6.67,533.03,0.03,21,0.15,29.61,10,11,6,4,0
0,1,0,0,1,1,1,6.55,3.0,58.95,0.01,7,0.33,3.28,1,6,1,0,0
0,1,0,0,1,1,1,6.55,3.0,58.95,0.01,7,0.33,3.28,1,6,1,0,0
0,3,0,0,2,2,1,6.69,7.5,376.42,0.02,14,0.13,20.91,5,9,3,0,0
0,3,0,0,2,2,1,6.69,7.5,376.42,0.02,14,0.13,20.91,5,9,3,0,0
0,1,0,0,1,1,1,7.86,2.5,49.13,0.01,7,0.4,2.73,2,5,2,0,0
0,1,0,0,1,1,1,7.86,2.5,49.13,0.01,7,0.4,2.73,2,5,2,0,0
0,3,0,0,2,2,1,9.32,5.0,233.02,0.02,13,0.2,12.95,5,8,4,0,0
0,3,0,0,2,2,1,9.32,5.0,233.02,0.02,13,0.2,12.95,5,8,4,0,0
6,1,0,0,1,1,1,17.51,5.0,437.85,0.03,23,0.2,24.32,10,13,7,6,0
6,1,0,0,1,1,1,17.51,5.0,437.85,0.03,23,0.2,24.32,10,13,7,6,0
0,3,0,0,2,2,1,7.75,2.0,31.02,0.01,6,0.5,1.72,2,4,2,0,0
0,3,0,0,2,2,1,7.75,2.0,31.02,0.01,6,0.5,1.72,2,4,2,0,0
0,3,0,0,2,2,1,7.86,2.5,49.13,0.01,7,0.4,2.73,2,5,2,0,0
0,3,0,0,2,2,1,7.86,2.5,49.13,0.01,7,0.4,2.73,2,5,2,0,0
11,7,0,0,4,2,3,12.35,16.0,3162.47,0.07,45,0.06,175.69,16,29,7,11,0
11,7,0,0,4,2,3,12.35,16.0,3162.47,0.07,45,0.06,175.69,16,29,7,11,0
6,1,0,0,1,1,1,11.81,6.75,538.15,0.03,24,0.15,29.9,9,15,4,6,0
6,1,0,0,1,1,1,11.81,6.75,538.15,0.03,24,0.15,29.9,9,15,4,6,0
10,3,0,0,2,2,1,13.4,7.0,656.36,0.03,24,0.14,36.46,7,17,5,10,0
10,3,0,0,2,2,1,13.4,7.0,656.36,0.03,24,0.14,36.46,7,17,5,10,0
3,3,0,0,2,2,1,14.28,4.0,228.44,0.02,15,0.25,12.69,6,9,6,3,0
3,3,0,0,2,2,1,14.28,4.0,228.44,0.02,15,0.25,12.69,6,9,6,3,0
0,1,0,0,1,1,1,0.0,0.0,0.0,0.0,1,0.0,0.0,0,1,0,0,0
0,1,0,0,1,1,1,0.0,0.0,0.0,0.0,1,0.0,0.0,0,1,0,0,0
2,1,0,0,1,1,1,13.5,2.0,54.0,0.01,9,0.5,3.0,4,5,4,2,0
2,1,0,0,1,1,1,13.5,2.0,54.0,0.01,9,0.5,3.0,4,5,4,2,0
0,1,0,0,1,1,1,7.75,2.0,31.02,0.01,6,0.5,1.72,2,4,2,0,0
0,1,0,0,1,1,1,7.75,2.0,31.02,0.01,6,0.5,1.72,2,4,2,0,0
0,1,0,0,1,1,1,7.75,2.0,31.02,0.01,6,0.5,1.72,2,4,2,0,0
0,1,0,0,1,1,1,7.75,2.0,31.02,0.01,6,0.5,1.72,2,4,2,0,0
0,1,0,0,1,1,1,6.2,2.5,38.77,0.01,6,0.4,2.15,1,5,1,0,0
0,1,0,0,1,1,1,6.2,2.5,38.77,0.01,6,0.4,2.15,1,5,1,0,0
0,1,0,0,1,1,1,6.2,2.5,38.77,0.01,6,0.4,2.15,1,5,1,0,0
0,1,0,0,1,1,1,6.2,2.5,38.77,0.01,6,0.4,2.15,1,5,1,0,0
0,1,0,0,1,1,1,6.2,2.5,38.77,0.01,6,0.4,2.15,1,5,1,0,0
0,1,0,0,1,1,1,6.2,2.5,38.77,0.01,6,0.4,2.15,1,5,1,0,0
0,1,0,0,1,1,1,7.75,2.0,31.02,0.01,6,0.5,1.72,2,4,2,0,0
0,1,0,0,1,1,1,7.75,2.0,31.02,0.01,6,0.5,1.72,2,4,2,0,0
0,1,0,0,1,1,1,7.74,1.5,17.41,0.0,5,0.67,0.97,2,3,2,0,0
0,1,0,0,1,1,1,7.74,1.5,17.41,0.0,5,0.67,0.97,2,3,2,0,0
21,11,0,0,6,1,3,8.36,27.0,6094.62,0.08,61,0.04,338.59,24,37,4,21,0
21,11,0,0,6,1,3,8.36,27.0,6094.62,0.08,61,0.04,338.59,24,37,4,21,0
18,9,0,0,5,1,1,6.16,28.5,5006.4,0.06,49,0.04,278.13,19,30,3,18,0
18,9,0,0,5,1,1,6.16,28.5,5006.4,0.06,49,0.04,278.13,19,30,3,18,0
0,1,0,0,1,1,1,0.0,0.0,0.0,0.0,1,0.0,0.0,0,1,0,0,0
0,1,0,0,1,1,1,0.0,0.0,0.0,0.0,1,0.0,0.0,0,1,0,0,0
0,1,0,0,1,1,1,7.74,1.5,17.41,0.0,5,0.67,0.97,2,3,2,0,0
0,1,0,0,1,1,1,7.74,1.5,17.41,0.0,5,0.67,0.97,2,3,2,0,0
3,3,0,0,2,1,1,5.07,8.75,388.32,0.01,14,0.11,21.57,5,9,2,3,0
3,3,0,0,2,1,1,5.07,8.75,388.32,0.01,14,0.11,21.57,5,9,2,3,0
3,3,0,0,2,1,1,5.07,8.75,388.32,0.01,14,0.11,21.57,5,9,2,3,0
3,3,0,0,2,1,1,5.07,8.75,388.32,0.01,14,0.11,21.57,5,9,2,3,0
1,1,0,0,1,1,1,7.74,1.5,17.41,0.0,5,0.67,0.97,2,3,2,1,0
1,1,0,0,1,1,1,7.74,1.5,17.41,0.0,5,0.67,0.97,2,3,2,1,0
0,1,0,0,1,1,1,5.8,2.0,23.22,0.0,5,0.5,1.29,1,4,1,0,0
0,1,0,0,1,1,1,5.8,2.0,23.22,0.0,5,0.5,1.29,1,4,1,0,0
2,1,0,0,1,1,1,7.75,2.0,31.02,0.01,6,0.5,1.72,2,4,2,2,0
2,1,0,0,1,1,1,7.75,2.0,31.02,0.01,6,0.5,1.72,2,4,2,2,0
1,1,0,1,1,1,1,0.0,0.0,0.0,0.0,1,0.0,0.0,0,1,0,1,0
1,1,0,1,1,1,1,0.0,0.0,0.0,0.0,1,0.0,0.0,0,1,0,1,0
2,1,0,0,1,1,1,7.75,2.0,31.02,0.01,6,0.5,1.72,2,4,2,2,0
2,1,0,0,1,1,1,7.75,2.0,31.02,0.01,6,0.5,1.72,2,4,2,2,0
0,1,0,0,1,1,1,9.31,2.5,58.16,0.01,9,0.4,3.23,1,8,1,0,0
0,1,0,0,1,1,1,9.31,2.5,58.16,0.01,9,0.4,3.23,1,8,1,0,0
0,1,0,0,1,1,1,7.75,2.0,31.02,0.01,6,0.5,1.72,2,4,2,0,0
0,1,0,0,1,1,1,7.75,2.0,31.02,0.01,6,0.5,1.72,2,4,2,0,0
0,1,0,0,1,1,1,10.68,4.67,232.53,0.02,15,0.21,12.92,4,11,3,0,0
0,1,0,0,1,1,1,10.68,4.67,232.53,0.02,15,0.21,12.92,4,11,3,0,0
7,5,0,0,3,2,1,11.89,13.13,2048.55,0.05,35,0.08,113.81,15,20,8,7,0
7,5,0,0,3,2,1,11.89,13.13,2048.55,0.05,35,0.08,113.81,15,20,8,7,0
5,3,0,0,2,2,1,17.22,4.08,287.09,0.02,19,0.24,15.95,7,12,6,5,0
5,3,0,0,2,2,1,17.22,4.08,287.09,0.02,19,0.24,15.95,7,12,6,5,0
4,3,0,0,2,2,1,11.18,5.63,353.85,0.02,17,0.18,19.66,5,12,4,4,0
4,3,0,0,2,2,1,11.18,5.63,353.85,0.02,17,0.18,19.66,5,12,4,4,0
0,1,0,0,1,1,1,0.0,0.0,0.0,0.0,0,0.0,0.0,0,0,0,0,0
0,1,0,0,1,1,1,0.0,0.0,0.0,0.0,0,0.0,0.0,0,0,0,0,0
2,1,0,0,1,1,1,8.0,1.0,8.0,0.0,4,1.0,0.44,2,2,2,2,0
2,1,0,0,1,1,1,8.0,1.0,8.0,0.0,4,1.0,0.44,2,2,2,2,0
2,1,0,0,1,1,1,8.0,1.0,8.0,0.0,4,1.0,0.44,2,2,2,2,0
2,1,0,0,1,1,1,8.0,1.0,8.0,0.0,4,1.0,0.44,2,2,2,2,0
2,1,0,0,1,1,1,8.0,1.0,8.0,0.0,4,1.0,0.44,2,2,2,2,0
2,1,0,0,1,1,1,8.0,1.0,8.0,0.0,4,1.0,0.44,2,2,2,2,0
2,1,0,0,1,1,1,8.0,1.0,8.0,0.0,4,1.0,0.44,2,2,2,2,0
2,1,0,0,1,1,1,8.0,1.0,8.0,0.0,4,1.0,0.44,2,2,2,2,0
2,1,0,0,1,1,1,8.0,1.0,8.0,0.0,4,1.0,0.44,2,2,2,2,0
2,1,0,0,1,1,1,8.0,1.0,8.0,0.0,4,1.0,0.44,2,2,2,2,0
0,1,0,0,1,1,1,6.2,2.5,38.77,0.01,6,0.4,2.15,1,5,1,0,0
0,1,0,0,1,1,1,6.2,2.5,38.77,0.01,6,0.4,2.15,1,5,1,0,0
0,1,0,0,1,1,1,11.86,3.5,145.3,0.01,12,0.29,8.07,4,8,4,0,0
0,1,0,0,1,1,1,11.86,3.5,145.3,0.01,12,0.29,8.07,4,8,4,0,0
0,1,0,0,1,1,1,0.0,0.0,0.0,0.0,0,0.0,0.0,0,0,0,0,0
0,1,0,0,1,1,1,0.0,0.0,0.0,0.0,0,0.0,0.0,0,0,0,0,0
0,1,0,0,1,1,1,0.0,0.0,0.0,0.0,0,0.0,0.0,0,0,0,0,0
0,1,0,0,1,1,1,0.0,0.0,0.0,0.0,0,0.0,0.0,0,0,0,0,0
0,1,0,0,1,1,1,0.0,0.0,0.0,0.0,0,0.0,0.0,0,0,0,0,0
0,1,0,0,1,1,1,0.0,0.0,0.0,0.0,0,0.0,0.0,0,0,0,0,0
0,1,0,0,1,1,1,7.33,4.5,148.5,0.01,11,0.22,8.25,3,8,2,0,0
0,1,0,0,1,1,1,7.33,4.5,148.5,0.01,11,0.22,8.25,3,8,2,0,0
8,3,0,0,2,1,1,15.07,9.75,1432.72,0.05,34,0.1,79.6,13,21,8,8,0
8,3,0,0,2,1,1,15.07,9.75,1432.72,0.05,34,0.1,79.6,13,21,8,8,0
3,1,0,0,1,1,1,9.9,3.33,110.0,0.01,11,0.3,6.11,4,7,3,3,0
3,1,0,0,1,1,1,9.9,3.33,110.0,0.01,11,0.3,6.11,4,7,3,3,0
0,1,0,0,1,1,1,9.6,2.5,60.0,0.01,8,0.4,3.33,3,5,3,0,0
0,1,0,0,1,1,1,9.6,2.5,60.0,0.01,8,0.4,3.33,3,5,3,0,0
0,1,0,0,1,1,1,7.75,2.0,31.02,0.01,6,0.5,1.72,2,4,2,0,0
0,1,0,0,1,1,1,7.75,2.0,31.02,0.01,6,0.5,1.72,2,4,2,0,0
1,1,0,0,1,1,1,0.0,0.0,0.0,0.0,1,0.0,0.0,0,1,0,1,0
1,1,0,0,1,1,1,0.0,0.0,0.0,0.0,1,0.0,0.0,0,1,0,1,0
2,1,0,0,1,1,1,3.0,1.0,3.0,0.0,3,1.0,0.17,2,1,1,2,0
2,1,0,0,1,1,1,3.0,1.0,3.0,0.0,3,1.0,0.17,2,1,1,2,0
12,7,0,5,4,4,4,25.22,9.45,2254.13,0.08,52,0.11,125.23,16,36,11,12,0
12,7,0,5,4,4,4,25.22,9.45,2254.13,0.08,52,0.11,125.23,16,36,11,12,0
1,1,0,0,1,1,1,0.0,0.0,0.0,0.0,1,0.0,0.0,0,1,0,1,0
1,1,0,0,1,1,1,0.0,0.0,0.0,0.0,1,0.0,0.0,0,1,0,1,0
3,1,0,0,1,1,1,18.27,2.0,73.08,0.01,11,0.5,4.05,6,5,6,3,0
3,1,0,0,1,1,1,18.27,2.0,73.08,0.01,11,0.5,4.05,6,5,6,3,0
2,1,0,0,1,1,1,6.2,2.5,38.77,0.01,6,0.4,2.15,1,5,1,2,0
2,1,0,0,1,1,1,6.2,2.5,38.77,0.01,6,0.4,2.15,1,5,1,2,0
2,1,0,0,1,1,1,6.2,2.5,38.77,0.01,6,0.4,2.15,1,5,1,2,0
2,1,0,0,1,1,1,6.2,2.5,38.77,0.01,6,0.4,2.15,1,5,1,2,0
2,1,0,0,1,1,1,6.2,2.5,38.77,0.01,6,0.4,2.15,1,5,1,2,0
2,1,0,0,1,1,1,6.2,2.5,38.77,0.01,6,0.4,2.15,1,5,1,2,0
0,1,0,0,1,1,1,6.86,3.5,84.0,0.01,8,0.29,4.67,1,7,1,0,0
0,1,0,0,1,1,1,6.86,3.5,84.0,0.01,8,0.29,4.67,1,7,1,0,0
0,1,0,0,1,1,1,7.75,2.0,31.02,0.01,6,0.5,1.72,2,4,2,0,0
0,1,0,0,1,1,1,7.75,2.0,31.02,0.01,6,0.5,1.72,2,4,2,0,0
0,1,0,0,1,1,1,8.3,6.0,298.97,0.02,15,0.17,16.61,3,12,2,0,0
0,1,0,0,1,1,1,8.3,6.0,298.97,0.02,15,0.17,16.61,3,12,2,0,0
0,1,0,0,1,1,1,8.3,6.0,298.97,0.02,15,0.17,16.61,3,12,2,0,0
0,1,0,0,1,1,1,8.3,6.0,298.97,0.02,15,0.17,16.61,3,12,2,0,0
0,1,0,0,1,1,1,8.3,6.0,298.97,0.02,15,0.17,16.61,3,12,2,0,0
0,1,0,0,1,1,1,8.3,6.0,298.97,0.02,15,0.17,16.61,3,12,2,0,0
0,1,0,0,1,1,1,5.8,2.0,23.22,0.0,5,0.5,1.29,1,4,1,0,0
0,1,0,0,1,1,1,5.8,2.0,23.22,0.0,5,0.5,1.29,1,4,1,0,0
0,1,0,0,1,1,1,7.75,2.0,31.02,0.01,6,0.5,1.72,2,4,2,0,0
0,1,0,0,1,1,1,7.75,2.0,31.02,0.01,6,0.5,1.72,2,4,2,0,0
0,1,0,0,1,1,1,7.75,2.0,31.02,0.01,6,0.5,1.72,2,4,2,0,0
0,1,0,0,1,1,1,7.75,2.0,31.02,0.01,6,0.5,1.72,2,4,2,0,0
3,1,0,0,1,1,1,9.51,3.0,85.59,0.01,9,0.33,4.75,3,6,3,3,0
3,1,0,0,1,1,1,9.51,3.0,85.59,0.01,9,0.33,4.75,3,6,3,3,0
5,3,0,0,2,2,1,15.36,3.5,188.21,0.02,15,0.29,10.46,5,10,5,5,0
5,3,0,0,2,2,1,15.36,3.5,188.21,0.02,15,0.29,10.46,5,10,5,5,0
0,1,0,0,1,1,1,6.55,3.0,58.95,0.01,7,0.33,3.28,1,6,1,0,0
0,1,0,0,1,1,1,6.55,3.0,58.95,0.01,7,0.33,3.28,1,6,1,0,0
0,1,0,0,1,1,1,6.55,3.0,58.95,0.01,7,0.33,3.28,1,6,1,0,0
0,1,0,0,1,1,1,6.55,3.0,58.95,0.01,7,0.33,3.28,1,6,1,0,0
0,1,0,0,1,1,1,6.55,3.0,58.95,0.01,7,0.33,3.28,1,6,1,0,0
0,1,0,0,1,1,1,6.55,3.0,58.95,0.01,7,0.33,3.28,1,6,1,0,0
0,1,0,0,1,1,1,5.8,2.0,23.22,0.0,5,0.5,1.29,1,4,1,0,0
0,1,0,0,1,1,1,5.8,2.0,23.22,0.0,5,0.5,1.29,1,4,1,0,0
4,3,0,0,2,2,1,10.88,5.6,341.29,0.02,17,0.18,18.96,8,9,5,4,0
4,3,0,0,2,2,1,10.88,5.6,341.29,0.02,17,0.18,18.96,8,9,5,4,0
0,1,0,0,1,1,1,7.74,1.5,17.41,0.0,5,0.67,0.97,2,3,2,0,0
0,1,0,0,1,1,1,7.74,1.5,17.41,0.0,5,0.67,0.97,2,3,2,0,0
0,1,0,0,1,1,1,12.68,2.5,79.25,0.01,10,0.4,4.4,4,6,4,0,0
0,1,0,0,1,1,1,12.68,2.5,79.25,0.01,10,0.4,4.4,4,6,4,0,0
0,1,0,0,1,1,1,7.74,1.5,17.41,0.0,5,0.67,0.97,2,3,2,0,0
0,1,0,0,1,1,1,7.74,1.5,17.41,0.0,5,0.67,0.97,2,3,2,0,0
0,1,0,0,1,1,1,7.75,2.0,31.02,0.01,6,0.5,1.72,2,4,2,0,0
0,1,0,0,1,1,1,7.75,2.0,31.02,0.01,6,0.5,1.72,2,4,2,0,0
0,1,0,0,1,1,1,7.75,2.0,31.02,0.01,6,0.5,1.72,2,4,2,0,0
0,1,0,0,1,1,1,7.75,2.0,31.02,0.01,6,0.5,1.72,2,4,2,0,0
0,1,0,0,1,1,1,7.75,2.0,31.02,0.01,6,0.5,1.72,2,4,2,0,0
0,1,0,0,1,1,1,7.75,2.0,31.02,0.01,6,0.5,1.72,2,4,2,0,0
0,1,0,0,1,1,1,7.75,2.0,31.02,0.01,6,0.5,1.72,2,4,2,0,0
0,1,0,0,1,1,1,7.75,2.0,31.02,0.01,6,0.5,1.72,2,4,2,0,0
7,3,0,0,2,2,1,15.65,7.31,836.91,0.04,28,0.14,46.49,13,15,8,7,0
7,3,0,0,2,2,1,15.65,7.31,836.91,0.04,28,0.14,46.49,13,15,8,7,0
0,1,0,0,1,1,1,7.75,2.0,31.02,0.01,6,0.5,1.72,2,4,2,0,0
0,1,0,0,1,1,1,7.75,2.0,31.02,0.01,6,0.5,1.72,2,4,2,0,0
0,1,0,0,1,1,1,7.75,2.0,31.02,0.01,6,0.5,1.72,2,4,2,0,0
0,1,0,0,1,1,1,7.75,2.0,31.02,0.01,6,0.5,1.72,2,4,2,0,0
0,3,0,0,2,1,1,7.75,2.0,31.02,0.01,6,0.5,1.72,2,4,2,0,0
0,3,0,0,2,1,1,7.75,2.0,31.02,0.01,6,0.5,1.72,2,4,2,0,0
0,1,0,0,1,1,1,5.8,2.0,23.22,0.0,5,0.5,1.29,1,4,1,0,0
0,1,0,0,1,1,1,5.8,2.0,23.22,0.0,5,0.5,1.29,1,4,1,0,0
0,3,0,0,2,1,1,7.75,2.0,31.02,0.01,6,0.5,1.72,2,4,2,0,0
0,3,0,0,2,1,1,7.75,2.0,31.02,0.01,6,0.5,1.72,2,4,2,0,0
0,1,0,0,1,1,1,12.18,3.0,109.62,0.01,11,0.33,6.09,4,7,4,0,0
0,1,0,0,1,1,1,12.18,3.0,109.62,0.01,11,0.33,6.09,4,7,4,0,0
0,1,0,0,1,1,1,7.75,2.0,31.02,0.01,6,0.5,1.72,2,4,2,0,0
0,1,0,0,1,1,1,7.75,2.0,31.02,0.01,6,0.5,1.72,2,4,2,0,0
0,1,0,0,1,1,1,7.75,2.0,31.02,0.01,6,0.5,1.72,2,4,2,0,0
0,1,0,0,1,1,1,7.75,2.0,31.02,0.01,6,0.5,1.72,2,4,2,0,0
0,1,0,0,1,1,1,7.75,2.0,31.02,0.01,6,0.5,1.72,2,4,2,0,0
0,1,0,0,1,1,1,7.75,2.0,31.02,0.01,6,0.5,1.72,2,4,2,0,0
0,1,0,0,1,1,1,10.0,1.0,10.0,0.0,5,1.0,0.56,2,3,2,0,0
0,1,0,0,1,1,1,10.0,1.0,10.0,0.0,5,1.0,0.56,2,3,2,0,0
0,1,0,0,1,1,1,5.8,2.0,23.22,0.0,5,0.5,1.29,1,4,1,0,0
0,1,0,0,1,1,1,5.8,2.0,23.22,0.0,5,0.5,1.29,1,4,1,0,0
0,1,0,0,1,1,1,7.75,2.0,31.02,0.01,6,0.5,1.72,2,4,2,0,0
0,1,0,0,1,1,1,7.75,2.0,31.02,0.01,6,0.5,1.72,2,4,2,0,0
2,1,0,0,1,1,1,8.98,2.5,56.15,0.01,8,0.4,3.12,2,6,2,2,0
2,1,0,0,1,1,1,8.98,2.5,56.15,0.01,8,0.4,3.12,2,6,2,2,0
2,1,0,0,1,1,1,5.33,1.5,12.0,0.0,4,0.67,0.67,1,3,1,2,0
2,1,0,0,1,1,1,5.33,1.5,12.0,0.0,4,0.67,0.67,1,3,1,2,0
0,1,0,0,1,1,1,5.33,1.5,12.0,0.0,4,0.67,0.67,1,3,1,0,0
0,1,0,0,1,1,1,5.33,1.5,12.0,0.0,4,0.67,0.67,1,3,1,0,0
2,1,0,0,1,1,1,5.33,1.5,12.0,0.0,4,0.67,0.67,1,3,1,2,0
2,1,0,0,1,1,1,5.33,1.5,12.0,0.0,4,0.67,0.67,1,3,1,2,0
2,1,0,0,1,1,1,5.33,1.5,12.0,0.0,4,0.67,0.67,1,3,1,2,0
2,1,0,0,1,1,1,5.33,1.5,12.0,0.0,4,0.67,0.67,1,3,1,2,0
3,1,0,0,1,1,1,12.0,2.5,75.0,0.01,10,0.4,4.17,3,7,3,3,0
3,1,0,0,1,1,1,12.0,2.5,75.0,0.01,10,0.4,4.17,3,7,3,3,0
0,1,0,0,1,1,1,7.86,2.5,49.13,0.01,7,0.4,2.73,2,5,2,0,0
0,1,0,0,1,1,1,7.86,2.5,49.13,0.01,7,0.4,2.73,2,5,2,0,0
0,1,0,0,1,1,1,6.55,3.0,58.95,0.01,7,0.33,3.28,1,6,1,0,0
0,1,0,0,1,1,1,6.55,3.0,58.95,0.01,7,0.33,3.28,1,6,1,0,0
0,1,0,0,1,1,1,6.55,3.0,58.95,0.01,7,0.33,3.28,1,6,1,0,0
0,1,0,0,1,1,1,6.55,3.0,58.95,0.01,7,0.33,3.28,1,6,1,0,0
2,1,0,0,1,1,1,8.98,2.5,56.15,0.01,8,0.4,3.12,2,6,2,2,0
2,1,0,0,1,1,1,8.98,2.5,56.15,0.01,8,0.4,3.12,2,6,2,2,0
2,1,0,0,1,1,1,5.33,1.5,12.0,0.0,4,0.67,0.67,1,3,1,2,0
2,1,0,0,1,1,1,5.33,1.5,12.0,0.0,4,0.67,0.67,1,3,1,2,0
0,1,0,0,1,1,1,5.33,1.5,12.0,0.0,4,0.67,0.67,1,3,1,0,0
0,1,0,0,1,1,1,5.33,1.5,12.0,0.0,4,0.67,0.67,1,3,1,0,0
2,1,0,0,1,1,1,5.33,1.5,12.0,0.0,4,0.67,0.67,1,3,1,2,0
2,1,0,0,1,1,1,5.33,1.5,12.0,0.0,4,0.67,0.67,1,3,1,2,0
2,1,0,0,1,1,1,5.33,1.5,12.0,0.0,4,0.67,0.67,1,3,1,2,0
2,1,0,0,1,1,1,5.33,1.5,12.0,0.0,4,0.67,0.67,1,3,1,2,0
0,1,0,0,1,1,1,5.33,1.5,12.0,0.0,4,0.67,0.67,1,3,1,0,0
0,1,0,0,1,1,1,5.33,1.5,12.0,0.0,4,0.67,0.67,1,3,1,0,0
0,1,0,0,1,1,1,5.33,1.5,12.0,0.0,4,0.67,0.67,1,3,1,0,0
0,1,0,0,1,1,1,5.33,1.5,12.0,0.0,4,0.67,0.67,1,3,1,0,0
0,1,0,0,1,1,1,7.75,2.0,31.02,0.01,6,0.5,1.72,2,4,2,0,0
0,1,0,0,1,1,1,7.75,2.0,31.02,0.01,6,0.5,1.72,2,4,2,0,0
0,1,0,0,1,1,1,9.0,3.0,81.0,0.01,9,0.33,4.5,2,7,2,0,0
0,1,0,0,1,1,1,9.0,3.0,81.0,0.01,9,0.33,4.5,2,7,2,0,0
0,1,0,0,1,1,1,8.3,6.0,298.97,0.02,15,0.17,16.61,3,12,2,0,0
0,1,0,0,1,1,1,8.3,6.0,298.97,0.02,15,0.17,16.61,3,12,2,0,0
0,1,0,0,1,1,1,10.0,1.0,10.0,0.0,5,1.0,0.56,2,3,2,0,0
0,1,0,0,1,1,1,10.0,1.0,10.0,0.0,5,1.0,0.56,2,3,2,0,0
0,1,0,0,1,1,1,9.51,3.0,85.59,0.01,9,0.33,4.75,3,6,3,0,0
0,1,0,0,1,1,1,9.51,3.0,85.59,0.01,9,0.33,4.75,3,6,3,0,0
0,1,0,0,1,1,1,9.51,3.0,85.59,0.01,9,0.33,4.75,3,6,3,0,0
0,1,0,0,1,1,1,9.51,3.0,85.59,0.01,9,0.33,4.75,3,6,3,0,0
0,1,0,0,1,1,1,9.51,3.0,85.59,0.01,9,0.33,4.75,3,6,3,0,0
0,1,0,0,1,1,1,9.51,3.0,85.59,0.01,9,0.33,4.75,3,6,3,0,0
0,1,0,0,1,1,1,9.51,3.0,85.59,0.01,9,0.33,4.75,3,6,3,0,0
0,1,0,0,1,1,1,9.51,3.0,85.59,0.01,9,0.33,4.75,3,6,3,0,0
4,3,0,0,2,2,1,13.67,6.0,492.27,0.03,21,0.17,27.35,6,15,5,4,0
4,3,0,0,2,2,1,13.67,6.0,492.27,0.03,21,0.17,27.35,6,15,5,4,0
4,1,0,0,1,1,1,10.24,7.0,501.89,0.02,20,0.14,27.88,7,13,4,4,0
4,3,0,0,2,2,1,21.5,7.15,1099.18,0.05,35,0.14,61.07,13,22,10,4,0
8,3,0,0,2,2,1,23.46,10.29,2485.24,0.08,52,0.1,138.07,19,33,12,8,0
54,13,1,8,7,6,6,25.11,40.0,40181.42,0.33,184,0.03,2232.3,80,104,22,55,0
0,1,0,0,1,1,1,8.3,6.67,369.01,0.02,16,0.15,20.5,5,11,3,0,0
23,5,0,1,3,2,1,19.78,20.04,7940.87,0.13,80,0.05,441.16,33,47,14,23,0
0,1,0,0,1,1,1,8.6,7.5,483.97,0.02,18,0.13,26.89,5,13,3,0,0
19,5,0,3,3,3,1,19.07,10.91,2270.01,0.07,46,0.09,126.11,20,26,11,19,0
12,3,0,2,2,2,1,14.73,8.94,1176.94,0.04,31,0.11,65.39,13,18,8,12,0
12,9,0,0,5,3,3,17.46,16.55,4779.2,0.1,63,0.06,265.51,28,35,11,12,0
4,1,0,0,1,1,1,9.47,2.67,67.38,0.01,9,0.38,3.74,4,5,3,4,0
13,5,0,0,3,3,1,16.4,7.07,820.29,0.04,29,0.14,45.57,11,18,7,13,0
13,5,0,0,3,3,1,17.24,7.5,969.51,0.04,31,0.13,53.86,12,19,8,13,0
4,3,0,0,2,2,1,11.99,6.67,533.03,0.03,21,0.15,29.61,10,11,6,4,0
0,1,0,0,1,1,1,6.55,3.0,58.95,0.01,7,0.33,3.28,1,6,1,0,0
0,3,0,0,2,2,1,6.69,7.5,376.42,0.02,14,0.13,20.91,5,9,3,0,0
0,1,0,0,1,1,1,7.86,2.5,49.13,0.01,7,0.4,2.73,2,5,2,0,0
0,3,0,0,2,2,1,9.32,5.0,233.02,0.02,13,0.2,12.95,5,8,4,0,0
6,1,0,0,1,1,1,17.51,5.0,437.85,0.03,23,0.2,24.32,10,13,7,6,0
0,3,0,0,2,2,1,7.75,2.0,31.02,0.01,6,0.5,1.72,2,4,2,0,0
0,3,0,0,2,2,1,7.86,2.5,49.13,0.01,7,0.4,2.73,2,5,2,0,0
11,7,0,0,4,2,3,12.35,16.0,3162.47,0.07,45,0.06,175.69,16,29,7,11,0
3,3,0,0,2,2,1,14.28,4.0,228.44,0.02,15,0.25,12.69,6,9,6,3,0
0,1,0,0,1,1,1,0.0,0.0,0.0,0.0,1,0.0,0.0,0,1,0,0,0
2,1,0,0,1,1,1,13.5,2.0,54.0,0.01,9,0.5,3.0,4,5,4,2,0
0,1,0,0,1,1,1,7.75,2.0,31.02,0.01,6,0.5,1.72,2,4,2,0,0
0,1,0,0,1,1,1,7.75,2.0,31.02,0.01,6,0.5,1.72,2,4,2,0,0
0,1,0,0,1,1,1,7.75,2.0,31.02,0.01,6,0.5,1.72,2,4,2,0,0
0,1,0,0,1,1,1,7.74,1.5,17.41,0.0,5,0.67,0.97,2,3,2,0,0
1,1,0,0,1,1,1,7.74,1.5,17.41,0.0,5,0.67,0.97,2,3,2,1,0
0,1,0,0,1,1,1,5.8,2.0,23.22,0.0,5,0.5,1.29,1,4,1,0,0
2,1,0,0,1,1,1,7.75,2.0,31.02,0.01,6,0.5,1.72,2,4,2,2,0
1,1,0,1,1,1,1,0.0,0.0,0.0,0.0,1,0.0,0.0,0,1,0,1,0
2,1,0,0,1,1,1,7.75,2.0,31.02,0.01,6,0.5,1.72,2,4,2,2,0
0,1,0,0,1,1,1,9.31,2.5,58.16,0.01,9,0.4,3.23,1,8,1,0,0
0,1,0,0,1,1,1,7.75,2.0,31.02,0.01,6,0.5,1.72,2,4,2,0,0
0,1,0,0,1,1,1,10.68,4.67,232.53,0.02,15,0.21,12.92,4,11,3,0,0
7,5,0,0,3,2,1,11.89,13.13,2048.55,0.05,35,0.08,113.81,15,20,8,7,0
5,3,0,0,2,2,1,17.22,4.08,287.09,0.02,19,0.24,15.95,7,12,6,5,0
4,3,0,0,2,2,1,11.18,5.63,353.85,0.02,17,0.18,19.66,5,12,4,4,0
0,1,0,0,1,1,1,0.0,0.0,0.0,0.0,0,0.0,0.0,0,0,0,0,0
0,1,0,0,1,1,1,6.2,2.5,38.77,0.01,6,0.4,2.15,1,5,1,0,0
0,1,0,0,1,1,1,11.86,3.5,145.3,0.01,12,0.29,8.07,4,8,4,0,0
0,1,0,0,1,1,1,0.0,0.0,0.0,0.0,0,0.0,0.0,0,0,0,0,0
0,1,0,0,1,1,1,0.0,0.0,0.0,0.0,0,0.0,0.0,0,0,0,0,0
0,1,0,0,1,1,1,0.0,0.0,0.0,0.0,0,0.0,0.0,0,0,0,0,0
0,1,0,0,1,1,1,7.33,4.5,148.5,0.01,11,0.22,8.25,3,8,2,0,0
8,3,0,0,2,1,1,15.07,9.75,1432.72,0.05,34,0.1,79.6,13,21,8,8,0
0,1,0,0,1,1,1,9.6,2.5,60.0,0.01,8,0.4,3.33,3,5,3,0,0
0,1,0,0,1,1,1,7.75,2.0,31.02,0.01,6,0.5,1.72,2,4,2,0,0
0,1,0,0,1,1,1,6.86,3.5,84.0,0.01,8,0.29,4.67,1,7,1,0,0
0,1,0,0,1,1,1,7.75,2.0,31.02,0.01,6,0.5,1.72,2,4,2,0,0
2,1,0,0,1,1,1,6.2,2.5,38.77,0.01,6,0.4,2.15,1,5,1,2,0
0,1,0,0,1,1,1,8.3,6.0,298.97,0.02,15,0.17,16.61,3,12,2,0,0
0,1,0,0,1,1,1,8.3,6.0,298.97,0.02,15,0.17,16.61,3,12,2,0,0
0,1,0,0,1,1,1,8.3,6.0,298.97,0.02,15,0.17,16.61,3,12,2,0,0
0,1,0,0,1,1,1,7.75,2.0,31.02,0.01,6,0.5,1.72,2,4,2,0,0
0,1,0,0,1,1,1,7.75,2.0,31.02,0.01,6,0.5,1.72,2,4,2,0,0
2,1,0,1,1,1,1,5.8,2.0,23.22,0.0,5,0.5,1.29,1,4,1,2,0
2,1,0,0,1,1,1,5.33,1.5,12.0,0.0,4,0.67,0.67,1,3,1,2,0
2,1,0,0,1,1,1,5.33,1.5,12.0,0.0,4,0.67,0.67,1,3,1,2,0
2,1,0,0,1,1,1,5.33,1.5,12.0,0.0,4,0.67,0.67,1,3,1,2,0
2,1,0,0,1,1,1,5.33,1.5,12.0,0.0,4,0.67,0.67,1,3,1,2,0
2,1,0,0,1,1,1,7.74,1.5,17.41,0.0,5,0.67,0.97,2,3,2,2,0
2,1,0,0,1,1,1,7.74,1.5,17.41,0.0,5,0.67,0.97,2,3,2,2,0
3,1,0,0,1,1,1,9.51,3.0,85.59,0.01,9,0.33,4.75,3,6,3,3,0
5,3,0,0,2,2,1,15.36,3.5,188.21,0.02,15,0.29,10.46,5,10,5,5,0
4,3,0,0,2,2,1,10.88,5.6,341.29,0.02,17,0.18,18.96,8,9,5,4,0
0,1,0,0,1,1,1,7.74,1.5,17.41,0.0,5,0.67,0.97,2,3,2,0,0
0,1,0,0,1,1,1,12.68,2.5,79.25,0.01,10,0.4,4.4,4,6,4,0,0
0,1,0,0,1,1,1,7.74,1.5,17.41,0.0,5,0.67,0.97,2,3,2,0,0
0,1,0,0,1,1,1,7.75,2.0,31.02,0.01,6,0.5,1.72,2,4,2,0,0
0,1,0,0,1,1,1,7.75,2.0,31.02,0.01,6,0.5,1.72,2,4,2,0,0
0,1,0,0,1,1,1,7.75,2.0,31.02,0.01,6,0.5,1.72,2,4,2,0,0
0,1,0,0,1,1,1,7.75,2.0,31.02,0.01,6,0.5,1.72,2,4,2,0,0
0,1,0,0,1,1,1,7.75,2.0,31.02,0.01,6,0.5,1.72,2,4,2,0,0
0,1,0,0,1,1,1,7.75,2.0,31.02,0.01,6,0.5,1.72,2,4,2,0,0
0,3,0,0,2,1,1,7.75,2.0,31.02,0.01,6,0.5,1.72,2,4,2,0,0
0,1,0,0,1,1,1,5.8,2.0,23.22,0.0,5,0.5,1.29,1,4,1,0,0
0,3,0,0,2,1,1,7.75,2.0,31.02,0.01,6,0.5,1.72,2,4,2,0,0
0,1,0,0,1,1,1,12.18,3.0,109.62,0.01,11,0.33,6.09,4,7,4,0,0
0,1,0,0,1,1,1,7.75,2.0,31.02,0.01,6,0.5,1.72,2,4,2,0,0
0,1,0,0,1,1,1,7.75,2.0,31.02,0.01,6,0.5,1.72,2,4,2,0,0
0,1,0,0,1,1,1,7.75,2.0,31.02,0.01,6,0.5,1.72,2,4,2,0,0
0,1,0,0,1,1,1,5.8,2.0,23.22,0.0,5,0.5,1.29,1,4,1,0,0
0,1,0,0,1,1,1,7.75,2.0,31.02,0.01,6,0.5,1.72,2,4,2,0,0
2,1,0,0,1,1,1,8.98,2.5,56.15,0.01,8,0.4,3.12,2,6,2,2,0
2,1,0,0,1,1,1,5.33,1.5,12.0,0.0,4,0.67,0.67,1,3,1,2,0
0,1,0,0,1,1,1,5.33,1.5,12.0,0.0,4,0.67,0.67,1,3,1,0,0
2,1,0,0,1,1,1,5.33,1.5,12.0,0.0,4,0.67,0.67,1,3,1,2,0
2,1,0,0,1,1,1,5.33,1.5,12.0,0.0,4,0.67,0.67,1,3,1,2,0
3,1,0,0,1,1,1,12.0,2.5,75.0,0.01,10,0.4,4.17,3,7,3,3,0
0,1,0,0,1,1,1,7.86,2.5,49.13,0.01,7,0.4,2.73,2,5,2,0,0
0,1,0,0,1,1,1,6.55,3.0,58.95,0.01,7,0.33,3.28,1,6,1,0,0
0,1,0,0,1,1,1,6.55,3.0,58.95,0.01,7,0.33,3.28,1,6,1,0,0
2,1,0,0,1,1,1,8.98,2.5,56.15,0.01,8,0.4,3.12,2,6,2,2,0
2,1,0,0,1,1,1,5.33,1.5,12.0,0.0,4,0.67,0.67,1,3,1,2,0
0,1,0,0,1,1,1,5.33,1.5,12.0,0.0,4,0.67,0.67,1,3,1,0,0
2,1,0,0,1,1,1,5.33,1.5,12.0,0.0,4,0.67,0.67,1,3,1,2,0
2,1,0,0,1,1,1,5.33,1.5,12.0,0.0,4,0.67,0.67,1,3,1,2,0
0,1,0,0,1,1,1,5.33,1.5,12.0,0.0,4,0.67,0.67,1,3,1,0,0
0,1,0,0,1,1,1,5.33,1.5,12.0,0.0,4,0.67,0.67,1,3,1,0,0
0,1,0,0,1,1,1,7.75,2.0,31.02,0.01,6,0.5,1.72,2,4,2,0,0
2,1,0,0,1,1,1,6.2,2.5,38.77,0.01,6,0.4,2.15,1,5,1,2,0
0,1,0,0,1,1,1,9.0,3.0,81.0,0.01,9,0.33,4.5,2,7,2,0,0
0,1,0,0,1,1,1,8.3,6.0,298.97,0.02,15,0.17,16.61,3,12,2,0,0
2,1,0,0,1,1,1,5.33,1.5,12.0,0.0,4,0.67,0.67,1,3,1,2,0
0,1,0,0,1,1,1,9.51,3.0,85.59,0.01,9,0.33,4.75,3,6,3,0,0
0,1,0,0,1,1,1,9.51,3.0,85.59,0.01,9,0.33,4.75,3,6,3,0,0
0,1,0,0,1,1,1,9.51,3.0,85.59,0.01,9,0.33,4.75,3,6,3,0,0
0,1,0,0,1,1,1,9.51,3.0,85.59,0.01,9,0.33,4.75,3,6,3,0,0
4,3,0,0,2,2,1,13.67,6.0,492.27,0.03,21,0.17,27.35,6,15,5,4,0
2,1,0,0,1,1,1,9.97,4.0,159.45,0.01,12,0.25,8.86,2,10,2,2,0
2,1,0,0,1,1,1,7.86,2.5,49.13,0.01,7,0.4,2.73,2,5,2,2,0
2,1,0,0,1,1,1,6.2,2.5,38.77,0.01,6,0.4,2.15,1,5,1,2,0
14,7,3,0,4,4,1,19.45,12.25,2919.42,0.08,61,0.08,162.19,28,33,8,17,0
2,1,1,0,1,1,1,11.23,2.0,44.92,0.01,8,0.5,2.5,3,5,3,3,0
21,1,2,1,1,1,1,113.83,4.92,2757.49,0.19,106,0.2,153.19,45,61,32,23,0
0,1,0,0,1,1,1,5.33,1.5,12.0,0.0,4,0.67,0.67,1,3,1,0,0
0,1,0,0,1,1,1,5.33,1.5,12.0,0.0,4,0.67,0.67,1,3,1,0,0
0,1,0,0,1,1,1,5.33,1.5,12.0,0.0,4,0.67,0.67,1,3,1,0,0
28,9,0,5,5,4,1,67.56,8.59,4989.62,0.19,107,0.12,277.2,50,57,32,28,0
70,12,25,14,1,1,1,50.46,76.84,297882.59,1.29,615,0.01,16549.02,251,364,49,95,0
3,1,0,0,1,1,1,11.23,2.0,44.92,0.01,8,0.5,2.5,3,5,3,3,0
3,1,0,0,1,1,1,11.23,2.0,44.92,0.01,8,0.5,2.5,3,5,3,3,0
2,1,0,0,1,1,1,9.6,2.5,60.0,0.01,8,0.4,3.33,3,5,3,2,0
14,5,0,0,3,2,1,27.33,6.75,1245.22,0.06,42,0.15,69.18,18,24,12,14,0
2,1,0,0,1,1,1,9.6,2.5,60.0,0.01,8,0.4,3.33,3,5,3,2,0
10,3,0,0,2,2,1,24.0,4.67,522.66,0.04,28,0.21,29.04,12,16,9,10,0
15,13,0,6,7,5,6,17.56,40.8,29225.2,0.24,142,0.02,1623.62,68,74,15,15,0
2,1,0,1,1,1,1,10.57,3.0,95.1,0.01,10,0.33,5.28,3,7,3,2,0
112,41,11,44,21,16,13,64.76,51.77,173605.3,1.12,526,0.02,9644.74,227,299,57,123,0
58,17,3,16,9,7,6,33.47,42.95,61740.82,0.48,233,0.02,3430.05,96,137,38,61,0
2,1,4,0,1,1,1,21.13,9.0,1711.48,0.06,44,0.11,95.08,18,26,10,6,0
1,1,0,0,1,1,1,0.0,0.0,0.0,0.0,1,0.0,0.0,0,1,0,1,0
20,7,0,5,4,2,3,33.9,9.9,3325.75,0.11,66,0.1,184.76,32,34,21,20,0
4,1,0,0,1,1,1,21.18,2.67,150.59,0.02,17,0.38,8.37,8,9,6,4,0
5,1,1,2,1,1,1,27.88,3.3,303.6,0.03,23,0.3,16.87,11,12,10,6,0
4,1,0,0,1,1,1,10.24,7.0,501.89,0.02,20,0.14,27.88,7,13,4,4,0
4,3,0,0,2,2,1,21.5,7.15,1099.18,0.05,35,0.14,61.07,13,22,10,4,0
8,3,0,0,2,2,1,23.46,10.29,2485.24,0.08,52,0.1,138.07,19,33,12,8,0
54,13,1,8,7,6,6,25.11,40.0,40181.42,0.33,184,0.03,2232.3,80,104,22,55,0
0,1,0,0,1,1,1,8.3,6.67,369.01,0.02,16,0.15,20.5,5,11,3,0,0
23,5,0,1,3,2,1,19.78,20.04,7940.87,0.13,80,0.05,441.16,33,47,14,23,0
0,1,0,0,1,1,1,8.6,7.5,483.97,0.02,18,0.13,26.89,5,13,3,0,0
19,5,0,3,3,3,1,19.07,10.91,2270.01,0.07,46,0.09,126.11,20,26,11,19,0
19,5,0,3,3,3,1,20.96,10.5,2310.82,0.07,48,0.1,128.38,21,27,12,19,0
12,3,0,2,2,2,1,14.73,8.94,1176.94,0.04,31,0.11,65.39,13,18,8,12,0
12,9,0,0,5,3,3,17.46,16.55,4779.2,0.1,63,0.06,265.51,28,35,11,12,0
4,1,0,0,1,1,1,9.47,2.67,67.38,0.01,9,0.38,3.74,4,5,3,4,0
13,5,0,0,3,3,1,16.4,7.07,820.29,0.04,29,0.14,45.57,11,18,7,13,0
13,5,0,0,3,3,1,17.24,7.5,969.51,0.04,31,0.13,53.86,12,19,8,13,0
4,3,0,0,2,2,1,11.99,6.67,533.03,0.03,21,0.15,29.61,10,11,6,4,0
0,1,0,0,1,1,1,6.55,3.0,58.95,0.01,7,0.33,3.28,1,6,1,0,0
0,3,0,0,2,2,1,6.69,7.5,376.42,0.02,14,0.13,20.91,5,9,3,0,0
0,1,0,0,1,1,1,7.86,2.5,49.13,0.01,7,0.4,2.73,2,5,2,0,0
0,3,0,0,2,2,1,9.32,5.0,233.02,0.02,13,0.2,12.95,5,8,4,0,0
0,1,0,0,1,1,1,6.55,3.0,58.95,0.01,7,0.33,3.28,1,6,1,0,0
0,3,0,0,2,2,1,6.69,7.5,376.42,0.02,14,0.13,20.91,5,9,3,0,0
0,1,0,0,1,1,1,7.86,2.5,49.13,0.01,7,0.4,2.73,2,5,2,0,0
0,3,0,0,2,2,1,9.32,5.0,233.02,0.02,13,0.2,12.95,5,8,4,0,0
6,1,0,0,1,1,1,17.51,5.0,437.85,0.03,23,0.2,24.32,10,13,7,6,0
0,3,0,0,2,2,1,7.75,2.0,31.02,0.01,6,0.5,1.72,2,4,2,0,0
0,3,0,0,2,2,1,7.86,2.5,49.13,0.01,7,0.4,2.73,2,5,2,0,0
11,7,0,0,4,2,3,12.35,16.0,3162.47,0.07,45,0.06,175.69,16,29,7,11,0
11,7,0,0,4,2,3,12.35,16.0,3162.47,0.07,45,0.06,175.69,16,29,7,11,0
3,3,0,0,2,2,1,14.28,4.0,228.44,0.02,15,0.25,12.69,6,9,6,3,0
0,1,0,0,1,1,1,7.75,2.0,31.02,0.01,6,0.5,1.72,2,4,2,0,0
0,1,0,0,1,1,1,7.75,2.0,31.02,0.01,6,0.5,1.72,2,4,2,0,0
0,1,0,0,1,1,1,0.0,0.0,0.0,0.0,1,0.0,0.0,0,1,0,0,0
2,1,0,0,1,1,1,13.5,2.0,54.0,0.01,9,0.5,3.0,4,5,4,2,0
0,1,0,0,1,1,1,7.75,2.0,31.02,0.01,6,0.5,1.72,2,4,2,0,0
0,1,0,0,1,1,1,7.75,2.0,31.02,0.01,6,0.5,1.72,2,4,2,0,0
0,1,0,0,1,1,1,9.83,2.0,39.3,0.01,7,0.5,2.18,3,4,3,0,0
0,1,0,0,1,1,1,9.83,2.0,39.3,0.01,7,0.5,2.18,3,4,3,0,0
0,1,0,0,1,1,1,7.75,2.0,31.02,0.01,6,0.5,1.72,2,4,2,0,0
0,1,0,0,1,1,1,7.74,1.5,17.41,0.0,5,0.67,0.97,2,3,2,0,0
1,1,0,0,1,1,1,7.74,1.5,17.41,0.0,5,0.67,0.97,2,3,2,1,0
0,1,0,0,1,1,1,5.8,2.0,23.22,0.0,5,0.5,1.29,1,4,1,0,0
2,1,0,0,1,1,1,7.75,2.0,31.02,0.01,6,0.5,1.72,2,4,2,2,0
1,1,0,1,1,1,1,0.0,0.0,0.0,0.0,1,0.0,0.0,0,1,0,1,0
2,1,0,0,1,1,1,7.75,2.0,31.02,0.01,6,0.5,1.72,2,4,2,2,0
0,1,0,0,1,1,1,9.31,2.5,58.16,0.01,9,0.4,3.23,1,8,1,0,0
0,1,0,0,1,1,1,7.75,2.0,31.02,0.01,6,0.5,1.72,2,4,2,0,0
10,7,0,3,4,3,4,26.1,9.43,2320.6,0.08,53,0.11,128.91,24,29,14,10,0
10,7,0,3,4,3,4,26.1,9.43,2320.6,0.08,53,0.11,128.91,24,29,14,10,0
18,13,1,7,1,1,1,35.01,12.33,5325.61,0.14,88,0.08,295.87,37,51,18,19,0
18,13,1,7,1,1,1,35.01,12.33,5325.61,0.14,88,0.08,295.87,37,51,18,19,0
0,1,0,0,1,1,1,10.68,4.67,232.53,0.02,15,0.21,12.92,4,11,3,0,0
7,5,0,0,3,2,1,11.89,13.13,2048.55,0.05,35,0.08,113.81,15,20,8,7,0
7,5,0,0,3,2,1,11.89,13.13,2048.55,0.05,35,0.08,113.81,15,20,8,7,0
5,3,0,0,2,2,1,17.22,4.08,287.09,0.02,19,0.24,15.95,7,12,6,5,0
4,3,0,0,2,2,1,11.18,5.63,353.85,0.02,17,0.18,19.66,5,12,4,4,0
0,1,0,0,1,1,1,0.0,0.0,0.0,0.0,0,0.0,0.0,0,0,0,0,0
0,1,0,0,1,1,1,6.2,2.5,38.77,0.01,6,0.4,2.15,1,5,1,0,0
0,1,0,0,1,1,1,0.0,0.0,0.0,0.0,1,0.0,0.0,0,1,0,0,0
0,1,0,0,1,1,1,0.0,0.0,0.0,0.0,0,0.0,0.0,0,0,0,0,0
0,1,0,0,1,1,1,0.0,0.0,0.0,0.0,3,0.0,0.0,0,3,0,0,0
0,1,0,0,1,1,1,0.0,0.0,0.0,0.0,2,0.0,0.0,0,2,0,0,0
0,1,0,0,1,1,1,5.33,1.5,12.0,0.0,4,0.67,0.67,1,3,1,0,0
0,1,0,0,1,1,1,5.33,1.5,12.0,0.0,4,0.67,0.67,1,3,1,0,0
0,1,0,0,1,1,1,11.86,3.5,145.3,0.01,12,0.29,8.07,4,8,4,0,0
0,1,0,0,1,1,1,0.0,0.0,0.0,0.0,0,0.0,0.0,0,0,0,0,0
0,1,0,0,1,1,1,0.0,0.0,0.0,0.0,0,0.0,0.0,0,0,0,0,0
0,1,0,0,1,1,1,0.0,0.0,0.0,0.0,0,0.0,0.0,0,0,0,0,0
0,1,0,0,1,1,1,0.0,0.0,0.0,0.0,1,0.0,0.0,0,1,0,0,0
0,1,0,0,1,1,1,7.33,4.5,148.5,0.01,11,0.22,8.25,3,8,2,0,0
8,3,0,0,2,1,1,15.07,9.75,1432.72,0.05,34,0.1,79.6,13,21,8,8,0
8,3,0,0,2,1,1,15.07,9.75,1432.72,0.05,34,0.1,79.6,13,21,8,8,0
0,1,0,0,1,1,1,0.0,0.0,0.0,0.0,1,0.0,0.0,0,1,0,0,0
0,1,0,0,1,1,1,7.74,1.5,17.41,0.0,5,0.67,0.97,2,3,2,0,0
0,1,0,0,1,1,1,9.6,2.5,60.0,0.01,8,0.4,3.33,3,5,3,0,0
0,1,0,0,1,1,1,7.75,2.0,31.02,0.01,6,0.5,1.72,2,4,2,0,0
0,1,0,0,1,1,1,7.75,2.0,31.02,0.01,6,0.5,1.72,2,4,2,0,0
0,1,0,0,1,1,1,6.86,3.5,84.0,0.01,8,0.29,4.67,1,7,1,0,0
0,1,0,0,1,1,1,7.74,1.5,17.41,0.0,5,0.67,0.97,2,3,2,0,0
0,1,0,0,1,1,1,7.75,2.0,31.02,0.01,6,0.5,1.72,2,4,2,0,0
0,1,0,0,1,1,1,7.75,2.0,31.02,0.01,6,0.5,1.72,2,4,2,0,0
9,1,0,0,1,1,1,16.05,10.31,1708.46,0.06,39,0.1,94.91,15,24,8,9,0
9,1,0,0,1,1,1,16.05,10.31,1708.46,0.06,39,0.1,94.91,15,24,8,9,0
0,1,0,0,1,1,1,8.3,6.0,298.97,0.02,15,0.17,16.61,3,12,2,0,0
0,1,0,0,1,1,1,8.3,6.0,298.97,0.02,15,0.17,16.61,3,12,2,0,0
0,1,0,0,1,1,1,8.3,6.0,298.97,0.02,15,0.17,16.61,3,12,2,0,0
0,1,0,0,1,1,1,5.33,1.5,12.0,0.0,4,0.67,0.67,1,3,1,0,0
0,1,0,0,1,1,1,5.33,1.5,12.0,0.0,4,0.67,0.67,1,3,1,0,0
0,1,0,0,1,1,1,5.33,1.5,12.0,0.0,4,0.67,0.67,1,3,1,0,0
0,1,0,0,1,1,1,5.33,1.5,12.0,0.0,4,0.67,0.67,1,3,1,0,0
0,1,0,0,1,1,1,5.33,1.5,12.0,0.0,4,0.67,0.67,1,3,1,0,0
0,1,0,0,1,1,1,5.33,1.5,12.0,0.0,4,0.67,0.67,1,3,1,0,0
0,1,0,0,1,1,1,5.33,1.5,12.0,0.0,4,0.67,0.67,1,3,1,0,0
0,1,0,0,1,1,1,5.33,1.5,12.0,0.0,4,0.67,0.67,1,3,1,0,0
0,1,0,0,1,1,1,5.33,1.5,12.0,0.0,4,0.67,0.67,1,3,1,0,0
0,1,0,0,1,1,1,5.33,1.5,12.0,0.0,4,0.67,0.67,1,3,1,0,0
0,1,0,0,1,1,1,5.33,1.5,12.0,0.0,4,0.67,0.67,1,3,1,0,0
0,1,0,0,1,1,1,5.33,1.5,12.0,0.0,4,0.67,0.67,1,3,1,0,0
0,1,0,0,1,1,1,7.75,2.0,31.02,0.01,6,0.5,1.72,2,4,2,0,0
0,1,0,0,1,1,1,7.75,2.0,31.02,0.01,6,0.5,1.72,2,4,2,0,0
0,1,0,0,1,1,1,7.75,2.0,31.02,0.01,6,0.5,1.72,2,4,2,0,0
0,1,0,0,1,1,1,7.75,2.0,31.02,0.01,6,0.5,1.72,2,4,2,0,0
4,3,0,0,2,2,1,8.54,5.83,290.67,0.02,15,0.17,16.14,5,10,3,4,0
4,3,0,0,2,2,1,8.54,5.83,290.67,0.02,15,0.17,16.14,5,10,3,4,0
8,5,0,0,3,3,1,14.4,10.0,1440.0,0.05,36,0.1,80.0,12,24,6,8,0
8,5,0,0,3,3,1,14.4,10.0,1440.0,0.05,36,0.1,80.0,12,24,6,8,0
3,1,0,0,1,1,1,9.51,3.0,85.59,0.01,9,0.33,4.75,3,6,3,3,0
3,1,0,0,1,1,1,9.51,3.0,85.59,0.01,9,0.33,4.75,3,6,3,3,0
5,3,0,0,2,2,1,15.36,3.5,188.21,0.02,15,0.29,10.46,5,10,5,5,0
5,3,0,0,2,2,1,15.36,3.5,188.21,0.02,15,0.29,10.46,5,10,5,5,0
4,3,0,0,2,2,1,10.88,5.6,341.29,0.02,17,0.18,18.96,8,9,5,4,0
4,3,0,0,2,2,1,10.88,5.6,341.29,0.02,17,0.18,18.96,8,9,5,4,0
0,1,0,0,1,1,1,7.74,1.5,17.41,0.0,5,0.67,0.97,2,3,2,0,0
0,1,0,0,1,1,1,7.74,1.5,17.41,0.0,5,0.67,0.97,2,3,2,0,0
2,1,0,0,1,1,1,7.35,8.0,470.48,0.02,17,0.13,26.14,6,11,3,2,0
0,1,0,0,1,1,1,12.68,2.5,79.25,0.01,10,0.4,4.4,4,6,4,0,0
0,1,0,0,1,1,1,12.68,2.5,79.25,0.01,10,0.4,4.4,4,6,4,0,0
0,1,0,0,1,1,1,7.74,1.5,17.41,0.0,5,0.67,0.97,2,3,2,0,0
0,1,0,0,1,1,1,7.74,1.5,17.41,0.0,5,0.67,0.97,2,3,2,0,0
0,1,0,0,1,1,1,7.75,2.0,31.02,0.01,6,0.5,1.72,2,4,2,0,0
0,1,0,0,1,1,1,7.75,2.0,31.02,0.01,6,0.5,1.72,2,4,2,0,0
0,1,0,0,1,1,1,7.75,2.0,31.02,0.01,6,0.5,1.72,2,4,2,0,0
0,1,0,0,1,1,1,7.75,2.0,31.02,0.01,6,0.5,1.72,2,4,2,0,0
0,1,0,0,1,1,1,7.75,2.0,31.02,0.01,6,0.5,1.72,2,4,2,0,0
0,1,0,0,1,1,1,7.75,2.0,31.02,0.01,6,0.5,1.72,2,4,2,0,0
0,1,0,0,1,1,1,7.75,2.0,31.02,0.01,6,0.5,1.72,2,4,2,0,0
0,1,0,0,1,1,1,7.75,2.0,31.02,0.01,6,0.5,1.72,2,4,2,0,0
2,1,0,0,1,1,1,7.81,9.0,632.78,0.02,19,0.11,35.15,8,11,4,2,0
0,1,0,0,1,1,1,7.75,2.0,31.02,0.01,6,0.5,1.72,2,4,2,0,0
0,1,0,0,1,1,1,7.75,2.0,31.02,0.01,6,0.5,1.72,2,4,2,0,0
0,1,0,0,1,1,1,7.75,2.0,31.02,0.01,6,0.5,1.72,2,4,2,0,0
0,1,0,0,1,1,1,7.75,2.0,31.02,0.01,6,0.5,1.72,2,4,2,0,0
0,1,0,0,1,1,1,7.74,1.5,17.41,0.0,5,0.67,0.97,2,3,2,0,0
0,1,0,0,1,1,1,5.33,1.5,12.0,0.0,4,0.67,0.67,1,3,1,0,0
0,3,0,0,2,1,1,7.75,2.0,31.02,0.01,6,0.5,1.72,2,4,2,0,0
0,3,0,0,2,1,1,7.75,2.0,31.02,0.01,6,0.5,1.72,2,4,2,0,0
0,1,0,0,1,1,1,5.8,2.0,23.22,0.0,5,0.5,1.29,1,4,1,0,0
0,1,0,0,1,1,1,5.8,2.0,23.22,0.0,5,0.5,1.29,1,4,1,0,0
0,3,0,0,2,1,1,7.75,2.0,31.02,0.01,6,0.5,1.72,2,4,2,0,0
0,3,0,0,2,1,1,7.75,2.0,31.02,0.01,6,0.5,1.72,2,4,2,0,0
0,1,0,0,1,1,1,12.18,3.0,109.62,0.01,11,0.33,6.09,4,7,4,0,0
0,1,0,0,1,1,1,7.75,2.0,31.02,0.01,6,0.5,1.72,2,4,2,0,0
0,1,0,0,1,1,1,7.75,2.0,31.02,0.01,6,0.5,1.72,2,4,2,0,0
0,1,0,0,1,1,1,7.75,2.0,31.02,0.01,6,0.5,1.72,2,4,2,0,0
0,1,0,0,1,1,1,7.75,2.0,31.02,0.01,6,0.5,1.72,2,4,2,0,0
0,1,0,0,1,1,1,7.75,2.0,31.02,0.01,6,0.5,1.72,2,4,2,0,0
0,1,0,0,1,1,1,7.75,2.0,31.02,0.01,6,0.5,1.72,2,4,2,0,0
0,1,0,0,1,1,1,5.8,2.0,23.22,0.0,5,0.5,1.29,1,4,1,0,0
0,1,0,0,1,1,1,5.8,2.0,23.22,0.0,5,0.5,1.29,1,4,1,0,0
0,1,0,0,1,1,1,7.75,2.0,31.02,0.01,6,0.5,1.72,2,4,2,0,0
0,1,0,0,1,1,1,7.75,2.0,31.02,0.01,6,0.5,1.72,2,4,2,0,0
2,1,0,0,1,1,1,8.98,2.5,56.15,0.01,8,0.4,3.12,2,6,2,2,0
2,1,0,0,1,1,1,8.98,2.5,56.15,0.01,8,0.4,3.12,2,6,2,2,0
2,1,0,0,1,1,1,5.33,1.5,12.0,0.0,4,0.67,0.67,1,3,1,2,0
0,1,0,0,1,1,1,5.33,1.5,12.0,0.0,4,0.67,0.67,1,3,1,0,0
2,1,0,0,1,1,1,5.33,1.5,12.0,0.0,4,0.67,0.67,1,3,1,2,0
2,1,0,0,1,1,1,5.33,1.5,12.0,0.0,4,0.67,0.67,1,3,1,2,0
2,1,0,0,1,1,1,5.33,1.5,12.0,0.0,4,0.67,0.67,1,3,1,2,0
3,1,0,0,1,1,1,12.0,2.5,75.0,0.01,10,0.4,4.17,3,7,3,3,0
0,1,0,0,1,1,1,7.86,2.5,49.13,0.01,7,0.4,2.73,2,5,2,0,0
0,1,0,0,1,1,1,6.55,3.0,58.95,0.01,7,0.33,3.28,1,6,1,0,0
0,1,0,0,1,1,1,6.55,3.0,58.95,0.01,7,0.33,3.28,1,6,1,0,0
2,1,0,0,1,1,1,8.98,2.5,56.15,0.01,8,0.4,3.12,2,6,2,2,0
2,1,0,0,1,1,1,8.98,2.5,56.15,0.01,8,0.4,3.12,2,6,2,2,0
2,1,0,0,1,1,1,5.33,1.5,12.0,0.0,4,0.67,0.67,1,3,1,2,0
0,1,0,0,1,1,1,5.33,1.5,12.0,0.0,4,0.67,0.67,1,3,1,0,0
2,1,0,0,1,1,1,5.33,1.5,12.0,0.0,4,0.67,0.67,1,3,1,2,0
2,1,0,0,1,1,1,5.33,1.5,12.0,0.0,4,0.67,0.67,1,3,1,2,0
2,1,0,0,1,1,1,5.33,1.5,12.0,0.0,4,0.67,0.67,1,3,1,2,0
0,1,0,0,1,1,1,5.33,1.5,12.0,0.0,4,0.67,0.67,1,3,1,0,0
0,1,0,0,1,1,1,5.33,1.5,12.0,0.0,4,0.67,0.67,1,3,1,0,0
0,1,0,0,1,1,1,7.86,2.5,49.13,0.01,7,0.4,2.73,2,5,2,0,0
0,1,0,0,1,1,1,0.0,0.0,0.0,0.0,3,0.0,0.0,0,3,0,0,0
0,1,0,0,1,1,1,7.75,2.0,31.02,0.01,6,0.5,1.72,2,4,2,0,0
0,1,0,0,1,1,1,7.75,2.0,31.02,0.01,6,0.5,1.72,2,4,2,0,0
3,1,0,0,1,1,1,11.23,2.0,44.92,0.01,8,0.5,2.5,3,5,3,3,0
3,1,0,0,1,1,1,11.23,2.0,44.92,0.01,8,0.5,2.5,3,5,3,3,0
0,1,0,0,1,1,1,9.29,1.5,20.9,0.0,6,0.67,1.16,2,4,2,0,0
0,1,0,0,1,1,1,9.29,1.5,20.9,0.0,6,0.67,1.16,2,4,2,0,0
27,7,0,4,1,1,1,34.35,13.68,6431.58,0.16,94,0.07,357.31,40,54,19,27,0
27,7,0,4,1,1,1,34.35,13.68,6431.58,0.16,94,0.07,357.31,40,54,19,27,0
20,11,0,1,1,1,1,21.1,18.56,7271.57,0.13,77,0.05,403.98,33,44,16,20,0
20,11,0,1,1,1,1,21.1,18.56,7271.57,0.13,77,0.05,403.98,33,44,16,20,0
27,7,0,4,1,1,1,34.35,13.68,6431.58,0.16,94,0.07,357.31,40,54,19,27,0
27,7,0,4,1,1,1,34.35,13.68,6431.58,0.16,94,0.07,357.31,40,54,19,27,0
0,1,0,0,1,1,1,9.29,1.5,20.9,0.0,6,0.67,1.16,2,4,2,0,0
0,1,0,0,1,1,1,11.23,2.0,44.92,0.01,8,0.5,2.5,3,5,3,0,0
0,1,0,0,1,1,1,9.29,1.5,20.9,0.0,6,0.67,1.16,2,4,2,0,0
0,1,0,0,1,1,1,11.23,2.0,44.92,0.01,8,0.5,2.5,3,5,3,0,0
0,1,0,0,1,1,1,9.0,3.0,81.0,0.01,9,0.33,4.5,2,7,2,0,0
0,1,0,0,1,1,1,9.0,3.0,81.0,0.01,9,0.33,4.5,2,7,2,0,0
0,1,0,0,1,1,1,8.3,6.0,298.97,0.02,15,0.17,16.61,3,12,2,0,0
0,1,0,0,1,1,1,7.74,1.5,17.41,0.0,5,0.67,0.97,2,3,2,0,0
0,1,0,0,1,1,1,7.74,1.5,17.41,0.0,5,0.67,0.97,2,3,2,0,0
0,1,0,0,1,1,1,7.74,1.5,17.41,0.0,5,0.67,0.97,2,3,2,0,0
0,1,0,0,1,1,1,7.74,1.5,17.41,0.0,5,0.67,0.97,2,3,2,0,0
0,1,0,0,1,1,1,7.74,1.5,17.41,0.0,5,0.67,0.97,2,3,2,0,0
0,1,0,0,1,1,1,7.74,1.5,17.41,0.0,5,0.67,0.97,2,3,2,0,0
0,1,0,0,1,1,1,9.51,3.0,85.59,0.01,9,0.33,4.75,3,6,3,0,0
0,1,0,0,1,1,1,9.51,3.0,85.59,0.01,9,0.33,4.75,3,6,3,0,0
0,1,0,0,1,1,1,9.51,3.0,85.59,0.01,9,0.33,4.75,3,6,3,0,0
0,1,0,0,1,1,1,9.51,3.0,85.59,0.01,9,0.33,4.75,3,6,3,0,0
4,3,0,0,2,2,1,13.67,6.0,492.27,0.03,21,0.17,27.35,6,15,5,4,0
36,21,4,16,11,10,11,57.99,23.06,30850.19,0.45,245,0.04,1713.9,110,135,31,40,0
36,21,4,16,11,10,11,57.99,23.06,30850.19,0.45,245,0.04,1713.9,110,135,31,40,0
0,1,0,0,1,1,1,7.74,1.5,17.41,0.0,5,0.67,0.97,2,3,2,0,0
0,1,0,0,1,1,1,5.33,1.5,12.0,0.0,4,0.67,0.67,1,3,1,0,0
11,6,0,0,5,1,1,22.96,8.8,1778.01,0.07,46,0.11,98.78,16,30,10,11,0
102,37,4,15,24,7,9,51.95,61.33,195431.3,1.06,485,0.02,10857.29,184,301,57,106,0
1,1,1,0,1,1,1,7.75,2.0,31.02,0.01,6,0.5,1.72,2,4,2,2,0
1,1,1,0,1,1,1,7.75,2.0,31.02,0.01,6,0.5,1.72,2,4,2,2,0
23,9,2,7,5,3,1,28.49,33.47,31908.79,0.32,189,0.03,1772.71,63,126,16,25,0
23,9,2,7,5,3,1,28.49,33.47,31908.79,0.32,189,0.03,1772.71,63,126,16,25,0
1,1,1,0,1,1,1,7.75,2.0,31.02,0.01,6,0.5,1.72,2,4,2,2,0
1,1,1,0,1,1,1,7.75,2.0,31.02,0.01,6,0.5,1.72,2,4,2,2,0
25,17,0,7,9,8,3,19.39,47.27,43326.7,0.31,185,0.02,2407.04,52,133,11,25,0
25,17,0,7,9,8,3,19.39,47.27,43326.7,0.31,185,0.02,2407.04,52,133,11,25,0
14,11,0,0,6,1,1,17.97,17.6,5565.94,0.11,72,0.06,309.22,32,40,10,14,0
14,11,0,0,6,1,1,17.97,17.6,5565.94,0.11,72,0.06,309.22,32,40,10,14,0
7,9,0,0,5,2,5,17.33,16.67,4814.21,0.1,63,0.06,267.46,20,43,9,7,0
7,9,0,0,5,2,5,17.33,16.67,4814.21,0.1,63,0.06,267.46,20,43,9,7,0
9,3,0,5,2,2,1,14.0,22.75,7248.03,0.11,75,0.04,402.67,21,54,6,9,0
9,3,0,5,2,2,1,14.0,22.75,7248.03,0.11,75,0.04,402.67,21,54,6,9,0
10,7,1,6,4,3,1,18.31,21.0,8074.56,0.13,85,0.05,448.59,27,58,9,11,0
10,7,1,6,4,3,1,18.31,21.0,8074.56,0.13,85,0.05,448.59,27,58,9,11,0
23,13,0,10,7,6,1,22.04,34.83,26748.53,0.26,155,0.03,1486.03,44,111,12,23,0
23,13,0,10,7,6,1,22.04,34.83,26748.53,0.26,155,0.03,1486.03,44,111,12,23,0
20,11,0,7,6,5,1,18.59,38.0,26850.51,0.24,144,0.03,1491.69,44,100,11,20,0
20,11,0,7,6,5,1,18.59,38.0,26850.51,0.24,144,0.03,1491.69,44,100,11,20,0
31,5,1,9,1,1,1,41.76,30.85,39750.32,0.43,236,0.03,2208.35,98,138,27,32,0
31,5,1,9,1,1,1,41.76,30.85,39750.32,0.43,236,0.03,2208.35,98,138,27,32,0
14,5,1,0,3,1,1,18.47,12.0,2659.85,0.07,49,0.08,147.77,22,27,11,15,0
14,5,1,0,3,1,1,18.47,12.0,2659.85,0.07,49,0.08,147.77,22,27,11,15,0
18,7,1,1,4,1,1,19.65,14.0,3851.37,0.09,60,0.07,213.96,28,32,12,19,0
18,7,1,1,4,1,1,19.65,14.0,3851.37,0.09,60,0.07,213.96,28,32,12,19,0
1,1,0,1,1,1,1,0.0,0.0,0.0,0.0,1,0.0,0.0,0,1,0,1,0
1,1,0,1,1,1,1,0.0,0.0,0.0,0.0,1,0.0,0.0,0,1,0,1,0
22,5,0,1,1,1,1,32.46,17.2,9603.65,0.19,108,0.06,533.54,43,65,20,22,0
22,5,0,1,1,1,1,32.46,17.2,9603.65,0.19,108,0.06,533.54,43,65,20,22,0
30,5,0,8,1,1,1,43.11,26.77,30890.51,0.38,214,0.04,1716.14,87,127,26,30,0
30,5,0,8,1,1,1,43.11,26.77,30890.51,0.38,214,0.04,1716.14,87,127,26,30,0
17,3,0,8,1,1,1,46.97,32.0,48098.41,0.5,277,0.03,2672.13,108,169,27,17,0
17,3,0,8,1,1,1,46.97,32.0,48098.41,0.5,277,0.03,2672.13,108,169,27,17,0
84,53,2,3,1,1,1,29.6,96.43,275199.03,0.95,511,0.01,15288.83,150,361,21,86,0
84,53,2,3,1,1,1,29.6,96.43,275199.03,0.95,511,0.01,15288.83,150,361,21,86,0
40,13,4,16,7,2,1,36.91,36.02,47887.35,0.44,245,0.03,2660.41,91,154,24,44,0
40,13,4,16,7,2,1,36.91,36.02,47887.35,0.44,245,0.03,2660.41,91,154,24,44,0
32,7,2,11,4,2,1,53.48,21.25,24147.68,0.38,215,0.05,1341.54,68,147,24,34,0
32,7,2,11,4,2,1,53.48,21.25,24147.68,0.38,215,0.05,1341.54,68,147,24,34,0
79,27,0,21,15,8,5,40.13,53.57,115173.52,0.72,357,0.02,6398.53,133,224,36,79,0
79,27,0,21,15,8,5,40.13,53.57,115173.52,0.72,357,0.02,6398.53,133,224,36,79,0
29,7,0,1,5,2,1,26.8,24.09,15548.84,0.22,123,0.04,863.82,39,84,17,29,0
29,7,0,1,5,2,1,26.8,24.09,15548.84,0.22,123,0.04,863.82,39,84,17,29,0
44,27,0,9,1,1,1,30.59,55.52,94302.8,0.57,313,0.02,5239.04,106,207,21,44,0
44,27,0,9,1,1,1,30.59,55.52,94302.8,0.57,313,0.02,5239.04,106,207,21,44,0
34,13,0,10,7,2,1,24.46,36.42,32440.57,0.3,171,0.03,1802.25,69,102,18,34,0
34,13,0,10,7,2,1,24.46,36.42,32440.57,0.3,171,0.03,1802.25,69,102,18,34,0
19,9,3,10,5,4,1,26.77,18.5,9160.41,0.17,103,0.05,508.91,37,66,14,22,0
19,9,3,10,5,4,1,26.77,18.5,9160.41,0.17,103,0.05,508.91,37,66,14,22,0
24,13,0,15,7,3,4,14.41,32.63,15335.18,0.16,100,0.03,851.95,29,71,8,24,0
24,13,0,15,7,3,4,14.41,32.63,15335.18,0.16,100,0.03,851.95,29,71,8,24,0
14,5,2,1,3,2,1,13.41,20.57,5676.42,0.09,61,0.05,315.36,18,43,7,16,0
14,5,2,1,3,2,1,13.41,20.57,5676.42,0.09,61,0.05,315.36,18,43,7,16,0
22,7,0,5,4,3,1,19.25,27.0,14034.71,0.17,107,0.04,779.71,33,74,11,22,0
22,7,0,5,4,3,1,19.25,27.0,14034.71,0.17,107,0.04,779.71,33,74,11,22,0
6,5,0,4,3,2,1,12.2,11.14,1514.69,0.05,32,0.09,84.15,13,19,7,6,0
6,5,0,4,3,2,1,12.2,11.14,1514.69,0.05,32,0.09,84.15,13,19,7,6,0
3,3,2,2,2,2,1,7.17,12.0,1032.47,0.03,24,0.08,57.36,8,16,3,5,0
3,3,2,2,2,2,1,7.17,12.0,1032.47,0.03,24,0.08,57.36,8,16,3,5,0
15,15,2,3,1,1,1,27.8,22.5,14073.95,0.21,116,0.04,781.89,45,71,21,17,0
15,15,2,3,1,1,1,27.8,22.5,14073.95,0.21,116,0.04,781.89,45,71,21,17,0
8,7,0,7,4,1,1,12.17,13.5,2217.15,0.05,38,0.07,123.17,18,20,8,8,0
8,7,0,7,4,1,1,12.17,13.5,2217.15,0.05,38,0.07,123.17,18,20,8,8,0
25,1,0,5,1,1,1,188.48,4.9,4519.03,0.31,155,0.2,251.06,142,13,58,25,0
25,1,0,5,1,1,1,188.48,4.9,4519.03,0.31,155,0.2,251.06,142,13,58,25,0
3,1,0,2,1,1,1,14.24,3.5,174.4,0.02,15,0.29,9.69,7,8,5,3,0
3,1,0,2,1,1,1,14.24,3.5,174.4,0.02,15,0.29,9.69,7,8,5,3,0
64,39,1,16,1,1,1,32.06,61.5,121246.74,0.66,353,0.02,6735.93,123,230,24,65,0
64,39,1,16,1,1,1,32.06,61.5,121246.74,0.66,353,0.02,6735.93,123,230,24,65,0
8,3,0,6,2,2,1,15.92,12.57,2516.25,0.07,48,0.08,139.79,16,32,7,8,0
8,3,0,6,2,2,1,15.92,12.57,2516.25,0.07,48,0.08,139.79,16,32,7,8,0
1,1,0,1,1,1,1,0.0,0.0,0.0,0.0,1,0.0,0.0,0,1,0,1,0
1,1,0,1,1,1,1,0.0,0.0,0.0,0.0,1,0.0,0.0,0,1,0,1,0
46,27,0,17,14,7,7,41.77,50.94,108403.19,0.71,381,0.02,6022.4,131,250,27,46,0
46,27,0,17,14,7,7,41.77,50.94,108403.19,0.71,381,0.02,6022.4,131,250,27,46,0
8,3,1,4,2,2,1,16.92,18.69,5909.86,0.11,72,0.05,328.33,23,49,8,9,0
8,3,1,4,2,2,1,16.92,18.69,5909.86,0.11,72,0.05,328.33,23,49,8,9,0
1,1,1,0,1,1,1,7.75,2.0,31.02,0.01,6,0.5,1.72,2,4,2,2,0
1,1,1,0,1,1,1,7.75,2.0,31.02,0.01,6,0.5,1.72,2,4,2,2,0
24,9,1,11,5,3,1,30.2,31.5,29967.7,0.32,187,0.03,1664.87,63,124,17,25,0
24,9,1,11,5,3,1,30.2,31.5,29967.7,0.32,187,0.03,1664.87,63,124,17,25,0
1,1,1,0,1,1,1,7.75,2.0,31.02,0.01,6,0.5,1.72,2,4,2,2,0
1,1,1,0,1,1,1,7.75,2.0,31.02,0.01,6,0.5,1.72,2,4,2,2,0
7,7,0,0,4,2,4,11.7,22.5,5922.55,0.09,56,0.04,329.03,20,36,8,7,0
7,7,0,0,4,2,4,11.7,22.5,5922.55,0.09,56,0.04,329.03,20,36,8,7,0
32,25,0,8,13,9,10,20.97,37.71,29831.94,0.26,153,0.03,1657.33,48,105,14,32,0
32,25,0,8,13,9,10,20.97,37.71,29831.94,0.26,153,0.03,1657.33,48,105,14,32,0
8,3,0,0,2,2,1,14.46,17.33,4344.21,0.08,59,0.06,241.35,16,43,6,8,0
8,3,0,0,1,1,1,16.87,14.86,3724.27,0.08,58,0.07,206.9,16,42,7,8,0
7,1,0,1,1,1,1,10.8,13.75,2041.35,0.05,38,0.07,113.41,10,28,4,7,0
7,1,0,1,1,1,1,13.45,11.0,1628.0,0.05,37,0.09,90.44,10,27,5,7,0
10,7,0,2,1,1,1,24.11,14.64,5165.66,0.12,76,0.07,286.98,23,53,11,10,0
10,7,0,2,4,4,1,21.54,17.25,6408.52,0.12,80,0.06,356.03,23,57,10,10,0
11,3,1,6,1,1,1,19.16,13.22,3349.45,0.08,56,0.08,186.08,17,39,9,12,0
11,3,1,6,2,2,1,17.84,14.0,3496.19,0.08,56,0.07,194.23,16,40,8,12,0
15,5,1,1,3,3,1,24.61,21.25,11114.55,0.17,110,0.05,617.47,34,76,12,16,0
15,5,1,1,1,1,1,26.71,19.62,10278.49,0.17,109,0.05,571.03,34,75,13,16,0
3,1,0,4,1,1,1,10.8,2.5,67.5,0.01,9,0.4,3.75,3,6,3,3,0
3,1,0,4,1,1,1,11.23,2.0,44.92,0.01,8,0.5,2.5,3,5,3,3,0
10,5,0,7,3,2,1,12.03,14.3,2459.6,0.06,43,0.07,136.64,13,30,5,10,0
10,5,0,7,1,1,1,14.41,11.92,2045.78,0.06,42,0.08,113.65,13,29,6,10,0
1,1,0,1,1,1,1,0.0,0.0,0.0,0.0,1,0.0,0.0,0,1,0,1,0
1,1,0,1,1,1,1,0.0,0.0,0.0,0.0,1,0.0,0.0,0,1,0,1,0
16,3,4,7,1,1,1,26.44,18.67,9212.86,0.16,105,0.05,511.83,32,73,12,20,0
16,3,4,7,2,2,1,25.19,19.73,9802.34,0.17,107,0.05,544.57,31,76,11,20,0
100,30,4,24,19,4,4,44.28,51.35,116742.55,0.76,365,0.02,6485.7,138,227,43,104,0
100,30,4,24,19,4,4,44.28,51.35,116742.55,0.76,365,0.02,6485.7,138,227,43,104,0
17,3,0,2,2,2,1,17.73,24.89,10980.14,0.15,95,0.04,610.01,28,67,9,17,0
17,3,0,2,2,2,1,17.73,24.89,10980.14,0.15,95,0.04,610.01,28,67,9,17,0
26,23,1,10,1,1,1,22.44,50.0,56093.69,0.37,217,0.02,3116.32,80,137,16,27,0
26,23,1,10,1,1,1,22.44,50.0,56093.69,0.37,217,0.02,3116.32,80,137,16,27,0
48,21,6,14,11,2,1,26.08,61.0,97037.94,0.53,288,0.02,5391.0,122,166,23,54,0
48,21,6,14,11,2,1,26.08,61.0,97037.94,0.53,288,0.02,5391.0,122,166,23,54,0
71,55,4,17,1,1,1,35.59,83.83,250072.91,0.99,516,0.01,13892.94,187,329,29,75,0
71,55,4,17,1,1,1,35.59,83.83,250072.91,0.99,516,0.01,13892.94,187,329,29,75,0
13,3,0,3,2,1,1,18.83,17.73,5916.14,0.11,71,0.06,328.67,26,45,11,13,0
13,3,0,3,2,1,1,18.83,17.73,5916.14,0.11,71,0.06,328.67,26,45,11,13,0
22,9,2,5,5,2,1,12.71,44.0,24612.08,0.19,122,0.02,1367.34,44,78,8,24,0
22,9,2,5,5,2,1,12.71,44.0,24612.08,0.19,122,0.02,1367.34,44,78,8,24,0
22,7,0,5,4,3,1,18.66,30.14,16950.51,0.19,117,0.03,941.7,39,78,11,22,0
22,7,0,5,4,3,1,18.66,30.14,16950.51,0.19,117,0.03,941.7,39,78,11,22,0
30,13,0,10,8,7,1,24.11,30.69,22712.31,0.25,148,0.03,1261.79,42,106,13,30,0
30,13,0,10,8,7,1,24.11,30.69,22712.31,0.25,148,0.03,1261.79,42,106,13,30,0
23,5,2,8,3,3,1,17.39,29.75,15389.5,0.17,116,0.03,854.97,34,82,8,25,0
23,5,2,8,3,3,1,17.39,29.75,15389.5,0.17,116,0.03,854.97,34,82,8,25,0
2,1,0,0,1,1,1,7.75,2.0,31.02,0.01,6,0.5,1.72,2,4,2,2,0
2,1,0,0,1,1,1,7.75,2.0,31.02,0.01,6,0.5,1.72,2,4,2,2,0
21,5,0,3,3,1,1,27.89,28.39,22482.91,0.26,163,0.04,1249.05,53,110,14,21,0
21,5,0,3,3,1,1,27.89,28.39,22482.91,0.26,163,0.04,1249.05,53,110,14,21,0
15,5,1,0,3,1,1,20.67,11.5,2733.62,0.08,55,0.09,151.87,23,32,10,16,0
15,5,1,0,3,1,1,20.67,11.5,2733.62,0.08,55,0.09,151.87,23,32,10,16,0
29,9,2,5,5,1,1,35.48,36.0,45981.46,0.43,240,0.03,2554.53,88,152,22,31,0
29,9,2,5,5,1,1,35.48,36.0,45981.46,0.43,240,0.03,2554.53,88,152,22,31,0
20,5,1,0,3,2,1,24.4,15.79,6079.8,0.13,81,0.06,337.77,34,47,14,21,0
20,5,1,0,3,2,1,24.4,15.79,6079.8,0.13,81,0.06,337.77,34,47,14,21,0
28,9,1,2,1,1,1,26.8,21.03,11848.79,0.19,109,0.05,658.27,47,62,19,29,0
28,9,1,2,1,1,1,26.8,21.03,11848.79,0.19,109,0.05,658.27,47,62,19,29,0
1,1,1,0,1,1,1,7.75,2.0,31.02,0.01,6,0.5,1.72,2,4,2,2,0
1,1,1,0,1,1,1,7.75,2.0,31.02,0.01,6,0.5,1.72,2,4,2,2,0
29,11,0,12,1,1,1,18.41,40.19,29742.31,0.25,148,0.02,1652.35,55,93,13,29,0
29,11,0,12,1,1,1,18.41,40.19,29742.31,0.25,148,0.02,1652.35,55,93,13,29,0
4,1,0,2,1,1,1,12.63,3.33,140.37,0.01,15,0.3,7.8,5,10,3,4,0
4,1,0,2,1,1,1,12.63,3.33,140.37,0.01,15,0.3,7.8,5,10,3,4,0
57,35,3,14,1,1,1,36.94,52.98,103685.35,0.65,345,0.02,5760.3,129,216,28,60,0
57,35,3,14,1,1,1,36.94,52.98,103685.35,0.65,345,0.02,5760.3,129,216,28,60,0
24,19,0,7,10,5,6,17.9,36.67,24063.7,0.22,129,0.03,1336.87,40,89,12,24,0
24,19,0,7,10,5,6,17.9,36.67,24063.7,0.22,129,0.03,1336.87,40,89,12,24,0
10,9,0,6,5,4,4,9.32,19.6,3580.15,0.06,43,0.05,198.9,14,29,5,10,0
10,9,0,6,5,4,4,9.32,19.6,3580.15,0.06,43,0.05,198.9,14,29,5,10,0
4,1,0,2,1,1,1,12.55,4.5,254.13,0.02,17,0.22,14.12,6,11,4,4,0
4,1,0,2,1,1,1,12.55,4.5,254.13,0.02,17,0.22,14.12,6,11,4,4,0
34,21,0,4,11,2,5,26.07,35.6,33036.05,0.31,170,0.03,1835.34,65,105,21,34,0
34,21,0,4,11,2,5,26.07,35.6,33036.05,0.31,170,0.03,1835.34,65,105,21,34,0
4,1,0,2,1,1,1,16.59,5.79,555.43,0.03,24,0.17,30.86,9,15,7,4,0
4,1,0,2,1,1,1,15.86,4.67,345.37,0.02,20,0.21,19.19,8,12,6,4,0
2,1,1,1,1,1,1,8.4,4.0,134.42,0.01,13,0.25,7.47,4,9,2,3,0
2,1,1,1,1,1,1,8.4,4.0,134.42,0.01,13,0.25,7.47,4,9,2,3,0
11,1,4,1,1,1,1,33.7,8.91,2674.82,0.1,72,0.11,148.6,28,44,11,15,0
11,1,4,1,1,1,1,33.7,8.91,2674.82,0.1,72,0.11,148.6,28,44,11,15,0
50,5,24,8,3,1,1,62.73,51.81,168419.65,1.08,582,0.02,9356.65,279,303,35,74,0
50,5,24,8,3,1,1,62.73,51.81,168419.65,1.08,582,0.02,9356.65,279,303,35,74,0
50,5,24,8,3,1,1,56.97,63.22,227673.63,1.2,652,0.02,12648.53,289,363,32,74,0
50,5,24,8,3,1,1,56.97,63.22,227673.63,1.2,652,0.02,12648.53,289,363,32,74,0
66,5,20,21,1,1,1,57.98,97.74,553920.61,1.89,1026,0.01,30773.37,404,622,31,86,0
66,5,20,21,1,1,1,57.98,97.74,553920.61,1.89,1026,0.01,30773.37,404,622,31,86,0
95,7,18,22,4,2,1,59.36,107.9,691137.63,2.14,1045,0.01,38396.53,441,604,47,113,0
95,7,18,22,4,2,1,59.36,107.9,691137.63,2.14,1045,0.01,38396.53,441,604,47,113,0
107,9,22,28,5,1,1,60.81,116.23,821531.72,2.36,1178,0.01,45640.65,476,702,43,129,0
107,9,22,28,5,1,1,60.81,116.23,821531.72,2.36,1178,0.01,45640.65,476,702,43,129,0
127,9,23,35,1,1,1,54.4,166.38,1505756.7,3.02,1520,0.01,83653.15,605,915,40,150,0
127,9,23,35,1,1,1,54.4,166.38,1505756.7,3.02,1520,0.01,83653.15,605,915,40,150,0
8,1,0,3,1,1,1,31.35,9.97,3114.36,0.1,65,0.1,173.02,23,42,15,8,0
8,1,0,3,1,1,1,31.35,9.97,3114.36,0.1,65,0.1,173.02,23,42,15,8,0
46,15,11,12,1,1,1,35.44,92.28,301801.36,1.09,571,0.01,16766.74,223,348,29,57,0
46,15,11,12,1,1,1,35.44,92.28,301801.36,1.09,571,0.01,16766.74,223,348,29,57,0
71,11,19,12,1,1,1,42.96,127.76,701291.3,1.83,937,0.01,38960.63,362,575,34,90,0
71,11,19,12,1,1,1,42.96,127.76,701291.3,1.83,937,0.01,38960.63,362,575,34,90,0
2,1,0,3,1,1,1,7.75,2.0,31.02,0.01,6,0.5,1.72,2,4,2,2,0
2,1,0,3,1,1,1,7.75,2.0,31.02,0.01,6,0.5,1.72,2,4,2,2,0
6,5,0,0,3,3,1,30.72,9.0,2488.36,0.09,62,0.11,138.24,18,44,11,6,0
6,5,0,0,3,3,1,30.72,9.0,2488.36,0.09,62,0.11,138.24,18,44,11,6,0
6,5,0,0,3,3,1,30.72,9.0,2488.36,0.09,62,0.11,138.24,18,44,11,6,0
6,5,0,0,3,3,1,30.72,9.0,2488.36,0.09,62,0.11,138.24,18,44,11,6,0
2,1,0,0,1,1,1,7.74,1.5,17.41,0.0,5,0.67,0.97,2,3,2,2,0
2,1,0,0,1,1,1,7.74,1.5,17.41,0.0,5,0.67,0.97,2,3,2,2,0
2,1,0,0,1,1,1,7.74,1.5,17.41,0.0,5,0.67,0.97,2,3,2,2,0
2,1,0,0,1,1,1,7.74,1.5,17.41,0.0,5,0.67,0.97,2,3,2,2,0
2,1,0,0,1,1,1,7.86,2.5,49.13,0.01,7,0.4,2.73,2,5,2,2,0
2,1,0,0,1,1,1,7.86,2.5,49.13,0.01,7,0.4,2.73,2,5,2,2,0
2,1,0,0,1,1,1,7.86,2.5,49.13,0.01,7,0.4,2.73,2,5,2,2,0
2,1,0,0,1,1,1,7.86,2.5,49.13,0.01,7,0.4,2.73,2,5,2,2,0
2,1,0,0,1,1,1,8.98,2.5,56.15,0.01,8,0.4,3.12,2,6,2,2,0
2,1,0,0,1,1,1,8.98,2.5,56.15,0.01,8,0.4,3.12,2,6,2,2,0
1,1,1,0,1,1,1,5.33,1.5,12.0,0.0,4,0.67,0.67,1,3,1,2,0
1,1,1,0,1,1,1,5.33,1.5,12.0,0.0,4,0.67,0.67,1,3,1,2,0
1,1,0,1,1,1,1,0.0,0.0,0.0,0.0,1,0.0,0.0,0,1,0,1,0
1,1,0,1,1,1,1,0.0,0.0,0.0,0.0,1,0.0,0.0,0,1,0,1,0
6,3,0,0,2,2,1,25.86,9.27,2223.13,0.08,53,0.11,123.51,17,36,11,6,0
6,3,0,0,2,2,1,25.86,9.27,2223.13,0.08,53,0.11,123.51,17,36,11,6,0
6,1,0,1,1,1,1,20.58,10.5,2269.01,0.07,50,0.1,126.06,14,36,8,6,0
6,1,0,1,1,1,1,20.58,10.5,2269.01,0.07,50,0.1,126.06,14,36,8,6,0
2,1,2,4,1,1,1,22.58,8.13,1490.75,0.06,44,0.12,82.82,13,31,8,4,0
2,1,2,4,1,1,1,22.58,8.13,1490.75,0.06,44,0.12,82.82,13,31,8,4,0
6,1,0,1,1,1,1,22.84,10.0,2284.01,0.08,52,0.1,126.89,15,37,9,6,0
6,1,0,1,1,1,1,22.84,10.0,2284.01,0.08,52,0.1,126.89,15,37,9,6,0
22,11,1,5,6,5,5,29.78,29.7,26264.9,0.29,164,0.03,1459.16,54,110,20,23,0
22,11,1,5,6,5,5,29.78,29.7,26264.9,0.29,164,0.03,1459.16,54,110,20,23,0
6,3,0,1,2,1,1,14.38,4.5,291.26,0.02,17,0.22,16.18,5,12,5,6,0
6,3,0,1,2,1,1,14.38,4.5,291.26,0.02,17,0.22,16.18,5,12,5,6,0
18,7,2,4,4,4,1,32.35,20.43,13494.29,0.22,125,0.05,749.68,43,82,20,20,0
18,7,2,4,4,4,1,32.35,20.43,13494.29,0.22,125,0.05,749.68,43,82,20,20,0
15,3,1,0,2,2,1,56.19,14.88,12432.2,0.28,156,0.07,690.68,42,114,24,16,0
15,3,1,0,2,2,1,56.19,14.88,12432.2,0.28,156,0.07,690.68,42,114,24,16,0
7,7,1,1,4,4,1,28.43,11.45,3730.7,0.11,72,0.09,207.26,21,51,11,8,0
7,7,1,1,4,4,1,28.43,11.45,3730.7,0.11,72,0.09,207.26,21,51,11,8,0
18,5,1,3,3,3,1,31.92,18.79,11268.26,0.2,116,0.05,626.01,42,74,19,19,0
18,5,1,3,3,3,1,31.92,18.79,11268.26,0.2,116,0.05,626.01,42,74,19,19,0
16,15,5,6,8,3,1,30.35,17.85,9670.83,0.18,104,0.06,537.27,42,62,20,21,0
16,15,5,6,8,3,1,28.89,17.89,9251.44,0.17,100,0.06,513.97,40,60,19,21,0
15,3,1,0,2,2,1,56.19,14.88,12432.2,0.28,156,0.07,690.68,42,114,24,16,0
15,3,1,0,2,2,1,56.19,14.88,12432.2,0.28,156,0.07,690.68,42,114,24,16,0
7,7,1,1,4,4,1,28.43,11.45,3730.7,0.11,72,0.09,207.26,21,51,11,8,0
7,7,1,1,4,4,1,28.43,11.45,3730.7,0.11,72,0.09,207.26,21,51,11,8,0
20,5,1,3,3,3,1,32.61,21.25,14723.22,0.23,133,0.05,817.96,50,83,20,21,0
20,5,1,3,3,3,1,32.61,21.25,14723.22,0.23,133,0.05,817.96,50,83,20,21,0
2,1,0,0,1,1,1,7.74,1.5,17.41,0.0,5,0.67,0.97,2,3,2,2,0
2,1,0,0,1,1,1,7.74,1.5,17.41,0.0,5,0.67,0.97,2,3,2,2,0
2,1,0,0,1,1,1,7.86,2.5,49.13,0.01,7,0.4,2.73,2,5,2,2,0
2,1,0,0,1,1,1,7.86,2.5,49.13,0.01,7,0.4,2.73,2,5,2,2,0
2,1,0,0,1,1,1,8.98,2.5,56.15,0.01,8,0.4,3.12,2,6,2,2,0
1,1,2,0,1,1,1,11.23,2.0,44.92,0.01,8,0.5,2.5,3,5,3,3,0
1,1,2,0,1,1,1,11.23,2.0,44.92,0.01,8,0.5,2.5,3,5,3,3,0
1,1,0,3,1,1,1,0.0,0.0,0.0,0.0,1,0.0,0.0,0,1,0,1,0
1,1,0,3,1,1,1,0.0,0.0,0.0,0.0,1,0.0,0.0,0,1,0,1,0
8,7,0,1,4,4,1,21.93,12.0,3157.28,0.09,59,0.08,175.4,20,39,10,8,0
8,7,0,1,4,4,1,21.93,12.0,3157.28,0.09,59,0.08,175.4,20,39,10,8,0
2,1,0,3,1,1,1,7.75,2.0,31.02,0.01,6,0.5,1.72,2,4,2,2,0
2,1,0,3,1,1,1,7.75,2.0,31.02,0.01,6,0.5,1.72,2,4,2,2,0
6,5,0,0,3,3,1,30.72,9.0,2488.36,0.09,62,0.11,138.24,18,44,11,6,0
6,5,0,0,3,3,1,30.72,9.0,2488.36,0.09,62,0.11,138.24,18,44,11,6,0
6,5,0,0,3,3,1,30.72,9.0,2488.36,0.09,62,0.11,138.24,18,44,11,6,0
6,5,0,0,3,3,1,30.72,9.0,2488.36,0.09,62,0.11,138.24,18,44,11,6,0
2,1,0,0,1,1,1,8.0,1.0,8.0,0.0,4,1.0,0.44,2,2,2,2,0
2,1,0,0,1,1,1,8.0,1.0,8.0,0.0,4,1.0,0.44,2,2,2,2,0
2,1,0,0,1,1,1,8.0,1.0,8.0,0.0,4,1.0,0.44,2,2,2,2,0
2,1,0,0,1,1,1,8.0,1.0,8.0,0.0,4,1.0,0.44,2,2,2,2,0
2,1,0,0,1,1,1,7.86,2.5,49.13,0.01,7,0.4,2.73,2,5,2,2,0
2,1,0,0,1,1,1,7.86,2.5,49.13,0.01,7,0.4,2.73,2,5,2,2,0
2,1,0,0,1,1,1,7.86,2.5,49.13,0.01,7,0.4,2.73,2,5,2,2,0
2,1,0,0,1,1,1,7.86,2.5,49.13,0.01,7,0.4,2.73,2,5,2,2,0
11,11,1,8,6,1,1,14.66,18.2,4857.4,0.09,59,0.05,269.86,28,31,10,12,0
11,11,1,8,6,1,1,14.66,18.2,4857.4,0.09,59,0.05,269.86,28,31,10,12,0
2,1,0,6,1,1,1,5.8,2.0,23.22,0.0,5,0.5,1.29,1,4,1,2,0
2,1,0,6,1,1,1,5.8,2.0,23.22,0.0,5,0.5,1.29,1,4,1,2,0
1,1,0,1,1,1,1,0.0,0.0,0.0,0.0,1,0.0,0.0,0,1,0,1,0
6,3,0,0,2,2,1,25.86,9.27,2223.13,0.08,53,0.11,123.51,17,36,11,6,0
29,11,0,3,6,3,1,20.31,38.25,29720.31,0.26,146,0.03,1651.13,51,95,16,29,0
29,11,0,3,6,3,1,20.31,38.25,29720.31,0.26,146,0.03,1651.13,51,95,16,29,0
17,11,4,7,6,4,3,22.38,33.06,24464.81,0.25,140,0.03,1359.16,46,94,16,21,0
17,11,4,7,6,4,3,22.38,33.06,24464.81,0.25,140,0.03,1359.16,46,94,16,21,0
29,11,0,3,6,3,1,20.31,38.25,29720.31,0.26,146,0.03,1651.13,51,95,16,29,0
29,11,0,3,6,3,1,20.31,38.25,29720.31,0.26,146,0.03,1651.13,51,95,16,29,0
41,25,9,9,13,6,5,22.2,65.6,95514.2,0.49,258,0.02,5306.34,95,163,21,50,0
41,25,9,9,13,6,5,22.2,65.6,95514.2,0.49,258,0.02,5306.34,95,163,21,50,0
72,27,5,17,14,6,1,24.57,81.89,164734.96,0.67,378,0.01,9151.94,134,244,18,77,0
72,27,5,17,14,6,1,24.57,81.89,164734.96,0.67,378,0.01,9151.94,134,244,18,77,0
12,3,4,2,2,2,1,23.17,19.08,8433.46,0.15,91,0.05,468.53,31,60,13,16,0
12,3,4,2,2,2,1,23.17,19.08,8433.46,0.15,91,0.05,468.53,31,60,13,16,0
12,3,4,2,2,2,1,23.17,19.08,8433.46,0.15,91,0.05,468.53,31,60,13,16,0
12,3,4,2,2,2,1,23.17,19.08,8433.46,0.15,91,0.05,468.53,31,60,13,16,0
2,1,0,0,1,1,1,7.74,1.5,17.41,0.0,5,0.67,0.97,2,3,2,2,0
2,1,0,0,1,1,1,7.74,1.5,17.41,0.0,5,0.67,0.97,2,3,2,2,0
2,1,0,0,1,1,1,7.86,2.5,49.13,0.01,7,0.4,2.73,2,5,2,2,0
2,1,0,0,1,1,1,7.86,2.5,49.13,0.01,7,0.4,2.73,2,5,2,2,0
2,1,0,0,1,1,1,5.33,1.5,12.0,0.0,4,0.67,0.67,1,3,1,2,0
1,1,1,0,1,1,1,5.33,1.5,12.0,0.0,4,0.67,0.67,1,3,1,2,0
1,1,0,1,1,1,1,0.0,0.0,0.0,0.0,1,0.0,0.0,0,1,0,1,0
2,1,0,0,1,1,1,6.53,9.0,529.29,0.02,17,0.11,29.41,4,13,2,2,0
2,1,0,0,1,1,1,6.53,9.0,529.29,0.02,17,0.11,29.41,4,13,2,2,0
19,7,0,2,1,1,1,26.29,17.5,8052.16,0.15,89,0.06,447.34,35,54,18,19,0
19,7,0,2,1,1,1,26.29,17.5,8052.16,0.15,89,0.06,447.34,35,54,18,19,0
2,1,0,0,1,1,1,18.5,4.0,296.04,0.02,20,0.25,16.45,5,15,5,2,0
2,1,0,0,1,1,1,18.5,4.0,296.04,0.02,20,0.25,16.45,5,15,5,2,0
11,3,0,0,2,2,1,22.86,9.75,2173.32,0.07,48,0.1,120.74,18,30,12,11,0
11,3,0,0,2,2,1,22.86,9.75,2173.32,0.07,48,0.1,120.74,18,30,12,11,0
2,1,0,0,1,1,1,7.83,4.67,170.53,0.01,11,0.21,9.47,4,7,3,2,0
2,1,0,0,1,1,1,7.83,4.67,170.53,0.01,11,0.21,9.47,4,7,3,2,0
3,1,0,0,1,1,1,7.12,7.0,348.8,0.02,15,0.14,19.38,6,9,3,3,0
3,1,0,0,1,1,1,7.12,7.0,348.8,0.02,15,0.14,19.38,6,9,3,3,0
2,1,0,0,1,1,1,13.95,2.5,87.17,0.01,11,0.4,4.84,4,7,4,2,0
2,1,0,0,1,1,1,13.95,2.5,87.17,0.01,11,0.4,4.84,4,7,4,2,0
38,13,1,5,7,6,1,52.13,20.79,22530.1,0.36,185,0.05,1251.67,79,106,38,39,0
114,32,8,35,19,17,7,66.2,43.06,122768.18,0.95,437,0.02,6820.45,178,259,62,122,0
20,5,0,2,3,2,1,47.47,8.64,3540.91,0.14,82,0.12,196.72,38,44,22,20,0
31,5,0,2,3,2,1,71.8,13.64,13361.04,0.33,171,0.07,742.28,76,95,39,31,0
22,5,0,2,3,2,1,53.26,9.1,4406.9,0.16,93,0.11,244.83,43,50,26,22,0
20,5,0,2,3,2,1,48.68,9.17,4090.6,0.15,87,0.11,227.26,40,47,24,20,0
20,5,0,2,3,2,1,50.07,8.26,3417.03,0.14,82,0.12,189.83,38,44,23,20,0
22,5,0,2,3,2,1,49.1,10.15,5062.23,0.17,95,0.1,281.24,44,51,26,22,0
14,3,3,2,2,2,1,36.62,12.93,6126.58,0.16,89,0.08,340.37,35,54,23,17,0
12,3,4,3,2,2,1,32.72,12.8,5360.18,0.14,81,0.08,297.79,32,49,20,16,0
13,3,3,2,2,2,1,37.23,13.91,7206.53,0.17,98,0.07,400.36,40,58,23,16,0
12,3,3,2,2,2,1,31.67,12.63,5053.69,0.13,78,0.08,280.76,30,48,19,15,0
14,3,3,2,2,2,1,36.93,12.36,5644.86,0.15,87,0.08,313.6,34,53,22,17,0
12,3,3,2,2,2,1,31.67,12.63,5053.69,0.13,78,0.08,280.76,30,48,19,15,0
12,3,3,2,2,2,1,31.67,12.63,5053.69,0.13,78,0.08,280.76,30,48,19,15,0
11,3,3,2,2,2,1,35.29,11.81,4921.69,0.14,80,0.08,273.43,31,49,21,14,0
14,3,3,3,2,2,1,36.93,12.36,5644.86,0.15,87,0.08,313.6,34,53,22,17,0
16,3,4,2,2,2,1,45.05,14.81,9887.86,0.22,123,0.07,549.33,50,73,27,20,0
21,5,0,2,3,2,1,55.05,8.2,3701.29,0.15,88,0.12,205.63,41,47,25,21,0
27,7,0,2,1,1,1,63.37,9.56,5794.85,0.2,111,0.1,321.94,51,60,32,27,0
17,3,0,3,2,2,1,67.24,3.38,769.25,0.08,51,0.3,42.74,23,28,17,17,0
5,1,6,0,1,1,1,31.76,6.79,1462.28,0.07,47,0.15,81.24,19,28,14,11,0
11,5,0,3,3,3,1,28.72,3.9,436.8,0.04,28,0.26,24.27,13,15,10,11,0
3,1,6,0,1,1,1,28.59,3.5,350.27,0.03,24,0.29,19.46,11,13,11,9,0
3,1,0,1,1,1,1,16.64,4.0,266.27,0.02,21,0.25,14.79,10,11,5,3,0
1,1,6,0,1,1,1,24.22,2.0,96.86,0.02,14,0.5,5.38,7,7,7,7,0
2,1,0,0,1,1,1,7.74,1.5,17.41,0.0,5,0.67,0.97,2,3,2,2,0
20,5,0,2,3,2,1,50.07,8.26,3417.03,0.14,82,0.12,189.83,38,44,23,20,0
20,5,0,2,3,2,1,50.07,8.26,3417.03,0.14,82,0.12,189.83,38,44,23,20,0
20,5,0,2,3,2,1,50.07,8.26,3417.03,0.14,82,0.12,189.83,38,44,23,20,0
20,5,0,2,3,2,1,50.07,8.26,3417.03,0.14,82,0.12,189.83,38,44,23,20,0
23,3,3,2,2,2,1,60.15,15.54,14530.58,0.31,164,0.06,807.25,64,100,35,26,0
22,5,0,2,3,2,1,50.43,10.62,5682.29,0.18,102,0.09,315.68,46,56,26,22,0
21,5,0,3,3,2,1,52.5,8.33,3646.02,0.15,86,0.12,202.56,40,46,24,21,0
23,5,0,3,3,2,1,44.11,14.07,8730.91,0.21,113,0.07,485.05,51,62,29,23,0
21,5,0,3,3,2,1,51.37,9.46,4597.3,0.16,94,0.11,255.41,43,51,25,21,0
23,5,0,2,3,2,1,51.71,10.22,5402.86,0.18,100,0.1,300.16,46,54,27,23,0
21,5,0,2,3,2,1,51.37,9.46,4597.3,0.16,94,0.11,255.41,43,51,25,21,0
21,5,0,3,3,2,1,51.37,9.46,4597.3,0.16,94,0.11,255.41,43,51,25,21,0
23,5,0,2,3,2,1,51.71,10.22,5402.86,0.18,100,0.1,300.16,46,54,27,23,0
20,5,0,2,3,2,1,50.07,8.26,3417.03,0.14,82,0.12,189.83,38,44,23,20,0
20,5,0,2,3,2,1,49.38,8.48,3549.72,0.14,83,0.12,197.21,39,44,23,20,0
11,1,0,3,1,1,1,39.02,7.43,2153.27,0.1,65,0.13,119.63,26,39,14,11,0
31,11,0,2,1,1,1,73.7,9.74,6995.99,0.24,130,0.1,388.67,62,68,35,31,0
14,5,3,4,3,1,1,21.23,13.64,3947.84,0.1,64,0.07,219.32,25,39,11,17,0
14,5,3,4,3,1,1,21.23,13.64,3947.84,0.1,64,0.07,219.32,25,39,11,17,0
24,9,0,0,5,1,3,17.84,15.0,4013.49,0.09,60,0.07,222.97,25,35,10,24,0
24,9,0,0,5,1,3,17.84,15.0,4013.49,0.09,60,0.07,222.97,25,35,10,24,0
6,3,1,1,2,2,1,8.36,9.0,677.56,0.03,21,0.11,37.64,9,12,4,7,0
6,3,1,1,2,2,1,8.36,9.0,677.56,0.03,21,0.11,37.64,9,12,4,7,0
7,3,3,0,2,1,1,8.72,13.0,1472.9,0.04,29,0.08,81.83,13,16,5,10,0
7,3,3,0,2,1,1,8.72,13.0,1472.9,0.04,29,0.08,81.83,13,16,5,10,0
22,9,0,1,5,2,1,15.64,22.56,7958.45,0.12,78,0.04,442.14,29,49,9,22,0
22,9,0,1,5,2,1,15.64,22.56,7958.45,0.12,78,0.04,442.14,29,49,9,22,0
13,5,0,0,3,1,3,12.22,9.17,1026.67,0.04,28,0.11,57.04,11,17,6,13,0
13,5,0,0,3,1,3,12.22,9.17,1026.67,0.04,28,0.11,57.04,11,17,6,13,0
9,3,0,0,2,1,1,8.51,8.0,544.91,0.02,19,0.13,30.27,8,11,4,9,0
9,3,0,0,2,1,1,8.51,8.0,544.91,0.02,19,0.13,30.27,8,11,4,9,0
11,3,0,0,2,2,1,11.18,9.6,1030.2,0.04,29,0.1,57.23,12,17,5,11,0
11,3,0,0,2,2,1,11.18,9.6,1030.2,0.04,29,0.1,57.23,12,17,5,11,0
14,5,0,0,3,1,3,13.88,10.21,1448.16,0.05,34,0.1,80.45,13,21,7,14,0
14,5,0,0,3,1,3,13.88,10.21,1448.16,0.05,34,0.1,80.45,13,21,7,14,0
19,9,0,0,5,1,4,12.61,16.63,3484.49,0.07,47,0.06,193.58,19,28,8,19,0
19,9,0,0,5,1,4,12.61,16.63,3484.49,0.07,47,0.06,193.58,19,28,8,19,0
33,9,0,1,5,3,5,13.21,29.25,11305.83,0.13,88,0.03,628.1,36,52,8,33,0
33,9,0,1,5,3,5,13.21,29.25,11305.83,0.13,88,0.03,628.1,36,52,8,33,0
21,6,0,3,1,1,1,19.91,14.4,4128.87,0.1,61,0.07,229.38,18,43,10,21,0
21,6,0,3,1,1,1,19.91,14.4,4128.87,0.1,61,0.07,229.38,18,43,10,21,0
205,69,15,54,39,31,22,80.6,73.26,432543.61,1.97,827,0.01,24030.2,323,504,97,220,0
205,69,15,54,39,31,22,80.6,73.26,432543.61,1.97,827,0.01,24030.2,323,504,97,220,0
7,5,0,0,3,2,3,12.73,6.75,580.17,0.03,22,0.15,32.22,9,13,6,7,0
7,5,0,0,3,2,3,12.73,6.75,580.17,0.03,22,0.15,32.22,9,13,6,7,0
3,1,0,0,1,1,1,6.74,3.75,94.75,0.01,9,0.27,5.26,3,6,2,3,0
3,1,0,0,1,1,1,6.74,3.75,94.75,0.01,9,0.27,5.26,3,6,2,3,0
2,1,0,0,1,1,1,7.74,1.5,17.41,0.0,5,0.67,0.97,2,3,2,2,0
2,1,0,0,1,1,1,7.74,1.5,17.41,0.0,5,0.67,0.97,2,3,2,2,0
4,1,0,0,1,1,1,28.17,5.0,704.36,0.05,37,0.2,39.13,18,19,9,4,0
4,1,0,0,1,1,1,28.17,5.0,704.36,0.05,37,0.2,39.13,18,19,9,4,0
2,1,0,0,1,1,1,7.74,1.5,17.41,0.0,5,0.67,0.97,2,3,2,2,0
2,1,0,0,1,1,1,7.74,1.5,17.41,0.0,5,0.67,0.97,2,3,2,2,0
198,61,16,32,35,28,18,73.58,80.67,478798.2,1.98,840,0.01,26599.9,330,510,90,214,0
198,61,16,32,35,28,18,73.58,80.67,478798.2,1.98,840,0.01,26599.9,330,510,90,214,0
3,1,0,0,1,1,1,6.74,3.75,94.75,0.01,9,0.27,5.26,3,6,2,3,0
3,1,0,0,1,1,1,6.74,3.75,94.75,0.01,9,0.27,5.26,3,6,2,3,0
4,1,0,0,1,1,1,28.17,5.0,704.36,0.05,37,0.2,39.13,18,19,9,4,0
4,1,0,0,1,1,1,28.17,5.0,704.36,0.05,37,0.2,39.13,18,19,9,4,0
2,1,0,0,1,1,1,7.74,1.5,17.41,0.0,5,0.67,0.97,2,3,2,2,0
2,1,0,0,1,1,1,7.74,1.5,17.41,0.0,5,0.67,0.97,2,3,2,2,0
11,1,12,6,1,1,1,134.27,3.82,1957.52,0.17,97,0.26,108.75,42,55,33,23,0
11,1,12,6,1,1,1,148.98,3.58,1912.92,0.18,99,0.28,106.27,43,56,36,23,0
8,1,13,85,1,1,1,99.91,4.15,1723.85,0.14,83,0.24,95.77,36,47,26,21,0
14,1,10,12,1,1,1,139.3,3.71,1913.08,0.17,97,0.27,106.28,42,55,34,24,0
4,1,9,4,1,1,1,71.1,2.66,501.69,0.06,43,0.38,27.87,17,26,16,13,0
8,1,12,8,1,1,1,98.83,3.96,1549.87,0.13,79,0.25,86.1,33,46,25,20,0
4,1,9,4,1,1,1,75.81,2.65,531.2,0.07,45,0.38,29.51,18,27,17,13,0
11,1,11,30,1,1,1,113.15,4.03,1841.77,0.15,89,0.25,102.32,39,50,29,22,0
14,1,10,12,1,1,1,134.27,3.82,1957.52,0.17,97,0.26,108.75,42,55,33,24,0
9,1,15,10,1,1,1,126.99,3.77,1808.86,0.16,92,0.26,100.49,39,53,31,24,0
19,9,8,7,5,4,1,55.28,6.0,1990.24,0.11,69,0.17,110.57,30,39,20,27,0
19,11,8,7,6,3,1,42.79,8.0,2738.82,0.11,72,0.13,152.16,32,40,18,27,0
8,1,12,8,1,1,1,108.16,3.78,1543.58,0.14,81,0.26,85.75,34,47,27,20,0
202,134,98,2,80,44,1,50.69,141.56,1015641.46,2.39,1037,0.01,56424.53,416,621,72,300,0
202,134,98,2,80,44,1,50.69,141.56,1015641.46,2.39,1037,0.01,56424.53,416,621,72,300,0
11,1,11,30,1,1,1,127.35,3.75,1790.86,0.16,91,0.27,99.49,40,51,32,22,0
9,1,15,10,1,1,1,116.97,4.03,1903.85,0.16,92,0.25,105.77,39,53,29,24,0
25,3,21,38,2,2,1,181.4,5.48,5450.52,0.33,167,0.18,302.81,74,93,54,46,0
8,1,13,85,1,1,1,114.32,3.72,1585.48,0.14,83,0.27,88.08,36,47,29,21,0
17,1,14,27,1,1,1,164.39,4.2,2899.87,0.23,125,0.24,161.1,56,69,40,31,0
25,3,21,38,2,2,1,189.28,5.36,5432.14,0.34,169,0.19,301.79,75,94,56,46,0
17,1,14,27,1,1,1,149.67,4.46,2976.38,0.22,123,0.22,165.35,55,68,37,31,0
2,1,0,3,1,1,1,0.0,0.0,0.0,0.0,3,0.0,0.0,0,3,0,2,0
9,1,0,0,1,1,1,110.73,3.48,1339.64,0.13,81,0.29,74.42,40,41,23,9,0
2,1,0,3,1,1,1,0.0,0.0,0.0,0.0,3,0.0,0.0,0,3,0,2,0
2,1,0,3,1,1,1,0.0,0.0,0.0,0.0,3,0.0,0.0,0,3,0,2,0
9,1,0,0,1,1,1,110.73,3.48,1339.64,0.13,81,0.29,74.42,40,41,23,9,0
2,1,0,3,1,1,1,0.0,0.0,0.0,0.0,3,0.0,0.0,0,3,0,2,0
2,1,0,3,1,1,1,0.0,0.0,0.0,0.0,3,0.0,0.0,0,3,0,2,0
2,1,0,3,1,1,1,0.0,0.0,0.0,0.0,3,0.0,0.0,0,3,0,2,0
2,1,0,3,1,1,1,0.0,0.0,0.0,0.0,3,0.0,0.0,0,3,0,2,0
2,1,0,3,1,1,1,0.0,0.0,0.0,0.0,3,0.0,0.0,0,3,0,2,0
2,1,0,3,1,1,1,0.0,0.0,0.0,0.0,3,0.0,0.0,0,3,0,2,0
2,1,0,3,1,1,1,0.0,0.0,0.0,0.0,3,0.0,0.0,0,3,0,2,0
13,5,2,0,3,2,3,55.64,8.25,3787.08,0.15,91,0.12,210.39,44,47,24,15,0
3,1,4,2,1,1,1,30.91,4.36,588.59,0.04,33,0.23,32.7,16,17,11,7,0
3,1,4,2,1,1,1,30.91,4.36,588.59,0.04,33,0.23,32.7,16,17,11,7,0
2,1,0,3,1,1,1,0.0,0.0,0.0,0.0,3,0.0,0.0,0,3,0,2,0
2,1,0,3,1,1,1,0.0,0.0,0.0,0.0,3,0.0,0.0,0,3,0,2,0
13,5,2,0,3,2,3,50.09,9.0,4057.49,0.15,91,0.11,225.42,44,47,22,15,0
7,5,1,0,3,1,1,13.48,4.67,293.57,0.02,17,0.21,16.3,8,9,6,8,0
7,5,1,0,3,1,1,13.48,4.67,293.57,0.02,17,0.21,16.3,8,9,6,8,0
12,1,0,23,1,1,1,68.52,2.5,428.25,0.06,39,0.4,23.79,16,23,16,12,0
12,1,0,23,1,1,1,68.52,2.5,428.25,0.06,39,0.4,23.79,16,23,16,12,0
12,1,0,23,1,1,1,68.52,2.5,428.25,0.06,39,0.4,23.79,16,23,16,12,0
12,1,0,23,1,1,1,68.52,2.5,428.25,0.06,39,0.4,23.79,16,23,16,12,0
6,1,0,19,1,1,1,34.06,2.0,136.23,0.02,19,0.5,7.57,8,11,8,6,0
6,1,0,19,1,1,1,34.06,2.0,136.23,0.02,19,0.5,7.57,8,11,8,6,0
6,1,7,1,1,1,1,83.2,3.33,924.42,0.09,59,0.3,51.36,28,31,21,13,0
6,1,7,1,1,1,1,83.2,3.33,924.42,0.09,59,0.3,51.36,28,31,21,13,0
11,1,1,23,1,1,1,68.52,2.5,428.25,0.06,39,0.4,23.79,16,23,16,12,0
13,1,0,24,1,1,1,74.92,2.5,468.24,0.06,42,0.4,26.01,17,25,17,13,0
11,1,1,23,1,1,1,68.52,2.5,428.25,0.06,39,0.4,23.79,16,23,16,12,0
13,1,0,24,1,1,1,74.92,2.5,468.24,0.06,42,0.4,26.01,17,25,17,13,0
13,1,0,24,1,1,1,74.92,2.5,468.24,0.06,42,0.4,26.01,17,25,17,13,0
12,1,0,23,1,1,1,68.52,2.5,428.25,0.06,39,0.4,23.79,16,23,16,12,0
13,1,0,24,1,1,1,74.92,2.5,468.24,0.06,42,0.4,26.01,17,25,17,13,0
12,1,0,23,1,1,1,68.52,2.5,428.25,0.06,39,0.4,23.79,16,23,16,12,0
12,1,0,23,1,1,1,68.52,2.5,428.25,0.06,39,0.4,23.79,16,23,16,12,0
13,1,0,24,1,1,1,74.92,2.5,468.24,0.06,42,0.4,26.01,17,25,17,13,0
12,1,0,23,1,1,1,68.52,2.5,428.25,0.06,39,0.4,23.79,16,23,16,12,0
13,1,0,24,1,1,1,74.92,2.5,468.24,0.06,42,0.4,26.01,17,25,17,13,0
2,1,1,0,1,1,1,11.23,2.0,44.92,0.01,8,0.5,2.5,3,5,3,3,0
0,1,0,0,1,1,1,5.33,1.5,12.0,0.0,4,0.67,0.67,1,3,1,0,0
0,1,0,0,1,1,1,5.33,1.5,12.0,0.0,4,0.67,0.67,1,3,1,0,0
3,1,0,0,1,1,1,11.23,2.0,44.92,0.01,8,0.5,2.5,3,5,3,3,0
3,1,0,0,1,1,1,11.23,2.0,44.92,0.01,8,0.5,2.5,3,5,3,3,0
2,1,0,0,1,1,1,5.8,2.0,23.22,0.0,5,0.5,1.29,1,4,1,2,0
0,1,0,0,1,1,1,0.0,0.0,0.0,0.0,0,0.0,0.0,0,0,0,0,0
4,3,0,2,2,1,1,11.71,7.33,629.47,0.03,21,0.14,34.97,8,13,6,4,0
8,7,0,4,4,4,1,21.25,8.73,1618.61,0.06,41,0.11,89.92,16,25,11,8,0
8,5,0,3,3,2,1,16.72,15.27,3900.84,0.09,55,0.07,216.71,24,31,11,8,0
20,15,0,10,8,2,7,19.19,29.18,16337.89,0.19,111,0.03,907.66,43,68,14,20,0
2,1,0,0,1,1,1,5.8,2.0,23.22,0.0,5,0.5,1.29,1,4,1,2,0
4,1,0,0,1,1,1,11.86,3.5,145.3,0.01,12,0.29,8.07,4,8,4,4,0
2,1,0,0,1,1,1,7.74,1.5,17.41,0.0,5,0.67,0.97,2,3,2,2,0
3,1,0,0,1,1,1,7.74,1.5,17.41,0.0,5,0.67,0.97,2,3,2,3,0
7,1,0,0,1,1,1,20.09,7.0,984.54,0.05,36,0.14,54.7,16,20,8,7,0
6,1,1,0,1,1,1,24.22,2.0,96.86,0.02,14,0.5,5.38,7,7,7,7,0
15,7,0,2,4,3,1,25.89,8.25,1762.34,0.07,46,0.12,97.91,21,25,14,15,0
2,1,0,0,1,1,1,9.6,2.5,60.0,0.01,8,0.4,3.33,3,5,3,2,0
7,1,0,0,1,1,1,20.84,7.88,1292.2,0.05,42,0.13,71.79,18,24,8,7,0
60,30,2,0,17,9,5,41.38,30.74,39089.48,0.42,219,0.03,2171.64,95,124,34,62,0
2,1,0,0,1,1,1,9.83,2.0,39.3,0.01,7,0.5,2.18,3,4,3,2,0
3,1,0,0,1,1,1,7.74,1.5,17.41,0.0,5,0.67,0.97,2,3,2,3,0
6,1,1,0,1,1,1,24.22,2.0,96.86,0.02,14,0.5,5.38,7,7,7,7,0
15,7,0,2,4,3,1,25.89,8.25,1762.34,0.07,46,0.12,97.91,21,25,14,15,0
0,1,0,0,1,1,1,5.33,1.5,12.0,0.0,4,0.67,0.67,1,3,1,0,0
4,3,0,0,2,1,1,11.52,3.75,161.94,0.01,13,0.27,9.0,5,8,4,4,0
0,1,0,0,1,1,1,0.0,0.0,0.0,0.0,1,0.0,0.0,0,1,0,0,0
3,1,0,0,1,1,1,11.63,2.0,46.53,0.01,9,0.5,2.58,4,5,3,3,0
3,1,0,0,1,1,1,11.63,2.0,46.53,0.01,9,0.5,2.58,4,5,3,3,0
3,1,0,0,1,1,1,8.54,4.67,186.03,0.01,12,0.21,10.33,4,8,3,3,0
3,1,0,0,1,1,1,8.54,4.67,186.03,0.01,12,0.21,10.33,4,8,3,3,0
5,3,3,1,2,2,1,16.07,4.5,325.53,0.02,19,0.22,18.08,9,10,7,8,0
5,3,3,1,2,2,1,16.07,4.5,325.53,0.02,19,0.22,18.08,9,10,7,8,0
11,3,0,0,2,2,1,37.46,4.85,879.68,0.06,42,0.21,48.87,18,24,13,11,0
11,3,0,0,2,2,1,37.46,4.85,879.68,0.06,42,0.21,48.87,18,24,13,11,0
4,1,0,0,1,1,1,8.0,4.5,162.0,0.01,12,0.22,9.0,3,9,2,4,0
4,1,0,0,1,1,1,8.0,4.5,162.0,0.01,12,0.22,9.0,3,9,2,4,0
42,13,2,8,7,1,1,15.91,36.75,21489.13,0.19,114,0.03,1193.84,49,65,14,44,0
42,13,2,8,7,1,1,15.91,36.75,21489.13,0.19,114,0.03,1193.84,49,65,14,44,0
3,1,0,0,1,1,1,10.57,3.0,95.1,0.01,10,0.33,5.28,3,7,3,3,0
3,1,0,0,1,1,1,10.57,3.0,95.1,0.01,10,0.33,5.28,3,7,3,3,0
32,11,2,0,6,1,3,19.66,21.25,8877.96,0.14,86,0.05,493.22,30,56,12,34,0
32,11,2,0,6,1,3,19.66,21.25,8877.96,0.14,86,0.05,493.22,30,56,12,34,0
4,1,0,0,1,1,1,12.34,3.5,151.15,0.01,13,0.29,8.4,3,10,3,4,0
4,1,0,0,1,1,1,12.34,3.5,151.15,0.01,13,0.29,8.4,3,10,3,4,0
5,1,0,0,1,1,1,15.11,6.3,599.66,0.03,25,0.16,33.31,7,18,5,5,0
5,1,0,0,1,1,1,15.11,6.3,599.66,0.03,25,0.16,33.31,7,18,5,5,0
14,3,0,1,2,1,1,14.94,18.33,5020.77,0.09,67,0.05,278.93,20,47,6,14,0
14,3,0,1,2,1,1,14.94,18.33,5020.77,0.09,67,0.05,278.93,20,47,6,14,0
14,5,3,0,3,1,1,11.98,22.0,5797.86,0.09,60,0.05,322.1,22,38,7,17,0
14,5,3,0,3,1,1,11.98,22.0,5797.86,0.09,60,0.05,322.1,22,38,7,17,0
51,13,0,3,7,3,4,21.8,47.14,48447.18,0.34,202,0.02,2691.51,66,136,14,51,0
51,13,0,3,7,3,4,21.8,47.14,48447.18,0.34,202,0.02,2691.51,66,136,14,51,0
13,3,0,0,2,1,1,20.04,11.0,2424.6,0.07,51,0.09,134.7,18,33,9,13,0
13,3,0,0,2,1,1,20.04,11.0,2424.6,0.07,51,0.09,134.7,18,33,9,13,0
17,3,0,0,2,1,1,9.69,23.38,5296.77,0.08,58,0.04,294.26,17,41,4,17,0
17,3,0,0,2,1,1,9.69,23.38,5296.77,0.08,58,0.04,294.26,17,41,4,17,0
16,5,2,0,3,1,1,13.18,22.0,6377.64,0.1,66,0.05,354.31,22,44,7,18,0
16,5,2,0,3,1,1,13.18,22.0,6377.64,0.1,66,0.05,354.31,22,44,7,18,0
10,1,0,2,1,1,1,11.49,9.33,1000.93,0.04,31,0.11,55.61,7,24,3,10,0
10,1,0,2,1,1,1,11.49,9.33,1000.93,0.04,31,0.11,55.61,7,24,3,10,0
23,5,3,3,3,2,1,22.86,16.25,6037.01,0.12,80,0.06,335.39,30,50,12,26,0
23,5,3,3,3,2,1,22.86,16.25,6037.01,0.12,80,0.06,335.39,30,50,12,26,0
23,5,3,3,3,2,1,25.44,17.0,7351.49,0.14,92,0.06,408.42,34,58,13,26,0
23,5,3,3,3,2,1,25.44,17.0,7351.49,0.14,92,0.06,408.42,34,58,13,26,0
10,3,0,0,2,1,1,12.16,10.08,1236.46,0.04,30,0.1,68.69,11,19,6,10,0
10,3,0,0,2,1,1,12.16,10.08,1236.46,0.04,30,0.1,68.69,11,19,6,10,0
6,1,0,0,1,1,1,11.68,5.33,332.11,0.02,18,0.19,18.45,4,14,3,6,0
6,1,0,0,1,1,1,11.68,5.33,332.11,0.02,18,0.19,18.45,4,14,3,6,0
30,11,6,1,6,4,4,29.0,15.0,6525.0,0.15,87,0.07,362.5,30,57,16,36,0
30,11,6,1,6,4,4,29.0,15.0,6525.0,0.15,87,0.07,362.5,30,57,16,36,0
2,1,0,0,1,1,1,11.39,3.5,139.52,0.01,12,0.29,7.75,3,9,3,2,0
2,1,0,0,1,1,1,11.39,3.5,139.52,0.01,12,0.29,7.75,3,9,3,2,0
70,27,2,9,14,11,9,28.64,36.53,38223.42,0.35,204,0.03,2123.52,69,135,17,72,0
70,27,2,9,14,11,9,28.64,36.53,38223.42,0.35,204,0.03,2123.52,69,135,17,72,0
14,1,0,0,1,1,1,15.29,13.8,2912.15,0.07,61,0.07,161.79,23,38,5,14,0
14,1,0,0,1,1,1,15.29,13.8,2912.15,0.07,61,0.07,161.79,23,38,5,14,0
8,3,0,2,2,2,1,9.47,12.38,1450.43,0.04,30,0.08,80.58,9,21,4,8,0
8,3,0,2,2,2,1,9.47,12.38,1450.43,0.04,30,0.08,80.58,9,21,4,8,0
16,7,0,6,4,3,1,11.2,18.2,3710.99,0.07,48,0.05,206.17,13,35,5,16,0
16,7,0,6,4,3,1,11.2,18.2,3710.99,0.07,48,0.05,206.17,13,35,5,16,0
90,27,1,11,14,8,11,40.63,23.63,22676.04,0.32,178,0.04,1259.78,63,115,24,91,0
90,27,1,11,14,8,11,40.63,23.63,22676.04,0.32,178,0.04,1259.78,63,115,24,91,0
37,15,0,8,8,3,4,21.56,24.07,12488.7,0.17,102,0.04,693.82,38,64,15,37,0
37,15,0,8,8,3,4,21.56,24.07,12488.7,0.17,102,0.04,693.82,38,64,15,37,0
5,1,0,0,1,1,1,19.81,2.4,114.12,0.02,15,0.42,6.34,6,9,5,5,0
5,1,0,0,1,1,1,19.81,2.4,114.12,0.02,15,0.42,6.34,6,9,5,5,0
0,1,0,0,1,1,1,5.33,1.5,12.0,0.0,4,0.67,0.67,1,3,1,0,0
0,1,0,0,1,1,1,5.33,1.5,12.0,0.0,4,0.67,0.67,1,3,1,0,0
0,1,0,0,1,1,1,5.33,1.5,12.0,0.0,4,0.67,0.67,1,3,1,0,0
0,1,0,0,1,1,1,5.33,1.5,12.0,0.0,4,0.67,0.67,1,3,1,0,0
0,1,0,0,1,1,1,5.33,1.5,12.0,0.0,4,0.67,0.67,1,3,1,0,0
0,1,0,0,1,1,1,5.33,1.5,12.0,0.0,4,0.67,0.67,1,3,1,0,0
0,1,0,0,1,1,1,5.33,1.5,12.0,0.0,4,0.67,0.67,1,3,1,0,0
0,1,0,0,1,1,1,5.33,1.5,12.0,0.0,4,0.67,0.67,1,3,1,0,0
0,1,0,0,1,1,1,5.33,1.5,12.0,0.0,4,0.67,0.67,1,3,1,0,0
0,1,0,0,1,1,1,5.33,1.5,12.0,0.0,4,0.67,0.67,1,3,1,0,0
0,1,0,0,1,1,1,5.33,1.5,12.0,0.0,4,0.67,0.67,1,3,1,0,0
0,1,0,0,1,1,1,5.33,1.5,12.0,0.0,4,0.67,0.67,1,3,1,0,0
0,1,0,0,1,1,1,7.74,1.5,17.41,0.0,5,0.67,0.97,2,3,2,0,0
0,1,0,0,1,1,1,7.74,1.5,17.41,0.0,5,0.67,0.97,2,3,2,0,0
0,1,0,0,1,1,1,7.74,1.5,17.41,0.0,5,0.67,0.97,2,3,2,0,0
0,1,0,0,1,1,1,7.74,1.5,17.41,0.0,5,0.67,0.97,2,3,2,0,0
0,1,0,0,1,1,1,7.74,1.5,17.41,0.0,5,0.67,0.97,2,3,2,0,0
0,1,0,0,1,1,1,7.74,1.5,17.41,0.0,5,0.67,0.97,2,3,2,0,0
0,1,0,0,1,1,1,9.47,2.67,67.38,0.01,9,0.38,3.74,4,5,3,0,0
0,1,0,0,1,1,1,7.74,1.5,17.41,0.0,5,0.67,0.97,2,3,2,0,0
0,1,0,0,1,1,1,5.33,1.5,12.0,0.0,4,0.67,0.67,1,3,1,0,0
10,1,0,0,1,1,1,40.82,7.75,2451.81,0.11,69,0.13,136.21,31,38,16,10,0
4,1,0,0,1,1,1,28.92,4.33,543.12,0.04,29,0.23,30.17,13,16,12,4,0
5,1,0,0,1,1,1,37.11,4.27,675.52,0.05,35,0.23,37.53,16,19,15,5,0
4,1,0,0,1,1,1,21.8,4.4,422.0,0.03,23,0.23,23.44,11,12,10,4,0
4,1,0,0,1,1,1,21.8,4.4,422.0,0.03,23,0.23,23.44,11,12,10,4,0
4,1,0,0,1,1,1,21.8,4.4,422.0,0.03,23,0.23,23.44,11,12,10,4,0
5,1,0,0,1,1,1,29.57,4.31,548.7,0.04,29,0.23,30.48,14,15,13,5,0
4,1,0,0,1,1,1,28.92,4.33,543.12,0.04,29,0.23,30.17,13,16,12,4,0
4,1,0,0,1,1,1,20.35,5.63,643.78,0.04,28,0.18,35.77,10,18,8,4,0
4,1,0,0,1,1,1,21.8,4.4,422.0,0.03,23,0.23,23.44,11,12,10,4,0
5,1,0,0,1,1,1,29.57,4.31,548.7,0.04,29,0.23,30.48,14,15,13,5,0
4,1,0,0,1,1,1,21.8,4.4,422.0,0.03,23,0.23,23.44,11,12,10,4,0
11,1,0,0,1,1,1,48.97,8.74,3736.43,0.14,91,0.11,207.58,33,58,17,11,0
11,1,0,0,1,1,1,48.97,8.74,3736.43,0.14,91,0.11,207.58,33,58,17,11,0
8,1,0,0,1,1,1,33.01,8.25,2246.67,0.09,62,0.12,124.82,22,40,12,8,0
11,1,0,0,1,1,1,44.21,8.72,3360.56,0.13,83,0.11,186.7,31,52,16,11,0
14,1,0,0,1,1,1,39.27,13.59,7250.91,0.18,111,0.07,402.83,42,69,17,14,0
11,1,0,0,1,1,1,25.92,14.86,5722.17,0.13,81,0.07,317.9,32,49,14,11,0
12,1,0,0,1,1,1,30.94,13.36,5520.55,0.14,89,0.07,306.7,34,55,14,12,0
9,1,0,0,1,1,1,23.11,12.0,3327.91,0.09,59,0.08,184.88,24,35,13,9,0
7,1,0,0,1,1,1,24.54,6.75,1118.27,0.06,39,0.15,62.13,15,24,10,7,0
7,1,0,0,1,1,1,24.54,6.75,1118.27,0.06,39,0.15,62.13,15,24,10,7,0
9,1,0,0,1,1,1,22.08,10.5,2434.85,0.08,52,0.1,135.27,21,31,11,9,0
9,1,0,0,1,1,1,22.08,10.5,2434.85,0.08,52,0.1,135.27,21,31,11,9,0
7,1,0,0,1,1,1,24.54,6.75,1118.27,0.06,39,0.15,62.13,15,24,10,7,0
148,40,2,0,31,26,1,71.68,133.17,1271153.09,3.18,1337,0.01,70619.62,470,867,90,150,0
214,49,4,26,34,28,4,94.84,75.8,544985.68,2.4,946,0.01,30276.98,414,532,142,218,0
3,1,0,0,1,1,1,11.58,2.67,82.35,0.01,11,0.38,4.57,4,7,3,3,0
12,3,2,1,2,1,1,39.68,12.67,6367.15,0.17,98,0.08,353.73,38,60,21,14,0
3,1,0,0,1,1,1,11.58,2.67,82.35,0.01,11,0.38,4.57,4,7,3,3,0
3,1,0,0,1,1,1,11.58,2.67,82.35,0.01,11,0.38,4.57,4,7,3,3,0
6,1,0,0,1,1,1,25.62,6.3,1016.95,0.05,38,0.16,56.5,14,24,10,6,0
6,1,0,0,1,1,1,22.64,7.0,1109.2,0.05,38,0.14,61.62,14,24,9,6,0
6,1,0,0,1,1,1,22.64,7.0,1109.2,0.05,38,0.14,61.62,14,24,9,6,0
5,1,1,0,1,1,1,20.15,5.14,532.86,0.03,28,0.19,29.6,12,16,7,6,0
6,1,0,0,1,1,1,22.64,7.0,1109.2,0.05,38,0.14,61.62,14,24,9,6,0
8,1,0,0,1,1,1,31.94,8.25,2174.2,0.09,60,0.12,120.79,22,38,12,8,0
8,1,0,0,1,1,1,31.94,8.25,2174.2,0.09,60,0.12,120.79,22,38,12,8,0
9,1,0,0,1,1,1,37.72,8.03,2435.45,0.1,67,0.12,135.3,25,42,14,9,0
3,1,0,0,1,1,1,11.58,2.67,82.35,0.01,11,0.38,4.57,4,7,3,3,0
9,1,1,0,1,1,1,37.62,11.19,4714.06,0.14,85,0.09,261.89,31,54,18,10,0
7,1,0,0,1,1,1,27.97,6.95,1352.57,0.06,45,0.14,75.14,17,28,11,7,0
8,1,0,0,1,1,1,31.94,8.25,2174.2,0.09,60,0.12,120.79,22,38,12,8,0
8,1,0,0,1,1,1,31.94,8.25,2174.2,0.09,60,0.12,120.79,22,38,12,8,0
6,1,0,0,1,1,1,22.64,7.0,1109.2,0.05,38,0.14,61.62,14,24,9,6,0
3,1,0,0,1,1,1,11.58,2.67,82.35,0.01,11,0.38,4.57,4,7,3,3,0
6,1,0,0,1,1,1,23.69,4.5,479.73,0.04,28,0.22,26.65,12,16,8,6,0
6,1,0,0,1,1,1,23.69,4.5,479.73,0.04,28,0.22,26.65,12,16,8,6,0
6,1,0,0,1,1,1,23.69,4.5,479.73,0.04,28,0.22,26.65,12,16,8,6,0
8,1,0,0,1,1,1,26.41,8.18,1768.06,0.07,50,0.12,98.23,20,30,11,8,0
6,1,0,0,1,1,1,25.62,6.3,1016.95,0.05,38,0.16,56.5,14,24,10,6,0
6,1,0,0,1,1,1,23.69,4.5,479.73,0.04,28,0.22,26.65,12,16,8,6,0
16,1,0,0,1,1,1,58.8,10.18,6095.25,0.2,122,0.1,338.63,56,66,22,16,0
3,1,0,0,1,1,1,11.58,2.67,82.35,0.01,11,0.38,4.57,4,7,3,3,0
7,1,0,0,1,1,1,24.54,6.75,1118.27,0.06,39,0.15,62.13,15,24,10,7,0
10,1,0,0,1,1,1,43.64,7.88,2706.21,0.11,74,0.13,150.34,28,46,16,10,0
8,1,0,0,1,1,1,33.01,8.25,2246.67,0.09,62,0.12,124.82,22,40,12,8,0
9,1,0,0,1,1,1,38.28,8.03,2471.8,0.1,68,0.12,137.32,25,43,14,9,0
9,1,0,0,1,1,1,34.6,7.71,2058.87,0.09,59,0.13,114.38,24,35,14,9,0
10,1,0,0,1,1,1,43.64,7.88,2706.21,0.11,74,0.13,150.34,28,46,16,10,0
8,1,0,0,1,1,1,33.01,8.25,2246.67,0.09,62,0.12,124.82,22,40,12,8,0
9,1,0,0,1,1,1,38.28,8.03,2471.8,0.1,68,0.12,137.32,25,43,14,9,0
9,1,0,0,1,1,1,34.17,7.96,2165.74,0.09,61,0.13,120.32,23,38,13,9,0
7,1,0,0,1,1,1,24.54,6.75,1118.27,0.06,39,0.15,62.13,15,24,10,7,0
7,1,0,0,1,1,1,24.54,6.75,1118.27,0.06,39,0.15,62.13,15,24,10,7,0
7,1,0,0,1,1,1,24.54,6.75,1118.27,0.06,39,0.15,62.13,15,24,10,7,0
7,1,0,0,1,1,1,24.54,6.75,1118.27,0.06,39,0.15,62.13,15,24,10,7,0
7,1,0,0,1,1,1,24.54,6.75,1118.27,0.06,39,0.15,62.13,15,24,10,7,0
2,1,1,0,1,1,1,11.58,2.67,82.35,0.01,11,0.38,4.57,4,7,3,3,0
7,1,0,0,1,1,1,24.54,6.75,1118.27,0.06,39,0.15,62.13,15,24,10,7,0
10,1,0,0,1,1,1,22.98,13.0,3884.16,0.1,67,0.08,215.79,26,41,11,10,0
10,1,0,0,1,1,1,23.44,11.0,2836.27,0.09,57,0.09,157.57,24,33,12,10,0
10,1,0,0,1,1,1,23.44,11.0,2836.27,0.09,57,0.09,157.57,24,33,12,10,0
10,1,0,0,1,1,1,23.44,11.0,2836.27,0.09,57,0.09,157.57,24,33,12,10,0
10,1,0,0,1,1,1,23.44,11.0,2836.27,0.09,57,0.09,157.57,24,33,12,10,0
10,3,0,0,2,2,1,28.45,14.0,5576.96,0.13,82,0.07,309.83,30,52,15,10,0
13,1,0,0,1,1,1,34.3,13.72,6458.35,0.16,95,0.07,358.8,38,57,18,13,0
18,1,0,0,1,1,1,49.27,15.44,11741.46,0.25,146,0.06,652.3,57,89,24,18,0
18,1,0,0,1,1,1,49.27,15.44,11741.46,0.25,146,0.06,652.3,57,89,24,18,0
16,1,0,0,1,1,1,46.12,13.57,8485.87,0.21,121,0.07,471.44,48,73,23,16,0
14,1,0,0,1,1,1,38.42,13.0,6492.14,0.17,99,0.08,360.67,40,59,20,14,0
11,1,0,0,1,1,1,26.78,12.57,4228.87,0.11,70,0.08,234.94,29,41,15,11,0
14,1,0,0,1,1,1,57.58,9.45,5141.69,0.18,112,0.11,285.65,42,70,20,14,0
14,1,0,0,1,1,1,41.9,11.83,5858.34,0.17,100,0.08,325.46,43,57,20,14,0
13,3,0,0,2,2,1,25.37,16.41,6827.5,0.14,84,0.06,379.31,35,49,16,13,0
17,3,0,0,2,2,1,39.15,16.88,11148.9,0.22,125,0.06,619.38,54,71,24,17,0
13,1,0,0,1,1,1,36.96,12.22,5521.91,0.15,93,0.08,306.77,40,53,18,13,0
12,5,0,0,3,2,1,21.54,19.27,7995.67,0.14,83,0.05,444.2,34,49,15,12,0
9,1,0,0,1,1,1,22.08,10.5,2434.85,0.08,52,0.1,135.27,21,31,11,9,0
9,1,0,0,1,1,1,22.08,10.5,2434.85,0.08,52,0.1,135.27,21,31,11,9,0
8,1,0,0,1,1,1,29.93,6.75,1363.81,0.07,46,0.15,75.77,18,28,12,8,0
10,1,0,0,1,1,1,24.26,11.0,2935.79,0.09,59,0.09,163.1,24,35,12,10,0
9,1,0,0,1,1,1,22.08,10.5,2434.85,0.08,52,0.1,135.27,21,31,11,9,0
11,1,0,0,1,1,1,26.78,12.57,4228.87,0.11,70,0.08,234.94,29,41,15,11,0
9,1,0,0,1,1,1,22.08,10.5,2434.85,0.08,52,0.1,135.27,21,31,11,9,0
9,1,0,0,1,1,1,22.08,10.5,2434.85,0.08,52,0.1,135.27,21,31,11,9,0
9,1,0,0,1,1,1,22.08,10.5,2434.85,0.08,52,0.1,135.27,21,31,11,9,0
9,1,0,0,1,1,1,22.08,10.5,2434.85,0.08,52,0.1,135.27,21,31,11,9,0
9,1,0,0,1,1,1,22.08,10.5,2434.85,0.08,52,0.1,135.27,21,31,11,9,0
13,1,0,0,1,1,1,36.96,12.22,5521.91,0.15,93,0.08,306.77,40,53,18,13,0
7,1,0,0,1,1,1,24.54,6.75,1118.27,0.06,39,0.15,62.13,15,24,10,7,0
12,1,0,0,1,1,1,32.45,11.73,4467.3,0.13,81,0.09,248.18,32,49,15,12,0
11,1,4,0,1,1,1,42.87,12.22,6404.47,0.17,109,0.08,355.8,44,65,18,15,0
10,1,0,0,1,1,1,26.44,10.58,2958.18,0.09,61,0.09,164.34,25,36,13,10,0
12,3,0,0,2,1,1,29.02,13.6,5367.32,0.13,83,0.07,298.18,34,49,15,12,0
11,1,0,0,1,1,1,29.28,11.78,4063.55,0.11,71,0.08,225.75,29,42,16,11,0
11,1,0,0,1,1,1,29.28,11.78,4063.55,0.11,71,0.08,225.75,29,42,16,11,0
7,1,0,0,1,1,1,24.54,6.75,1118.27,0.06,39,0.15,62.13,15,24,10,7,0
7,1,0,0,1,1,1,24.54,6.75,1118.27,0.06,39,0.15,62.13,15,24,10,7,0
7,1,0,0,1,1,1,24.54,6.75,1118.27,0.06,39,0.15,62.13,15,24,10,7,0
9,1,0,0,1,1,1,22.08,10.5,2434.85,0.08,52,0.1,135.27,21,31,11,9,0
7,3,0,0,2,1,1,16.78,6.29,663.06,0.04,27,0.16,36.84,11,16,7,7,0
6,1,0,0,1,1,1,23.69,4.5,479.73,0.04,28,0.22,26.65,12,16,8,6,0
10,5,1,0,3,2,1,32.97,9.33,2872.4,0.1,60,0.11,159.58,28,32,21,11,0
6,1,0,0,1,1,1,21.58,5.25,594.82,0.04,29,0.19,33.05,12,17,8,6,0
6,1,0,0,1,1,1,21.58,5.25,594.82,0.04,29,0.19,33.05,12,17,8,6,0
8,7,0,0,4,3,1,19.43,5.14,513.83,0.03,27,0.19,28.55,12,15,7,8,0
8,7,0,0,4,3,1,19.43,5.14,513.83,0.03,27,0.19,28.55,12,15,7,8,0
0,1,0,0,1,1,1,7.74,1.5,17.41,0.0,5,0.67,0.97,2,3,2,0,0
0,1,0,0,1,1,1,7.74,1.5,17.41,0.0,5,0.67,0.97,2,3,2,0,0
39,11,0,8,1,1,1,62.91,15.83,15770.0,0.33,166,0.06,876.11,75,91,45,39,0
39,11,0,8,1,1,1,62.91,15.83,15770.0,0.33,166,0.06,876.11,75,91,45,39,0
17,3,0,0,2,1,1,54.4,6.6,2369.73,0.12,70,0.15,131.65,33,37,25,17,0
17,3,0,0,2,1,1,54.4,6.6,2369.73,0.12,70,0.15,131.65,33,37,25,17,0
0,1,0,0,1,1,1,7.74,1.5,17.41,0.0,5,0.67,0.97,2,3,2,0,0
0,1,0,0,1,1,1,7.74,1.5,17.41,0.0,5,0.67,0.97,2,3,2,0,0
36,17,0,7,9,8,1,40.47,20.0,16189.25,0.27,142,0.05,899.4,64,78,32,36,0
5,3,0,9,2,1,1,14.41,3.6,186.81,0.02,15,0.28,10.38,6,9,5,5,0
5,3,0,9,2,1,1,14.41,3.6,186.81,0.02,15,0.28,10.38,6,9,5,5,0
5,3,0,9,2,1,1,14.41,3.6,186.81,0.02,15,0.28,10.38,6,9,5,5,0
0,1,0,0,1,1,1,5.33,1.5,12.0,0.0,4,0.67,0.67,1,3,1,0,0
0,1,0,0,1,1,1,5.33,1.5,12.0,0.0,4,0.67,0.67,1,3,1,0,0
4,3,0,0,2,1,1,11.52,3.75,161.94,0.01,13,0.27,9.0,5,8,4,4,0
4,3,0,0,2,1,1,11.52,3.75,161.94,0.01,13,0.27,9.0,5,8,4,4,0
0,1,0,0,1,1,1,0.0,0.0,0.0,0.0,1,0.0,0.0,0,1,0,0,0
0,1,0,0,1,1,1,0.0,0.0,0.0,0.0,1,0.0,0.0,0,1,0,0,0
6,1,6,3,1,1,1,60.1,3.63,792.63,0.07,47,0.28,44.04,23,24,19,12,0
6,1,6,3,1,1,1,60.1,3.63,792.63,0.07,47,0.28,44.04,23,24,19,12,0
6,1,6,3,1,1,1,60.1,3.63,792.63,0.07,47,0.28,44.04,23,24,19,12,0
5,1,1,1,1,1,1,15.99,5.0,399.77,0.03,21,0.2,22.21,10,11,7,6,0
5,1,1,1,1,1,1,15.99,5.0,399.77,0.03,21,0.2,22.21,10,11,7,6,0
5,1,1,1,1,1,1,15.99,5.0,399.77,0.03,21,0.2,22.21,10,11,7,6,0
5,1,1,1,1,1,1,15.99,5.0,399.77,0.03,21,0.2,22.21,10,11,7,6,0
5,1,1,1,1,1,1,15.99,5.0,399.77,0.03,21,0.2,22.21,10,11,7,6,0
5,1,1,1,1,1,1,15.99,5.0,399.77,0.03,21,0.2,22.21,10,11,7,6,0
2,1,1,0,1,1,1,11.23,2.0,44.92,0.01,8,0.5,2.5,3,5,3,3,0
0,1,0,0,1,1,1,5.33,1.5,12.0,0.0,4,0.67,0.67,1,3,1,0,0
0,1,0,0,1,1,1,5.33,1.5,12.0,0.0,4,0.67,0.67,1,3,1,0,0
0,1,0,0,1,1,1,5.33,1.5,12.0,0.0,4,0.67,0.67,1,3,1,0,0
2,1,0,0,1,1,1,7.74,1.5,17.41,0.0,5,0.67,0.97,2,3,2,2,0
3,1,0,0,1,1,1,11.23,2.0,44.92,0.01,8,0.5,2.5,3,5,3,3,0
3,1,0,0,1,1,1,11.23,2.0,44.92,0.01,8,0.5,2.5,3,5,3,3,0
4,1,0,0,1,1,1,10.24,7.0,501.89,0.02,20,0.14,27.88,7,13,4,4,0
4,3,0,0,2,2,1,21.5,7.15,1099.18,0.05,35,0.14,61.07,13,22,10,4,0
8,3,0,0,2,2,1,23.46,10.29,2485.24,0.08,52,0.1,138.07,19,33,12,8,0
54,13,1,8,7,6,6,25.11,40.0,40181.42,0.33,184,0.03,2232.3,80,104,22,55,0
0,1,0,0,1,1,1,8.3,6.67,369.01,0.02,16,0.15,20.5,5,11,3,0,0
23,5,0,1,3,2,1,19.78,20.04,7940.87,0.13,80,0.05,441.16,33,47,14,23,0
0,1,0,0,1,1,1,8.6,7.5,483.97,0.02,18,0.13,26.89,5,13,3,0,0
19,5,0,3,3,3,1,19.07,10.91,2270.01,0.07,46,0.09,126.11,20,26,11,19,0
12,3,0,2,2,2,1,14.73,8.94,1176.94,0.04,31,0.11,65.39,13,18,8,12,0
12,9,0,0,5,3,3,17.46,16.55,4779.2,0.1,63,0.06,265.51,28,35,11,12,0
4,1,0,0,1,1,1,9.47,2.67,67.38,0.01,9,0.38,3.74,4,5,3,4,0
13,5,0,0,3,3,1,16.4,7.07,820.29,0.04,29,0.14,45.57,11,18,7,13,0
13,5,0,0,3,3,1,17.24,7.5,969.51,0.04,31,0.13,53.86,12,19,8,13,0
4,3,0,0,2,2,1,11.99,6.67,533.03,0.03,21,0.15,29.61,10,11,6,4,0
0,1,0,0,1,1,1,6.55,3.0,58.95,0.01,7,0.33,3.28,1,6,1,0,0
0,3,0,0,2,2,1,6.69,7.5,376.42,0.02,14,0.13,20.91,5,9,3,0,0
0,1,0,0,1,1,1,7.86,2.5,49.13,0.01,7,0.4,2.73,2,5,2,0,0
0,3,0,0,2,2,1,9.32,5.0,233.02,0.02,13,0.2,12.95,5,8,4,0,0
6,1,0,0,1,1,1,17.51,5.0,437.85,0.03,23,0.2,24.32,10,13,7,6,0
0,3,0,0,2,2,1,7.75,2.0,31.02,0.01,6,0.5,1.72,2,4,2,0,0
0,3,0,0,2,2,1,7.86,2.5,49.13,0.01,7,0.4,2.73,2,5,2,0,0
11,7,0,0,4,2,3,12.35,16.0,3162.47,0.07,45,0.06,175.69,16,29,7,11,0
3,3,0,0,2,2,1,14.28,4.0,228.44,0.02,15,0.25,12.69,6,9,6,3,0
0,1,0,0,1,1,1,0.0,0.0,0.0,0.0,1,0.0,0.0,0,1,0,0,0
2,1,0,0,1,1,1,13.5,2.0,54.0,0.01,9,0.5,3.0,4,5,4,2,0
0,1,0,0,1,1,1,7.75,2.0,31.02,0.01,6,0.5,1.72,2,4,2,0,0
0,1,0,0,1,1,1,7.75,2.0,31.02,0.01,6,0.5,1.72,2,4,2,0,0
0,1,0,0,1,1,1,7.75,2.0,31.02,0.01,6,0.5,1.72,2,4,2,0,0
0,1,0,0,1,1,1,7.74,1.5,17.41,0.0,5,0.67,0.97,2,3,2,0,0
1,1,0,0,1,1,1,7.74,1.5,17.41,0.0,5,0.67,0.97,2,3,2,1,0
0,1,0,0,1,1,1,5.8,2.0,23.22,0.0,5,0.5,1.29,1,4,1,0,0
2,1,0,0,1,1,1,7.75,2.0,31.02,0.01,6,0.5,1.72,2,4,2,2,0
1,1,0,1,1,1,1,0.0,0.0,0.0,0.0,1,0.0,0.0,0,1,0,1,0
2,1,0,0,1,1,1,7.75,2.0,31.02,0.01,6,0.5,1.72,2,4,2,2,0
0,1,0,0,1,1,1,9.31,2.5,58.16,0.01,9,0.4,3.23,1,8,1,0,0
0,1,0,0,1,1,1,7.75,2.0,31.02,0.01,6,0.5,1.72,2,4,2,0,0
0,1,0,0,1,1,1,10.68,4.67,232.53,0.02,15,0.21,12.92,4,11,3,0,0
7,5,0,0,3,2,1,11.89,13.13,2048.55,0.05,35,0.08,113.81,15,20,8,7,0
5,3,0,0,2,2,1,17.22,4.08,287.09,0.02,19,0.24,15.95,7,12,6,5,0
4,3,0,0,2,2,1,11.18,5.63,353.85,0.02,17,0.18,19.66,5,12,4,4,0
0,1,0,0,1,1,1,0.0,0.0,0.0,0.0,0,0.0,0.0,0,0,0,0,0
0,1,0,0,1,1,1,6.2,2.5,38.77,0.01,6,0.4,2.15,1,5,1,0,0
0,1,0,0,1,1,1,11.86,3.5,145.3,0.01,12,0.29,8.07,4,8,4,0,0
0,1,0,0,1,1,1,0.0,0.0,0.0,0.0,0,0.0,0.0,0,0,0,0,0
0,1,0,0,1,1,1,0.0,0.0,0.0,0.0,0,0.0,0.0,0,0,0,0,0
0,1,0,0,1,1,1,0.0,0.0,0.0,0.0,0,0.0,0.0,0,0,0,0,0
0,1,0,0,1,1,1,7.33,4.5,148.5,0.01,11,0.22,8.25,3,8,2,0,0
8,3,0,0,2,1,1,15.07,9.75,1432.72,0.05,34,0.1,79.6,13,21,8,8,0
0,1,0,0,1,1,1,9.6,2.5,60.0,0.01,8,0.4,3.33,3,5,3,0,0
0,1,0,0,1,1,1,7.75,2.0,31.02,0.01,6,0.5,1.72,2,4,2,0,0
0,1,0,0,1,1,1,6.86,3.5,84.0,0.01,8,0.29,4.67,1,7,1,0,0
0,1,0,0,1,1,1,7.75,2.0,31.02,0.01,6,0.5,1.72,2,4,2,0,0
2,1,0,0,1,1,1,6.2,2.5,38.77,0.01,6,0.4,2.15,1,5,1,2,0
0,1,0,0,1,1,1,8.3,6.0,298.97,0.02,15,0.17,16.61,3,12,2,0,0
0,1,0,0,1,1,1,8.3,6.0,298.97,0.02,15,0.17,16.61,3,12,2,0,0
0,1,0,0,1,1,1,8.3,6.0,298.97,0.02,15,0.17,16.61,3,12,2,0,0
0,1,0,0,1,1,1,7.75,2.0,31.02,0.01,6,0.5,1.72,2,4,2,0,0
0,1,0,0,1,1,1,7.75,2.0,31.02,0.01,6,0.5,1.72,2,4,2,0,0
2,1,0,1,1,1,1,5.8,2.0,23.22,0.0,5,0.5,1.29,1,4,1,2,0
2,1,0,0,1,1,1,5.33,1.5,12.0,0.0,4,0.67,0.67,1,3,1,2,0
0,1,0,0,1,1,1,7.75,2.0,31.02,0.01,6,0.5,1.72,2,4,2,0,0
0,1,0,0,1,1,1,7.75,2.0,31.02,0.01,6,0.5,1.72,2,4,2,0,0
0,3,0,0,2,1,1,7.75,2.0,31.02,0.01,6,0.5,1.72,2,4,2,0,0
0,1,0,0,1,1,1,5.8,2.0,23.22,0.0,5,0.5,1.29,1,4,1,0,0
0,3,0,0,2,1,1,7.75,2.0,31.02,0.01,6,0.5,1.72,2,4,2,0,0
0,1,0,0,1,1,1,12.18,3.0,109.62,0.01,11,0.33,6.09,4,7,4,0,0
0,1,0,0,1,1,1,7.75,2.0,31.02,0.01,6,0.5,1.72,2,4,2,0,0
0,1,0,0,1,1,1,7.75,2.0,31.02,0.01,6,0.5,1.72,2,4,2,0,0
2,1,0,1,1,1,1,5.8,2.0,23.22,0.0,5,0.5,1.29,1,4,1,2,0
2,1,0,0,1,1,1,5.33,1.5,12.0,0.0,4,0.67,0.67,1,3,1,2,0
2,1,0,0,1,1,1,5.33,1.5,12.0,0.0,4,0.67,0.67,1,3,1,2,0
6,1,0,2,1,1,1,9.21,11.25,1165.64,0.03,28,0.09,64.76,10,18,4,6,0
3,1,0,1,1,1,1,9.3,3.75,130.75,0.01,11,0.27,7.26,6,5,4,3,0
13,5,0,5,3,2,1,13.41,19.29,4988.19,0.09,58,0.05,277.12,18,40,7,13,0
2,1,0,0,1,1,1,5.33,1.5,12.0,0.0,4,0.67,0.67,1,3,1,2,0
2,1,0,0,1,1,1,7.74,1.5,17.41,0.0,5,0.67,0.97,2,3,2,2,0
5,5,0,2,3,1,3,12.6,6.67,560.0,0.03,21,0.15,31.11,8,13,6,5,0
2,1,0,0,1,1,1,7.74,1.5,17.41,0.0,5,0.67,0.97,2,3,2,2,0
3,1,0,0,1,1,1,9.51,3.0,85.59,0.01,9,0.33,4.75,3,6,3,3,0
5,3,0,0,2,2,1,15.36,3.5,188.21,0.02,15,0.29,10.46,5,10,5,5,0
4,3,0,0,2,2,1,10.88,5.6,341.29,0.02,17,0.18,18.96,8,9,5,4,0
0,1,0,0,1,1,1,7.74,1.5,17.41,0.0,5,0.67,0.97,2,3,2,0,0
0,1,0,0,1,1,1,12.68,2.5,79.25,0.01,10,0.4,4.4,4,6,4,0,0
0,1,0,0,1,1,1,7.74,1.5,17.41,0.0,5,0.67,0.97,2,3,2,0,0
0,1,0,0,1,1,1,7.75,2.0,31.02,0.01,6,0.5,1.72,2,4,2,0,0
0,1,0,0,1,1,1,7.75,2.0,31.02,0.01,6,0.5,1.72,2,4,2,0,0
0,1,0,0,1,1,1,7.75,2.0,31.02,0.01,6,0.5,1.72,2,4,2,0,0
0,1,0,0,1,1,1,7.75,2.0,31.02,0.01,6,0.5,1.72,2,4,2,0,0
0,1,0,0,1,1,1,7.75,2.0,31.02,0.01,6,0.5,1.72,2,4,2,0,0
0,1,0,0,1,1,1,5.8,2.0,23.22,0.0,5,0.5,1.29,1,4,1,0,0
0,1,0,0,1,1,1,7.75,2.0,31.02,0.01,6,0.5,1.72,2,4,2,0,0
2,1,0,0,1,1,1,8.98,2.5,56.15,0.01,8,0.4,3.12,2,6,2,2,0
2,1,0,0,1,1,1,5.33,1.5,12.0,0.0,4,0.67,0.67,1,3,1,2,0
0,1,0,0,1,1,1,5.33,1.5,12.0,0.0,4,0.67,0.67,1,3,1,0,0
2,1,0,0,1,1,1,5.33,1.5,12.0,0.0,4,0.67,0.67,1,3,1,2,0
2,1,0,0,1,1,1,5.33,1.5,12.0,0.0,4,0.67,0.67,1,3,1,2,0
3,1,0,0,1,1,1,12.0,2.5,75.0,0.01,10,0.4,4.17,3,7,3,3,0
0,1,0,0,1,1,1,7.86,2.5,49.13,0.01,7,0.4,2.73,2,5,2,0,0
0,1,0,0,1,1,1,6.55,3.0,58.95,0.01,7,0.33,3.28,1,6,1,0,0
0,1,0,0,1,1,1,6.55,3.0,58.95,0.01,7,0.33,3.28,1,6,1,0,0
2,1,0,0,1,1,1,8.98,2.5,56.15,0.01,8,0.4,3.12,2,6,2,2,0
2,1,0,0,1,1,1,5.33,1.5,12.0,0.0,4,0.67,0.67,1,3,1,2,0
0,1,0,0,1,1,1,5.33,1.5,12.0,0.0,4,0.67,0.67,1,3,1,0,0
2,1,0,0,1,1,1,5.33,1.5,12.0,0.0,4,0.67,0.67,1,3,1,2,0
2,1,0,0,1,1,1,5.33,1.5,12.0,0.0,4,0.67,0.67,1,3,1,2,0
0,1,0,0,1,1,1,5.33,1.5,12.0,0.0,4,0.67,0.67,1,3,1,0,0
0,1,0,0,1,1,1,5.33,1.5,12.0,0.0,4,0.67,0.67,1,3,1,0,0
0,1,0,0,1,1,1,7.75,2.0,31.02,0.01,6,0.5,1.72,2,4,2,0,0
2,1,0,0,1,1,1,6.2,2.5,38.77,0.01,6,0.4,2.15,1,5,1,2,0
0,1,0,0,1,1,1,9.0,3.0,81.0,0.01,9,0.33,4.5,2,7,2,0,0
0,1,0,0,1,1,1,8.3,6.0,298.97,0.02,15,0.17,16.61,3,12,2,0,0
2,1,0,0,1,1,1,5.33,1.5,12.0,0.0,4,0.67,0.67,1,3,1,2,0
0,1,0,0,1,1,1,9.51,3.0,85.59,0.01,9,0.33,4.75,3,6,3,0,0
0,1,0,0,1,1,1,9.51,3.0,85.59,0.01,9,0.33,4.75,3,6,3,0,0
0,1,0,0,1,1,1,9.51,3.0,85.59,0.01,9,0.33,4.75,3,6,3,0,0
0,1,0,0,1,1,1,9.51,3.0,85.59,0.01,9,0.33,4.75,3,6,3,0,0
4,3,0,0,2,2,1,13.67,6.0,492.27,0.03,21,0.17,27.35,6,15,5,4,0
2,1,0,0,1,1,1,9.97,4.0,159.45,0.01,12,0.25,8.86,2,10,2,2,0
2,1,0,0,1,1,1,7.86,2.5,49.13,0.01,7,0.4,2.73,2,5,2,2,0
2,1,0,0,1,1,1,6.2,2.5,38.77,0.01,6,0.4,2.15,1,5,1,2,0
6,5,0,1,3,1,1,9.77,7.2,506.22,0.02,19,0.14,28.12,9,10,5,6,0
0,1,0,0,1,1,1,5.33,1.5,12.0,0.0,4,0.67,0.67,1,3,1,0,0
4,3,0,0,2,1,1,11.52,3.75,161.94,0.01,13,0.27,9.0,5,8,4,4,0
0,1,0,0,1,1,1,0.0,0.0,0.0,0.0,1,0.0,0.0,0,1,0,0,0
3,3,0,1,2,1,1,10.71,4.2,188.88,0.01,13,0.24,10.49,7,6,5,3,0
2,1,0,0,1,1,1,7.74,1.5,17.41,0.0,5,0.67,0.97,2,3,2,2,0
8,3,0,2,2,1,1,20.31,5.25,559.68,0.04,28,0.19,31.09,14,14,8,8,0
4,1,0,0,1,1,1,10.24,7.0,501.89,0.02,20,0.14,27.88,7,13,4,4,0
4,3,0,0,2,2,1,21.5,7.15,1099.18,0.05,35,0.14,61.07,13,22,10,4,0
8,3,0,0,2,2,1,23.46,10.29,2485.24,0.08,52,0.1,138.07,19,33,12,8,0
54,13,1,8,7,6,6,25.11,40.0,40181.42,0.33,184,0.03,2232.3,80,104,22,55,0
0,1,0,0,1,1,1,8.3,6.67,369.01,0.02,16,0.15,20.5,5,11,3,0,0
23,5,0,1,3,2,1,19.78,20.04,7940.87,0.13,80,0.05,441.16,33,47,14,23,0
0,1,0,0,1,1,1,8.6,7.5,483.97,0.02,18,0.13,26.89,5,13,3,0,0
19,5,0,3,3,3,1,19.07,10.91,2270.01,0.07,46,0.09,126.11,20,26,11,19,0
12,3,0,2,2,2,1,14.73,8.94,1176.94,0.04,31,0.11,65.39,13,18,8,12,0
12,9,0,0,5,3,3,17.46,16.55,4779.2,0.1,63,0.06,265.51,28,35,11,12,0
4,1,0,0,1,1,1,9.47,2.67,67.38,0.01,9,0.38,3.74,4,5,3,4,0
13,5,0,0,3,3,1,16.4,7.07,820.29,0.04,29,0.14,45.57,11,18,7,13,0
13,5,0,0,3,3,1,17.24,7.5,969.51,0.04,31,0.13,53.86,12,19,8,13,0
4,3,0,0,2,2,1,11.99,6.67,533.03,0.03,21,0.15,29.61,10,11,6,4,0
0,1,0,0,1,1,1,6.55,3.0,58.95,0.01,7,0.33,3.28,1,6,1,0,0
0,3,0,0,2,2,1,6.69,7.5,376.42,0.02,14,0.13,20.91,5,9,3,0,0
0,1,0,0,1,1,1,7.86,2.5,49.13,0.01,7,0.4,2.73,2,5,2,0,0
0,3,0,0,2,2,1,9.32,5.0,233.02,0.02,13,0.2,12.95,5,8,4,0,0
6,1,0,0,1,1,1,17.51,5.0,437.85,0.03,23,0.2,24.32,10,13,7,6,0
0,3,0,0,2,2,1,7.75,2.0,31.02,0.01,6,0.5,1.72,2,4,2,0,0
0,3,0,0,2,2,1,7.86,2.5,49.13,0.01,7,0.4,2.73,2,5,2,0,0
11,7,0,0,4,2,3,12.35,16.0,3162.47,0.07,45,0.06,175.69,16,29,7,11,0
3,3,0,0,2,2,1,14.28,4.0,228.44,0.02,15,0.25,12.69,6,9,6,3,0
0,1,0,0,1,1,1,0.0,0.0,0.0,0.0,1,0.0,0.0,0,1,0,0,0
2,1,0,0,1,1,1,13.5,2.0,54.0,0.01,9,0.5,3.0,4,5,4,2,0
0,1,0,0,1,1,1,7.75,2.0,31.02,0.01,6,0.5,1.72,2,4,2,0,0
0,1,0,0,1,1,1,7.75,2.0,31.02,0.01,6,0.5,1.72,2,4,2,0,0
0,1,0,0,1,1,1,7.75,2.0,31.02,0.01,6,0.5,1.72,2,4,2,0,0
0,1,0,0,1,1,1,7.74,1.5,17.41,0.0,5,0.67,0.97,2,3,2,0,0
1,1,0,0,1,1,1,7.74,1.5,17.41,0.0,5,0.67,0.97,2,3,2,1,0
0,1,0,0,1,1,1,5.8,2.0,23.22,0.0,5,0.5,1.29,1,4,1,0,0
2,1,0,0,1,1,1,7.75,2.0,31.02,0.01,6,0.5,1.72,2,4,2,2,0
1,1,0,1,1,1,1,0.0,0.0,0.0,0.0,1,0.0,0.0,0,1,0,1,0
2,1,0,0,1,1,1,7.75,2.0,31.02,0.01,6,0.5,1.72,2,4,2,2,0
0,1,0,0,1,1,1,9.31,2.5,58.16,0.01,9,0.4,3.23,1,8,1,0,0
0,1,0,0,1,1,1,7.75,2.0,31.02,0.01,6,0.5,1.72,2,4,2,0,0
0,1,0,0,1,1,1,10.68,4.67,232.53,0.02,15,0.21,12.92,4,11,3,0,0
7,5,0,0,3,2,1,11.89,13.13,2048.55,0.05,35,0.08,113.81,15,20,8,7,0
5,3,0,0,2,2,1,17.22,4.08,287.09,0.02,19,0.24,15.95,7,12,6,5,0
4,3,0,0,2,2,1,11.18,5.63,353.85,0.02,17,0.18,19.66,5,12,4,4,0
0,1,0,0,1,1,1,0.0,0.0,0.0,0.0,0,0.0,0.0,0,0,0,0,0
0,1,0,0,1,1,1,6.2,2.5,38.77,0.01,6,0.4,2.15,1,5,1,0,0
0,1,0,0,1,1,1,11.86,3.5,145.3,0.01,12,0.29,8.07,4,8,4,0,0
0,1,0,0,1,1,1,0.0,0.0,0.0,0.0,0,0.0,0.0,0,0,0,0,0
0,1,0,0,1,1,1,0.0,0.0,0.0,0.0,0,0.0,0.0,0,0,0,0,0
0,1,0,0,1,1,1,0.0,0.0,0.0,0.0,0,0.0,0.0,0,0,0,0,0
0,1,0,0,1,1,1,7.33,4.5,148.5,0.01,11,0.22,8.25,3,8,2,0,0
8,3,0,0,2,1,1,15.07,9.75,1432.72,0.05,34,0.1,79.6,13,21,8,8,0
0,1,0,0,1,1,1,9.6,2.5,60.0,0.01,8,0.4,3.33,3,5,3,0,0
0,1,0,0,1,1,1,7.75,2.0,31.02,0.01,6,0.5,1.72,2,4,2,0,0
0,1,0,0,1,1,1,6.86,3.5,84.0,0.01,8,0.29,4.67,1,7,1,0,0
0,1,0,0,1,1,1,7.75,2.0,31.02,0.01,6,0.5,1.72,2,4,2,0,0
0,1,0,0,1,1,1,8.3,6.0,298.97,0.02,15,0.17,16.61,3,12,2,0,0
0,1,0,0,1,1,1,8.3,6.0,298.97,0.02,15,0.17,16.61,3,12,2,0,0
0,1,0,0,1,1,1,8.3,6.0,298.97,0.02,15,0.17,16.61,3,12,2,0,0
0,1,0,0,1,1,1,7.75,2.0,31.02,0.01,6,0.5,1.72,2,4,2,0,0
0,1,0,0,1,1,1,7.75,2.0,31.02,0.01,6,0.5,1.72,2,4,2,0,0
0,1,0,0,1,1,1,7.75,2.0,31.02,0.01,6,0.5,1.72,2,4,2,0,0
0,1,0,0,1,1,1,7.75,2.0,31.02,0.01,6,0.5,1.72,2,4,2,0,0
0,3,0,0,2,1,1,7.75,2.0,31.02,0.01,6,0.5,1.72,2,4,2,0,0
0,1,0,0,1,1,1,5.8,2.0,23.22,0.0,5,0.5,1.29,1,4,1,0,0
0,3,0,0,2,1,1,7.75,2.0,31.02,0.01,6,0.5,1.72,2,4,2,0,0
0,1,0,0,1,1,1,12.18,3.0,109.62,0.01,11,0.33,6.09,4,7,4,0,0
0,1,0,0,1,1,1,7.75,2.0,31.02,0.01,6,0.5,1.72,2,4,2,0,0
0,1,0,0,1,1,1,7.75,2.0,31.02,0.01,6,0.5,1.72,2,4,2,0,0
3,1,0,0,1,1,1,9.51,3.0,85.59,0.01,9,0.33,4.75,3,6,3,3,0
5,3,0,0,2,2,1,15.36,3.5,188.21,0.02,15,0.29,10.46,5,10,5,5,0
4,3,0,0,2,2,1,10.88,5.6,341.29,0.02,17,0.18,18.96,8,9,5,4,0
0,1,0,0,1,1,1,7.74,1.5,17.41,0.0,5,0.67,0.97,2,3,2,0,0
0,1,0,0,1,1,1,12.68,2.5,79.25,0.01,10,0.4,4.4,4,6,4,0,0
0,1,0,0,1,1,1,7.74,1.5,17.41,0.0,5,0.67,0.97,2,3,2,0,0
0,1,0,0,1,1,1,7.75,2.0,31.02,0.01,6,0.5,1.72,2,4,2,0,0
0,1,0,0,1,1,1,7.75,2.0,31.02,0.01,6,0.5,1.72,2,4,2,0,0
0,1,0,0,1,1,1,7.75,2.0,31.02,0.01,6,0.5,1.72,2,4,2,0,0
0,1,0,0,1,1,1,7.75,2.0,31.02,0.01,6,0.5,1.72,2,4,2,0,0
0,1,0,0,1,1,1,7.75,2.0,31.02,0.01,6,0.5,1.72,2,4,2,0,0
0,1,0,0,1,1,1,5.8,2.0,23.22,0.0,5,0.5,1.29,1,4,1,0,0
0,1,0,0,1,1,1,7.75,2.0,31.02,0.01,6,0.5,1.72,2,4,2,0,0
2,1,0,0,1,1,1,8.98,2.5,56.15,0.01,8,0.4,3.12,2,6,2,2,0
2,1,0,0,1,1,1,5.33,1.5,12.0,0.0,4,0.67,0.67,1,3,1,2,0
0,1,0,0,1,1,1,5.33,1.5,12.0,0.0,4,0.67,0.67,1,3,1,0,0
2,1,0,0,1,1,1,5.33,1.5,12.0,0.0,4,0.67,0.67,1,3,1,2,0
2,1,0,0,1,1,1,5.33,1.5,12.0,0.0,4,0.67,0.67,1,3,1,2,0
3,1,0,0,1,1,1,12.0,2.5,75.0,0.01,10,0.4,4.17,3,7,3,3,0
0,1,0,0,1,1,1,7.86,2.5,49.13,0.01,7,0.4,2.73,2,5,2,0,0
0,1,0,0,1,1,1,6.55,3.0,58.95,0.01,7,0.33,3.28,1,6,1,0,0
0,1,0,0,1,1,1,6.55,3.0,58.95,0.01,7,0.33,3.28,1,6,1,0,0
2,1,0,0,1,1,1,8.98,2.5,56.15,0.01,8,0.4,3.12,2,6,2,2,0
2,1,0,0,1,1,1,5.33,1.5,12.0,0.0,4,0.67,0.67,1,3,1,2,0
0,1,0,0,1,1,1,5.33,1.5,12.0,0.0,4,0.67,0.67,1,3,1,0,0
2,1,0,0,1,1,1,5.33,1.5,12.0,0.0,4,0.67,0.67,1,3,1,2,0
2,1,0,0,1,1,1,5.33,1.5,12.0,0.0,4,0.67,0.67,1,3,1,2,0
0,1,0,0,1,1,1,5.33,1.5,12.0,0.0,4,0.67,0.67,1,3,1,0,0
0,1,0,0,1,1,1,5.33,1.5,12.0,0.0,4,0.67,0.67,1,3,1,0,0
0,1,0,0,1,1,1,7.75,2.0,31.02,0.01,6,0.5,1.72,2,4,2,0,0
0,1,0,0,1,1,1,9.0,3.0,81.0,0.01,9,0.33,4.5,2,7,2,0,0
0,1,0,0,1,1,1,8.3,6.0,298.97,0.02,15,0.17,16.61,3,12,2,0,0
0,1,0,0,1,1,1,9.51,3.0,85.59,0.01,9,0.33,4.75,3,6,3,0,0
0,1,0,0,1,1,1,9.51,3.0,85.59,0.01,9,0.33,4.75,3,6,3,0,0
0,1,0,0,1,1,1,9.51,3.0,85.59,0.01,9,0.33,4.75,3,6,3,0,0
0,1,0,0,1,1,1,9.51,3.0,85.59,0.01,9,0.33,4.75,3,6,3,0,0
4,3,0,0,2,2,1,13.67,6.0,492.27,0.03,21,0.17,27.35,6,15,5,4,0
4,1,0,0,1,1,1,10.24,7.0,501.89,0.02,20,0.14,27.88,7,13,4,4,0
4,3,0,0,2,2,1,21.5,7.15,1099.18,0.05,35,0.14,61.07,13,22,10,4,0
8,3,0,0,2,2,1,23.46,10.29,2485.24,0.08,52,0.1,138.07,19,33,12,8,0
54,13,1,8,7,6,6,25.11,40.0,40181.42,0.33,184,0.03,2232.3,80,104,22,55,0
0,1,0,0,1,1,1,8.3,6.67,369.01,0.02,16,0.15,20.5,5,11,3,0,0
23,5,0,1,3,2,1,19.78,20.04,7940.87,0.13,80,0.05,441.16,33,47,14,23,0
0,1,0,0,1,1,1,8.6,7.5,483.97,0.02,18,0.13,26.89,5,13,3,0,0
19,5,0,3,3,3,1,19.07,10.91,2270.01,0.07,46,0.09,126.11,20,26,11,19,0
12,3,0,2,2,2,1,14.73,8.94,1176.94,0.04,31,0.11,65.39,13,18,8,12,0
12,9,0,0,5,3,3,17.46,16.55,4779.2,0.1,63,0.06,265.51,28,35,11,12,0
4,1,0,0,1,1,1,9.47,2.67,67.38,0.01,9,0.38,3.74,4,5,3,4,0
13,5,0,0,3,3,1,16.4,7.07,820.29,0.04,29,0.14,45.57,11,18,7,13,0
13,5,0,0,3,3,1,17.24,7.5,969.51,0.04,31,0.13,53.86,12,19,8,13,0
4,3,0,0,2,2,1,11.99,6.67,533.03,0.03,21,0.15,29.61,10,11,6,4,0
0,1,0,0,1,1,1,6.55,3.0,58.95,0.01,7,0.33,3.28,1,6,1,0,0
0,3,0,0,2,2,1,6.69,7.5,376.42,0.02,14,0.13,20.91,5,9,3,0,0
0,1,0,0,1,1,1,7.86,2.5,49.13,0.01,7,0.4,2.73,2,5,2,0,0
0,3,0,0,2,2,1,9.32,5.0,233.02,0.02,13,0.2,12.95,5,8,4,0,0
6,1,0,0,1,1,1,17.51,5.0,437.85,0.03,23,0.2,24.32,10,13,7,6,0
0,3,0,0,2,2,1,7.75,2.0,31.02,0.01,6,0.5,1.72,2,4,2,0,0
0,3,0,0,2,2,1,7.86,2.5,49.13,0.01,7,0.4,2.73,2,5,2,0,0
11,7,0,0,4,2,3,12.35,16.0,3162.47,0.07,45,0.06,175.69,16,29,7,11,0
3,3,0,0,2,2,1,14.28,4.0,228.44,0.02,15,0.25,12.69,6,9,6,3,0
0,1,0,0,1,1,1,0.0,0.0,0.0,0.0,1,0.0,0.0,0,1,0,0,0
2,1,0,0,1,1,1,13.5,2.0,54.0,0.01,9,0.5,3.0,4,5,4,2,0
0,1,0,0,1,1,1,7.75,2.0,31.02,0.01,6,0.5,1.72,2,4,2,0,0
0,1,0,0,1,1,1,7.75,2.0,31.02,0.01,6,0.5,1.72,2,4,2,0,0
0,1,0,0,1,1,1,7.75,2.0,31.02,0.01,6,0.5,1.72,2,4,2,0,0
0,1,0,0,1,1,1,7.74,1.5,17.41,0.0,5,0.67,0.97,2,3,2,0,0
1,1,0,0,1,1,1,7.74,1.5,17.41,0.0,5,0.67,0.97,2,3,2,1,0
0,1,0,0,1,1,1,5.8,2.0,23.22,0.0,5,0.5,1.29,1,4,1,0,0
2,1,0,0,1,1,1,7.75,2.0,31.02,0.01,6,0.5,1.72,2,4,2,2,0
1,1,0,1,1,1,1,0.0,0.0,0.0,0.0,1,0.0,0.0,0,1,0,1,0
2,1,0,0,1,1,1,7.75,2.0,31.02,0.01,6,0.5,1.72,2,4,2,2,0
0,1,0,0,1,1,1,9.31,2.5,58.16,0.01,9,0.4,3.23,1,8,1,0,0
0,1,0,0,1,1,1,7.75,2.0,31.02,0.01,6,0.5,1.72,2,4,2,0,0
0,1,0,0,1,1,1,10.68,4.67,232.53,0.02,15,0.21,12.92,4,11,3,0,0
7,5,0,0,3,2,1,11.89,13.13,2048.55,0.05,35,0.08,113.81,15,20,8,7,0
5,3,0,0,2,2,1,17.22,4.08,287.09,0.02,19,0.24,15.95,7,12,6,5,0
4,3,0,0,2,2,1,11.18,5.63,353.85,0.02,17,0.18,19.66,5,12,4,4,0
0,1,0,0,1,1,1,0.0,0.0,0.0,0.0,0,0.0,0.0,0,0,0,0,0
0,1,0,0,1,1,1,6.2,2.5,38.77,0.01,6,0.4,2.15,1,5,1,0,0
0,1,0,0,1,1,1,11.86,3.5,145.3,0.01,12,0.29,8.07,4,8,4,0,0
0,1,0,0,1,1,1,0.0,0.0,0.0,0.0,0,0.0,0.0,0,0,0,0,0
0,1,0,0,1,1,1,0.0,0.0,0.0,0.0,0,0.0,0.0,0,0,0,0,0
0,1,0,0,1,1,1,0.0,0.0,0.0,0.0,0,0.0,0.0,0,0,0,0,0
0,1,0,0,1,1,1,7.33,4.5,148.5,0.01,11,0.22,8.25,3,8,2,0,0
8,3,0,0,2,1,1,15.07,9.75,1432.72,0.05,34,0.1,79.6,13,21,8,8,0
0,1,0,0,1,1,1,9.6,2.5,60.0,0.01,8,0.4,3.33,3,5,3,0,0
0,1,0,0,1,1,1,7.75,2.0,31.02,0.01,6,0.5,1.72,2,4,2,0,0
0,1,0,0,1,1,1,6.86,3.5,84.0,0.01,8,0.29,4.67,1,7,1,0,0
0,1,0,0,1,1,1,7.75,2.0,31.02,0.01,6,0.5,1.72,2,4,2,0,0
0,1,0,0,1,1,1,8.3,6.0,298.97,0.02,15,0.17,16.61,3,12,2,0,0
0,1,0,0,1,1,1,8.3,6.0,298.97,0.02,15,0.17,16.61,3,12,2,0,0
0,1,0,0,1,1,1,8.3,6.0,298.97,0.02,15,0.17,16.61,3,12,2,0,0
0,1,0,0,1,1,1,7.75,2.0,31.02,0.01,6,0.5,1.72,2,4,2,0,0
0,1,0,0,1,1,1,7.75,2.0,31.02,0.01,6,0.5,1.72,2,4,2,0,0
0,1,0,0,1,1,1,7.75,2.0,31.02,0.01,6,0.5,1.72,2,4,2,0,0
0,1,0,0,1,1,1,7.75,2.0,31.02,0.01,6,0.5,1.72,2,4,2,0,0
0,3,0,0,2,1,1,7.75,2.0,31.02,0.01,6,0.5,1.72,2,4,2,0,0
0,1,0,0,1,1,1,5.8,2.0,23.22,0.0,5,0.5,1.29,1,4,1,0,0
0,3,0,0,2,1,1,7.75,2.0,31.02,0.01,6,0.5,1.72,2,4,2,0,0
0,1,0,0,1,1,1,12.18,3.0,109.62,0.01,11,0.33,6.09,4,7,4,0,0
0,1,0,0,1,1,1,7.75,2.0,31.02,0.01,6,0.5,1.72,2,4,2,0,0
0,1,0,0,1,1,1,7.75,2.0,31.02,0.01,6,0.5,1.72,2,4,2,0,0
2,1,0,0,1,1,1,5.8,2.0,23.22,0.0,5,0.5,1.29,1,4,1,2,0
3,1,0,0,1,1,1,7.75,2.0,31.02,0.01,6,0.5,1.72,2,4,2,3,0
3,1,0,0,1,1,1,9.51,3.0,85.59,0.01,9,0.33,4.75,3,6,3,3,0
5,3,0,0,2,2,1,15.36,3.5,188.21,0.02,15,0.29,10.46,5,10,5,5,0
4,3,0,0,2,2,1,10.88,5.6,341.29,0.02,17,0.18,18.96,8,9,5,4,0
0,1,0,0,1,1,1,7.74,1.5,17.41,0.0,5,0.67,0.97,2,3,2,0,0
0,1,0,0,1,1,1,12.68,2.5,79.25,0.01,10,0.4,4.4,4,6,4,0,0
0,1,0,0,1,1,1,7.74,1.5,17.41,0.0,5,0.67,0.97,2,3,2,0,0
0,1,0,0,1,1,1,7.75,2.0,31.02,0.01,6,0.5,1.72,2,4,2,0,0
0,1,0,0,1,1,1,7.75,2.0,31.02,0.01,6,0.5,1.72,2,4,2,0,0
0,1,0,0,1,1,1,7.75,2.0,31.02,0.01,6,0.5,1.72,2,4,2,0,0
0,1,0,0,1,1,1,7.75,2.0,31.02,0.01,6,0.5,1.72,2,4,2,0,0
7,3,0,0,2,2,1,15.65,7.31,836.91,0.04,28,0.14,46.49,13,15,8,7,0
0,1,0,0,1,1,1,7.75,2.0,31.02,0.01,6,0.5,1.72,2,4,2,0,0
0,1,0,0,1,1,1,5.8,2.0,23.22,0.0,5,0.5,1.29,1,4,1,0,0
0,1,0,0,1,1,1,7.75,2.0,31.02,0.01,6,0.5,1.72,2,4,2,0,0
2,1,0,0,1,1,1,8.98,2.5,56.15,0.01,8,0.4,3.12,2,6,2,2,0
2,1,0,0,1,1,1,5.33,1.5,12.0,0.0,4,0.67,0.67,1,3,1,2,0
0,1,0,0,1,1,1,5.33,1.5,12.0,0.0,4,0.67,0.67,1,3,1,0,0
2,1,0,0,1,1,1,5.33,1.5,12.0,0.0,4,0.67,0.67,1,3,1,2,0
2,1,0,0,1,1,1,5.33,1.5,12.0,0.0,4,0.67,0.67,1,3,1,2,0
3,1,0,0,1,1,1,12.0,2.5,75.0,0.01,10,0.4,4.17,3,7,3,3,0
0,1,0,0,1,1,1,7.86,2.5,49.13,0.01,7,0.4,2.73,2,5,2,0,0
0,1,0,0,1,1,1,6.55,3.0,58.95,0.01,7,0.33,3.28,1,6,1,0,0
0,1,0,0,1,1,1,6.55,3.0,58.95,0.01,7,0.33,3.28,1,6,1,0,0
2,1,0,0,1,1,1,8.98,2.5,56.15,0.01,8,0.4,3.12,2,6,2,2,0
2,1,0,0,1,1,1,5.33,1.5,12.0,0.0,4,0.67,0.67,1,3,1,2,0
0,1,0,0,1,1,1,5.33,1.5,12.0,0.0,4,0.67,0.67,1,3,1,0,0
2,1,0,0,1,1,1,5.33,1.5,12.0,0.0,4,0.67,0.67,1,3,1,2,0
2,1,0,0,1,1,1,5.33,1.5,12.0,0.0,4,0.67,0.67,1,3,1,2,0
0,1,0,0,1,1,1,5.33,1.5,12.0,0.0,4,0.67,0.67,1,3,1,0,0
0,1,0,0,1,1,1,5.33,1.5,12.0,0.0,4,0.67,0.67,1,3,1,0,0
0,1,0,0,1,1,1,7.75,2.0,31.02,0.01,6,0.5,1.72,2,4,2,0,0
0,1,0,0,1,1,1,9.0,3.0,81.0,0.01,9,0.33,4.5,2,7,2,0,0
0,1,0,0,1,1,1,8.3,6.0,298.97,0.02,15,0.17,16.61,3,12,2,0,0
0,1,0,0,1,1,1,9.51,3.0,85.59,0.01,9,0.33,4.75,3,6,3,0,0
0,1,0,0,1,1,1,9.51,3.0,85.59,0.01,9,0.33,4.75,3,6,3,0,0
0,1,0,0,1,1,1,9.51,3.0,85.59,0.01,9,0.33,4.75,3,6,3,0,0
0,1,0,0,1,1,1,9.51,3.0,85.59,0.01,9,0.33,4.75,3,6,3,0,0
4,3,0,0,2,2,1,13.67,6.0,492.27,0.03,21,0.17,27.35,6,15,5,4,0
70,21,3,31,11,9,8,67.9,25.58,44433.67,0.58,278,0.04,2468.54,134,144,55,73,0
0,1,0,0,1,1,1,0.0,0.0,0.0,0.0,1,0.0,0.0,0,1,0,0,0
5,3,1,0,2,2,1,5.14,7.0,252.0,0.01,12,0.14,14.0,2,10,1,6,0
0,1,0,0,1,1,1,0.0,0.0,0.0,0.0,0,0.0,0.0,0,0,0,0,0
2,1,0,0,1,1,1,5.33,1.5,12.0,0.0,4,0.67,0.67,1,3,1,2,0
4,1,0,0,1,1,1,10.24,7.0,501.89,0.02,20,0.14,27.88,7,13,4,4,0
4,1,0,0,1,1,1,10.24,7.0,501.89,0.02,20,0.14,27.88,7,13,4,4,0
4,3,0,0,2,2,1,21.5,7.15,1099.18,0.05,35,0.14,61.07,13,22,10,4,0
4,3,0,0,2,2,1,21.5,7.15,1099.18,0.05,35,0.14,61.07,13,22,10,4,0
8,3,0,0,2,2,1,23.46,10.29,2485.24,0.08,52,0.1,138.07,19,33,12,8,0
8,3,0,0,2,2,1,23.46,10.29,2485.24,0.08,52,0.1,138.07,19,33,12,8,0
54,13,1,8,7,6,6,25.11,40.0,40181.42,0.33,184,0.03,2232.3,80,104,22,55,0
54,13,1,8,7,6,6,25.11,40.0,40181.42,0.33,184,0.03,2232.3,80,104,22,55,0
0,1,0,0,1,1,1,8.3,6.67,369.01,0.02,16,0.15,20.5,5,11,3,0,0
0,1,0,0,1,1,1,8.3,6.67,369.01,0.02,16,0.15,20.5,5,11,3,0,0
23,5,0,1,3,2,1,19.78,20.04,7940.87,0.13,80,0.05,441.16,33,47,14,23,0
23,5,0,1,3,2,1,19.78,20.04,7940.87,0.13,80,0.05,441.16,33,47,14,23,0
0,1,0,0,1,1,1,8.6,7.5,483.97,0.02,18,0.13,26.89,5,13,3,0,0
0,1,0,0,1,1,1,8.6,7.5,483.97,0.02,18,0.13,26.89,5,13,3,0,0
19,5,0,3,3,3,1,19.07,10.91,2270.01,0.07,46,0.09,126.11,20,26,11,19,0
19,5,0,3,3,3,1,19.07,10.91,2270.01,0.07,46,0.09,126.11,20,26,11,19,0
12,3,0,2,2,2,1,14.73,8.94,1176.94,0.04,31,0.11,65.39,13,18,8,12,0
12,3,0,2,2,2,1,14.73,8.94,1176.94,0.04,31,0.11,65.39,13,18,8,12,0
12,9,0,0,5,3,3,17.46,16.55,4779.2,0.1,63,0.06,265.51,28,35,11,12,0
12,9,0,0,5,3,3,17.46,16.55,4779.2,0.1,63,0.06,265.51,28,35,11,12,0
4,1,0,0,1,1,1,9.47,2.67,67.38,0.01,9,0.38,3.74,4,5,3,4,0
4,1,0,0,1,1,1,9.47,2.67,67.38,0.01,9,0.38,3.74,4,5,3,4,0
13,5,0,0,3,3,1,16.4,7.07,820.29,0.04,29,0.14,45.57,11,18,7,13,0
13,5,0,0,3,3,1,16.4,7.07,820.29,0.04,29,0.14,45.57,11,18,7,13,0
13,5,0,0,3,3,1,17.24,7.5,969.51,0.04,31,0.13,53.86,12,19,8,13,0
13,5,0,0,3,3,1,17.24,7.5,969.51,0.04,31,0.13,53.86,12,19,8,13,0
4,3,0,0,2,2,1,11.99,6.67,533.03,0.03,21,0.15,29.61,10,11,6,4,0
4,3,0,0,2,2,1,11.99,6.67,533.03,0.03,21,0.15,29.61,10,11,6,4,0
0,1,0,0,1,1,1,6.55,3.0,58.95,0.01,7,0.33,3.28,1,6,1,0,0
0,1,0,0,1,1,1,6.55,3.0,58.95,0.01,7,0.33,3.28,1,6,1,0,0
0,3,0,0,2,2,1,6.69,7.5,376.42,0.02,14,0.13,20.91,5,9,3,0,0
0,3,0,0,2,2,1,6.69,7.5,376.42,0.02,14,0.13,20.91,5,9,3,0,0
0,1,0,0,1,1,1,7.86,2.5,49.13,0.01,7,0.4,2.73,2,5,2,0,0
0,1,0,0,1,1,1,7.86,2.5,49.13,0.01,7,0.4,2.73,2,5,2,0,0
0,3,0,0,2,2,1,9.32,5.0,233.02,0.02,13,0.2,12.95,5,8,4,0,0
0,3,0,0,2,2,1,9.32,5.0,233.02,0.02,13,0.2,12.95,5,8,4,0,0
6,1,0,0,1,1,1,17.51,5.0,437.85,0.03,23,0.2,24.32,10,13,7,6,0
6,1,0,0,1,1,1,17.51,5.0,437.85,0.03,23,0.2,24.32,10,13,7,6,0
0,3,0,0,2,2,1,7.75,2.0,31.02,0.01,6,0.5,1.72,2,4,2,0,0
0,3,0,0,2,2,1,7.75,2.0,31.02,0.01,6,0.5,1.72,2,4,2,0,0
0,3,0,0,2,2,1,7.86,2.5,49.13,0.01,7,0.4,2.73,2,5,2,0,0
0,3,0,0,2,2,1,7.86,2.5,49.13,0.01,7,0.4,2.73,2,5,2,0,0
11,7,0,0,4,2,3,12.35,16.0,3162.47,0.07,45,0.06,175.69,16,29,7,11,0
11,7,0,0,4,2,3,12.35,16.0,3162.47,0.07,45,0.06,175.69,16,29,7,11,0
3,3,0,0,2,2,1,14.28,4.0,228.44,0.02,15,0.25,12.69,6,9,6,3,0
3,3,0,0,2,2,1,14.28,4.0,228.44,0.02,15,0.25,12.69,6,9,6,3,0
0,1,0,0,1,1,1,0.0,0.0,0.0,0.0,1,0.0,0.0,0,1,0,0,0
0,1,0,0,1,1,1,0.0,0.0,0.0,0.0,1,0.0,0.0,0,1,0,0,0
2,1,0,0,1,1,1,13.5,2.0,54.0,0.01,9,0.5,3.0,4,5,4,2,0
2,1,0,0,1,1,1,13.5,2.0,54.0,0.01,9,0.5,3.0,4,5,4,2,0
0,1,0,0,1,1,1,7.75,2.0,31.02,0.01,6,0.5,1.72,2,4,2,0,0
0,1,0,0,1,1,1,7.75,2.0,31.02,0.01,6,0.5,1.72,2,4,2,0,0
0,1,0,0,1,1,1,7.75,2.0,31.02,0.01,6,0.5,1.72,2,4,2,0,0
0,1,0,0,1,1,1,7.75,2.0,31.02,0.01,6,0.5,1.72,2,4,2,0,0
0,1,0,0,1,1,1,7.75,2.0,31.02,0.01,6,0.5,1.72,2,4,2,0,0
0,1,0,0,1,1,1,7.75,2.0,31.02,0.01,6,0.5,1.72,2,4,2,0,0
0,1,0,0,1,1,1,7.74,1.5,17.41,0.0,5,0.67,0.97,2,3,2,0,0
0,1,0,0,1,1,1,7.74,1.5,17.41,0.0,5,0.67,0.97,2,3,2,0,0
1,1,0,0,1,1,1,7.74,1.5,17.41,0.0,5,0.67,0.97,2,3,2,1,0
1,1,0,0,1,1,1,7.74,1.5,17.41,0.0,5,0.67,0.97,2,3,2,1,0
0,1,0,0,1,1,1,5.8,2.0,23.22,0.0,5,0.5,1.29,1,4,1,0,0
0,1,0,0,1,1,1,5.8,2.0,23.22,0.0,5,0.5,1.29,1,4,1,0,0
2,1,0,0,1,1,1,7.75,2.0,31.02,0.01,6,0.5,1.72,2,4,2,2,0
2,1,0,0,1,1,1,7.75,2.0,31.02,0.01,6,0.5,1.72,2,4,2,2,0
1,1,0,1,1,1,1,0.0,0.0,0.0,0.0,1,0.0,0.0,0,1,0,1,0
1,1,0,1,1,1,1,0.0,0.0,0.0,0.0,1,0.0,0.0,0,1,0,1,0
2,1,0,0,1,1,1,7.75,2.0,31.02,0.01,6,0.5,1.72,2,4,2,2,0
2,1,0,0,1,1,1,7.75,2.0,31.02,0.01,6,0.5,1.72,2,4,2,2,0
0,1,0,0,1,1,1,9.31,2.5,58.16,0.01,9,0.4,3.23,1,8,1,0,0
0,1,0,0,1,1,1,9.31,2.5,58.16,0.01,9,0.4,3.23,1,8,1,0,0
0,1,0,0,1,1,1,7.75,2.0,31.02,0.01,6,0.5,1.72,2,4,2,0,0
0,1,0,0,1,1,1,7.75,2.0,31.02,0.01,6,0.5,1.72,2,4,2,0,0
0,1,0,0,1,1,1,10.68,4.67,232.53,0.02,15,0.21,12.92,4,11,3,0,0
0,1,0,0,1,1,1,10.68,4.67,232.53,0.02,15,0.21,12.92,4,11,3,0,0
7,5,0,0,3,2,1,11.89,13.13,2048.55,0.05,35,0.08,113.81,15,20,8,7,0
7,5,0,0,3,2,1,11.89,13.13,2048.55,0.05,35,0.08,113.81,15,20,8,7,0
5,3,0,0,2,2,1,17.22,4.08,287.09,0.02,19,0.24,15.95,7,12,6,5,0
5,3,0,0,2,2,1,17.22,4.08,287.09,0.02,19,0.24,15.95,7,12,6,5,0
4,3,0,0,2,2,1,11.18,5.63,353.85,0.02,17,0.18,19.66,5,12,4,4,0
4,3,0,0,2,2,1,11.18,5.63,353.85,0.02,17,0.18,19.66,5,12,4,4,0
0,1,0,0,1,1,1,0.0,0.0,0.0,0.0,0,0.0,0.0,0,0,0,0,0
0,1,0,0,1,1,1,0.0,0.0,0.0,0.0,0,0.0,0.0,0,0,0,0,0
0,1,0,0,1,1,1,6.2,2.5,38.77,0.01,6,0.4,2.15,1,5,1,0,0
0,1,0,0,1,1,1,6.2,2.5,38.77,0.01,6,0.4,2.15,1,5,1,0,0
0,1,0,0,1,1,1,11.86,3.5,145.3,0.01,12,0.29,8.07,4,8,4,0,0
0,1,0,0,1,1,1,11.86,3.5,145.3,0.01,12,0.29,8.07,4,8,4,0,0
0,1,0,0,1,1,1,0.0,0.0,0.0,0.0,0,0.0,0.0,0,0,0,0,0
0,1,0,0,1,1,1,0.0,0.0,0.0,0.0,0,0.0,0.0,0,0,0,0,0
0,1,0,0,1,1,1,0.0,0.0,0.0,0.0,0,0.0,0.0,0,0,0,0,0
0,1,0,0,1,1,1,0.0,0.0,0.0,0.0,0,0.0,0.0,0,0,0,0,0
0,1,0,0,1,1,1,0.0,0.0,0.0,0.0,0,0.0,0.0,0,0,0,0,0
0,1,0,0,1,1,1,0.0,0.0,0.0,0.0,0,0.0,0.0,0,0,0,0,0
0,1,0,0,1,1,1,7.33,4.5,148.5,0.01,11,0.22,8.25,3,8,2,0,0
0,1,0,0,1,1,1,7.33,4.5,148.5,0.01,11,0.22,8.25,3,8,2,0,0
8,3,0,0,2,1,1,15.07,9.75,1432.72,0.05,34,0.1,79.6,13,21,8,8,0
8,3,0,0,2,1,1,15.07,9.75,1432.72,0.05,34,0.1,79.6,13,21,8,8,0
0,1,0,0,1,1,1,9.6,2.5,60.0,0.01,8,0.4,3.33,3,5,3,0,0
0,1,0,0,1,1,1,9.6,2.5,60.0,0.01,8,0.4,3.33,3,5,3,0,0
0,1,0,0,1,1,1,7.75,2.0,31.02,0.01,6,0.5,1.72,2,4,2,0,0
0,1,0,0,1,1,1,7.75,2.0,31.02,0.01,6,0.5,1.72,2,4,2,0,0
0,1,0,0,1,1,1,6.86,3.5,84.0,0.01,8,0.29,4.67,1,7,1,0,0
0,1,0,0,1,1,1,6.86,3.5,84.0,0.01,8,0.29,4.67,1,7,1,0,0
0,1,0,0,1,1,1,7.75,2.0,31.02,0.01,6,0.5,1.72,2,4,2,0,0
0,1,0,0,1,1,1,7.75,2.0,31.02,0.01,6,0.5,1.72,2,4,2,0,0
2,1,0,0,1,1,1,6.2,2.5,38.77,0.01,6,0.4,2.15,1,5,1,2,0
2,1,0,0,1,1,1,6.2,2.5,38.77,0.01,6,0.4,2.15,1,5,1,2,0
0,1,0,0,1,1,1,8.3,6.0,298.97,0.02,15,0.17,16.61,3,12,2,0,0
0,1,0,0,1,1,1,8.3,6.0,298.97,0.02,15,0.17,16.61,3,12,2,0,0
0,1,0,0,1,1,1,8.3,6.0,298.97,0.02,15,0.17,16.61,3,12,2,0,0
0,1,0,0,1,1,1,8.3,6.0,298.97,0.02,15,0.17,16.61,3,12,2,0,0
0,1,0,0,1,1,1,8.3,6.0,298.97,0.02,15,0.17,16.61,3,12,2,0,0
0,1,0,0,1,1,1,8.3,6.0,298.97,0.02,15,0.17,16.61,3,12,2,0,0
0,1,0,0,1,1,1,7.75,2.0,31.02,0.01,6,0.5,1.72,2,4,2,0,0
0,1,0,0,1,1,1,7.75,2.0,31.02,0.01,6,0.5,1.72,2,4,2,0,0
0,1,0,0,1,1,1,7.75,2.0,31.02,0.01,6,0.5,1.72,2,4,2,0,0
0,1,0,0,1,1,1,7.75,2.0,31.02,0.01,6,0.5,1.72,2,4,2,0,0
2,1,0,1,1,1,1,5.8,2.0,23.22,0.0,5,0.5,1.29,1,4,1,2,0
2,1,0,1,1,1,1,5.8,2.0,23.22,0.0,5,0.5,1.29,1,4,1,2,0
2,1,0,0,1,1,1,5.33,1.5,12.0,0.0,4,0.67,0.67,1,3,1,2,0
2,1,0,0,1,1,1,5.33,1.5,12.0,0.0,4,0.67,0.67,1,3,1,2,0
0,1,0,0,1,1,1,7.75,2.0,31.02,0.01,6,0.5,1.72,2,4,2,0,0
0,1,0,0,1,1,1,7.75,2.0,31.02,0.01,6,0.5,1.72,2,4,2,0,0
0,1,0,0,1,1,1,7.75,2.0,31.02,0.01,6,0.5,1.72,2,4,2,0,0
0,1,0,0,1,1,1,7.75,2.0,31.02,0.01,6,0.5,1.72,2,4,2,0,0
0,3,0,0,2,1,1,7.75,2.0,31.02,0.01,6,0.5,1.72,2,4,2,0,0
0,3,0,0,2,1,1,7.75,2.0,31.02,0.01,6,0.5,1.72,2,4,2,0,0
0,1,0,0,1,1,1,5.8,2.0,23.22,0.0,5,0.5,1.29,1,4,1,0,0
0,1,0,0,1,1,1,5.8,2.0,23.22,0.0,5,0.5,1.29,1,4,1,0,0
0,3,0,0,2,1,1,7.75,2.0,31.02,0.01,6,0.5,1.72,2,4,2,0,0
0,3,0,0,2,1,1,7.75,2.0,31.02,0.01,6,0.5,1.72,2,4,2,0,0
0,1,0,0,1,1,1,12.18,3.0,109.62,0.01,11,0.33,6.09,4,7,4,0,0
0,1,0,0,1,1,1,12.18,3.0,109.62,0.01,11,0.33,6.09,4,7,4,0,0
0,1,0,0,1,1,1,7.75,2.0,31.02,0.01,6,0.5,1.72,2,4,2,0,0
0,1,0,0,1,1,1,7.75,2.0,31.02,0.01,6,0.5,1.72,2,4,2,0,0
0,1,0,0,1,1,1,7.75,2.0,31.02,0.01,6,0.5,1.72,2,4,2,0,0
0,1,0,0,1,1,1,7.75,2.0,31.02,0.01,6,0.5,1.72,2,4,2,0,0
0,1,0,0,1,1,1,7.75,2.0,31.02,0.01,6,0.5,1.72,2,4,2,0,0
0,1,0,0,1,1,1,7.75,2.0,31.02,0.01,6,0.5,1.72,2,4,2,0,0
0,1,0,0,1,1,1,5.8,2.0,23.22,0.0,5,0.5,1.29,1,4,1,0,0
0,1,0,0,1,1,1,5.8,2.0,23.22,0.0,5,0.5,1.29,1,4,1,0,0
0,1,0,0,1,1,1,7.75,2.0,31.02,0.01,6,0.5,1.72,2,4,2,0,0
0,1,0,0,1,1,1,7.75,2.0,31.02,0.01,6,0.5,1.72,2,4,2,0,0
2,1,0,0,1,1,1,8.98,2.5,56.15,0.01,8,0.4,3.12,2,6,2,2,0
2,1,0,0,1,1,1,8.98,2.5,56.15,0.01,8,0.4,3.12,2,6,2,2,0
2,1,0,0,1,1,1,5.33,1.5,12.0,0.0,4,0.67,0.67,1,3,1,2,0
2,1,0,0,1,1,1,5.33,1.5,12.0,0.0,4,0.67,0.67,1,3,1,2,0
0,1,0,0,1,1,1,5.33,1.5,12.0,0.0,4,0.67,0.67,1,3,1,0,0
0,1,0,0,1,1,1,5.33,1.5,12.0,0.0,4,0.67,0.67,1,3,1,0,0
2,1,0,0,1,1,1,5.33,1.5,12.0,0.0,4,0.67,0.67,1,3,1,2,0
2,1,0,0,1,1,1,5.33,1.5,12.0,0.0,4,0.67,0.67,1,3,1,2,0
2,1,0,0,1,1,1,5.33,1.5,12.0,0.0,4,0.67,0.67,1,3,1,2,0
2,1,0,0,1,1,1,5.33,1.5,12.0,0.0,4,0.67,0.67,1,3,1,2,0
3,1,0,0,1,1,1,12.0,2.5,75.0,0.01,10,0.4,4.17,3,7,3,3,0
3,1,0,0,1,1,1,12.0,2.5,75.0,0.01,10,0.4,4.17,3,7,3,3,0
0,1,0,0,1,1,1,7.86,2.5,49.13,0.01,7,0.4,2.73,2,5,2,0,0
0,1,0,0,1,1,1,7.86,2.5,49.13,0.01,7,0.4,2.73,2,5,2,0,0
0,1,0,0,1,1,1,6.55,3.0,58.95,0.01,7,0.33,3.28,1,6,1,0,0
0,1,0,0,1,1,1,6.55,3.0,58.95,0.01,7,0.33,3.28,1,6,1,0,0
0,1,0,0,1,1,1,6.55,3.0,58.95,0.01,7,0.33,3.28,1,6,1,0,0
0,1,0,0,1,1,1,6.55,3.0,58.95,0.01,7,0.33,3.28,1,6,1,0,0
2,1,0,0,1,1,1,8.98,2.5,56.15,0.01,8,0.4,3.12,2,6,2,2,0
2,1,0,0,1,1,1,8.98,2.5,56.15,0.01,8,0.4,3.12,2,6,2,2,0
2,1,0,0,1,1,1,5.33,1.5,12.0,0.0,4,0.67,0.67,1,3,1,2,0
2,1,0,0,1,1,1,5.33,1.5,12.0,0.0,4,0.67,0.67,1,3,1,2,0
0,1,0,0,1,1,1,5.33,1.5,12.0,0.0,4,0.67,0.67,1,3,1,0,0
0,1,0,0,1,1,1,5.33,1.5,12.0,0.0,4,0.67,0.67,1,3,1,0,0
2,1,0,0,1,1,1,5.33,1.5,12.0,0.0,4,0.67,0.67,1,3,1,2,0
2,1,0,0,1,1,1,5.33,1.5,12.0,0.0,4,0.67,0.67,1,3,1,2,0
2,1,0,0,1,1,1,5.33,1.5,12.0,0.0,4,0.67,0.67,1,3,1,2,0
2,1,0,0,1,1,1,5.33,1.5,12.0,0.0,4,0.67,0.67,1,3,1,2,0
0,1,0,0,1,1,1,5.33,1.5,12.0,0.0,4,0.67,0.67,1,3,1,0,0
0,1,0,0,1,1,1,5.33,1.5,12.0,0.0,4,0.67,0.67,1,3,1,0,0
0,1,0,0,1,1,1,5.33,1.5,12.0,0.0,4,0.67,0.67,1,3,1,0,0
0,1,0,0,1,1,1,5.33,1.5,12.0,0.0,4,0.67,0.67,1,3,1,0,0
3,1,0,0,1,1,1,9.51,3.0,85.59,0.01,9,0.33,4.75,3,6,3,3,0
3,1,0,0,1,1,1,9.51,3.0,85.59,0.01,9,0.33,4.75,3,6,3,3,0
5,3,0,0,2,2,1,15.36,3.5,188.21,0.02,15,0.29,10.46,5,10,5,5,0
5,3,0,0,2,2,1,15.36,3.5,188.21,0.02,15,0.29,10.46,5,10,5,5,0
4,3,0,0,2,2,1,10.88,5.6,341.29,0.02,17,0.18,18.96,8,9,5,4,0
4,3,0,0,2,2,1,10.88,5.6,341.29,0.02,17,0.18,18.96,8,9,5,4,0
0,1,0,0,1,1,1,7.74,1.5,17.41,0.0,5,0.67,0.97,2,3,2,0,0
0,1,0,0,1,1,1,7.74,1.5,17.41,0.0,5,0.67,0.97,2,3,2,0,0
0,1,0,0,1,1,1,12.68,2.5,79.25,0.01,10,0.4,4.4,4,6,4,0,0
0,1,0,0,1,1,1,12.68,2.5,79.25,0.01,10,0.4,4.4,4,6,4,0,0
0,1,0,0,1,1,1,7.74,1.5,17.41,0.0,5,0.67,0.97,2,3,2,0,0
0,1,0,0,1,1,1,7.74,1.5,17.41,0.0,5,0.67,0.97,2,3,2,0,0
0,1,0,0,1,1,1,7.75,2.0,31.02,0.01,6,0.5,1.72,2,4,2,0,0
0,1,0,0,1,1,1,7.75,2.0,31.02,0.01,6,0.5,1.72,2,4,2,0,0
0,1,0,0,1,1,1,7.75,2.0,31.02,0.01,6,0.5,1.72,2,4,2,0,0
0,1,0,0,1,1,1,7.75,2.0,31.02,0.01,6,0.5,1.72,2,4,2,0,0
0,1,0,0,1,1,1,7.75,2.0,31.02,0.01,6,0.5,1.72,2,4,2,0,0
0,1,0,0,1,1,1,7.75,2.0,31.02,0.01,6,0.5,1.72,2,4,2,0,0
0,1,0,0,1,1,1,7.75,2.0,31.02,0.01,6,0.5,1.72,2,4,2,0,0
0,1,0,0,1,1,1,7.75,2.0,31.02,0.01,6,0.5,1.72,2,4,2,0,0
0,1,0,0,1,1,1,7.75,2.0,31.02,0.01,6,0.5,1.72,2,4,2,0,0
0,1,0,0,1,1,1,7.75,2.0,31.02,0.01,6,0.5,1.72,2,4,2,0,0
2,1,0,0,1,1,1,6.2,2.5,38.77,0.01,6,0.4,2.15,1,5,1,2,0
2,1,0,0,1,1,1,6.2,2.5,38.77,0.01,6,0.4,2.15,1,5,1,2,0
0,1,0,0,1,1,1,9.0,3.0,81.0,0.01,9,0.33,4.5,2,7,2,0,0
0,1,0,0,1,1,1,9.0,3.0,81.0,0.01,9,0.33,4.5,2,7,2,0,0
0,1,0,0,1,1,1,8.3,6.0,298.97,0.02,15,0.17,16.61,3,12,2,0,0
0,1,0,0,1,1,1,8.3,6.0,298.97,0.02,15,0.17,16.61,3,12,2,0,0
2,1,0,0,1,1,1,5.33,1.5,12.0,0.0,4,0.67,0.67,1,3,1,2,0
2,1,0,0,1,1,1,5.33,1.5,12.0,0.0,4,0.67,0.67,1,3,1,2,0
0,1,0,0,1,1,1,9.51,3.0,85.59,0.01,9,0.33,4.75,3,6,3,0,0
0,1,0,0,1,1,1,9.51,3.0,85.59,0.01,9,0.33,4.75,3,6,3,0,0
0,1,0,0,1,1,1,9.51,3.0,85.59,0.01,9,0.33,4.75,3,6,3,0,0
0,1,0,0,1,1,1,9.51,3.0,85.59,0.01,9,0.33,4.75,3,6,3,0,0
0,1,0,0,1,1,1,9.51,3.0,85.59,0.01,9,0.33,4.75,3,6,3,0,0
0,1,0,0,1,1,1,9.51,3.0,85.59,0.01,9,0.33,4.75,3,6,3,0,0
0,1,0,0,1,1,1,9.51,3.0,85.59,0.01,9,0.33,4.75,3,6,3,0,0
0,1,0,0,1,1,1,9.51,3.0,85.59,0.01,9,0.33,4.75,3,6,3,0,0
4,3,0,0,2,2,1,13.67,6.0,492.27,0.03,21,0.17,27.35,6,15,5,4,0
4,3,0,0,2,2,1,13.67,6.0,492.27,0.03,21,0.17,27.35,6,15,5,4,0
2,1,0,0,1,1,1,9.97,4.0,159.45,0.01,12,0.25,8.86,2,10,2,2,0
2,1,0,0,1,1,1,9.97,4.0,159.45,0.01,12,0.25,8.86,2,10,2,2,0
2,1,0,0,1,1,1,7.86,2.5,49.13,0.01,7,0.4,2.73,2,5,2,2,0
2,1,0,0,1,1,1,7.86,2.5,49.13,0.01,7,0.4,2.73,2,5,2,2,0
2,1,0,0,1,1,1,6.2,2.5,38.77,0.01,6,0.4,2.15,1,5,1,2,0
2,1,0,0,1,1,1,6.2,2.5,38.77,0.01,6,0.4,2.15,1,5,1,2,0
5,1,0,1,1,1,1,17.99,5.0,449.73,0.03,26,0.2,24.98,12,14,6,5,0
15,5,1,0,3,3,1,29.96,8.57,2200.78,0.09,56,0.12,122.27,24,32,14,16,0
2,1,0,0,1,1,1,7.74,1.5,17.41,0.0,5,0.67,0.97,2,3,2,2,0
15,3,0,1,2,2,1,32.47,8.82,2529.01,0.1,59,0.11,140.5,25,34,17,15,0
15,3,0,1,2,2,1,34.47,8.09,2255.22,0.09,58,0.12,125.29,25,33,17,15,0
10,1,0,0,1,1,1,22.77,7.65,1332.36,0.06,41,0.13,74.02,17,24,10,10,0
10,1,0,0,1,1,1,24.53,6.8,1134.22,0.06,40,0.15,63.01,17,23,10,10,0
20,5,0,3,3,2,1,36.21,11.33,4650.55,0.14,80,0.09,258.36,34,46,21,20,0
20,5,0,3,3,2,1,40.5,9.71,3822.21,0.13,78,0.1,212.34,34,44,21,20,0
2,1,0,0,1,1,1,5.33,1.5,12.0,0.0,4,0.67,0.67,1,3,1,2,0
2,1,0,0,1,1,1,5.33,1.5,12.0,0.0,4,0.67,0.67,1,3,1,2,0
18,11,3,1,6,2,6,23.47,24.5,14087.5,0.19,115,0.04,782.64,49,66,16,21,0
10,3,2,0,2,2,1,24.55,8.85,1920.77,0.07,48,0.11,106.71,23,25,13,12,0
22,9,0,0,5,1,5,20.3,25.14,12830.82,0.17,104,0.04,712.82,44,60,14,22,0
13,3,1,0,2,2,1,22.45,12.07,3271.7,0.09,57,0.08,181.76,26,31,14,14,0
9,3,0,4,2,2,1,11.98,7.5,673.94,0.03,23,0.13,37.44,10,13,6,9,0
17,3,0,1,2,2,1,48.99,8.4,3456.99,0.14,79,0.12,192.06,35,44,25,17,0
15,3,0,1,2,2,1,53.57,6.46,2234.24,0.12,68,0.15,124.12,31,37,24,15,0
11,1,0,0,1,1,1,27.05,6.91,1291.37,0.06,44,0.14,71.74,19,25,11,11,0
11,1,0,0,1,1,1,25.02,7.77,1511.69,0.06,45,0.13,83.98,19,26,11,11,0
25,3,0,1,2,2,1,62.29,10.4,6737.7,0.22,116,0.1,374.32,56,60,35,25,0
14,1,0,0,1,1,1,40.49,6.62,1773.03,0.09,57,0.15,98.5,25,32,17,14,0
18,3,0,1,2,2,1,53.35,8.22,3606.99,0.15,83,0.12,200.39,37,46,27,18,0
18,3,0,1,2,2,1,57.1,7.54,3243.41,0.14,82,0.13,180.19,37,45,27,18,0
2,1,3,0,1,1,1,32.94,1.71,96.81,0.02,17,0.58,5.38,8,9,7,5,0
1,9,6,0,5,1,1,15.14,4.8,348.71,0.02,21,0.21,19.37,8,13,5,7,0
8,5,6,0,3,3,1,30.59,3.75,430.18,0.04,31,0.27,23.9,12,19,8,14,0
8,5,6,0,3,3,1,30.59,3.75,430.18,0.04,31,0.27,23.9,12,19,8,14,0
8,5,6,0,3,3,1,30.59,3.75,430.18,0.04,31,0.27,23.9,12,19,8,14,0
8,5,6,0,3,3,1,30.59,3.75,430.18,0.04,31,0.27,23.9,12,19,8,14,0
8,5,6,0,3,3,1,30.59,3.75,430.18,0.04,31,0.27,23.9,12,19,8,14,0
8,5,6,0,3,3,1,30.59,3.75,430.18,0.04,31,0.27,23.9,12,19,8,14,0
8,5,6,0,3,3,1,30.59,3.75,430.18,0.04,31,0.27,23.9,12,19,8,14,0
8,5,6,0,3,3,1,30.59,3.75,430.18,0.04,31,0.27,23.9,12,19,8,14,0
8,5,6,0,3,3,1,30.59,3.75,430.18,0.04,31,0.27,23.9,12,19,8,14,0
1,9,6,0,5,1,1,15.14,4.8,348.71,0.02,21,0.21,19.37,8,13,5,7,0
8,5,6,0,3,3,1,30.59,3.75,430.18,0.04,31,0.27,23.9,12,19,8,14,0
8,5,6,0,3,3,1,30.59,3.75,430.18,0.04,31,0.27,23.9,12,19,8,14,0
8,5,6,0,3,3,1,30.59,3.75,430.18,0.04,31,0.27,23.9,12,19,8,14,0
8,5,6,0,3,3,1,30.59,3.75,430.18,0.04,31,0.27,23.9,12,19,8,14,0
8,5,6,0,3,3,1,30.59,3.75,430.18,0.04,31,0.27,23.9,12,19,8,14,0
8,5,6,0,3,3,1,30.59,3.75,430.18,0.04,31,0.27,23.9,12,19,8,14,0
8,5,6,0,3,3,1,30.59,3.75,430.18,0.04,31,0.27,23.9,12,19,8,14,0
8,5,6,0,3,3,1,30.59,3.75,430.18,0.04,31,0.27,23.9,12,19,8,14,0
8,5,6,0,3,3,1,30.59,3.75,430.18,0.04,31,0.27,23.9,12,19,8,14,0
8,5,6,0,3,3,1,30.59,3.75,430.18,0.04,31,0.27,23.9,12,19,8,14,0
8,5,6,0,3,3,1,30.59,3.75,430.18,0.04,31,0.27,23.9,12,19,8,14,0
5,3,5,0,2,2,1,13.96,6.0,502.57,0.03,22,0.17,27.92,9,13,6,10,0
5,3,5,0,2,2,1,13.96,6.0,502.57,0.03,22,0.17,27.92,9,13,6,10,0
5,3,5,0,2,2,1,13.96,6.0,502.57,0.03,22,0.17,27.92,9,13,6,10,0
5,3,5,0,2,2,1,13.96,6.0,502.57,0.03,22,0.17,27.92,9,13,6,10,0
5,3,5,0,2,2,1,13.96,6.0,502.57,0.03,22,0.17,27.92,9,13,6,10,0
5,3,5,0,2,2,1,13.96,6.0,502.57,0.03,22,0.17,27.92,9,13,6,10,0
5,3,5,0,2,2,1,13.96,6.0,502.57,0.03,22,0.17,27.92,9,13,6,10,0
5,3,5,0,2,2,1,13.96,6.0,502.57,0.03,22,0.17,27.92,9,13,6,10,0
5,3,5,0,2,2,1,13.96,6.0,502.57,0.03,22,0.17,27.92,9,13,6,10,0
5,3,5,0,2,2,1,13.96,6.0,502.57,0.03,22,0.17,27.92,9,13,6,10,0
5,3,5,0,2,2,1,13.96,6.0,502.57,0.03,22,0.17,27.92,9,13,6,10,0
5,3,5,0,2,2,1,13.96,6.0,502.57,0.03,22,0.17,27.92,9,13,6,10,0
5,3,5,0,2,2,1,13.96,6.0,502.57,0.03,22,0.17,27.92,9,13,6,10,0
5,3,5,0,2,2,1,13.96,6.0,502.57,0.03,22,0.17,27.92,9,13,6,10,0
5,3,5,0,2,2,1,13.96,6.0,502.57,0.03,22,0.17,27.92,9,13,6,10,0
5,3,5,0,2,2,1,13.96,6.0,502.57,0.03,22,0.17,27.92,9,13,6,10,0
5,3,5,0,2,2,1,13.96,6.0,502.57,0.03,22,0.17,27.92,9,13,6,10,0
5,3,5,0,2,2,1,13.96,6.0,502.57,0.03,22,0.17,27.92,9,13,6,10,0
5,3,5,0,2,2,1,13.96,6.0,502.57,0.03,22,0.17,27.92,9,13,6,10,0
5,3,5,0,2,2,1,13.96,6.0,502.57,0.03,22,0.17,27.92,9,13,6,10,0
5,3,5,0,2,2,1,13.96,6.0,502.57,0.03,22,0.17,27.92,9,13,6,10,0
5,3,5,0,2,2,1,13.96,6.0,502.57,0.03,22,0.17,27.92,9,13,6,10,0
9,5,0,0,3,1,1,9.88,5.25,272.43,0.02,15,0.19,15.14,6,9,4,9,0
9,5,0,0,3,1,1,9.88,5.25,272.43,0.02,15,0.19,15.14,6,9,4,9,0
5,3,2,2,2,1,1,27.78,3.6,360.0,0.03,25,0.28,20.0,12,13,10,7,0
5,3,2,2,2,1,1,27.78,3.6,360.0,0.03,25,0.28,20.0,12,13,10,7,0
0,1,0,0,1,1,1,0.0,0.0,0.0,0.0,1,0.0,0.0,0,1,0,0,0
0,1,0,0,1,1,1,0.0,0.0,0.0,0.0,0,0.0,0.0,0,0,0,0,0
0,1,0,0,1,1,1,5.33,1.5,12.0,0.0,4,0.67,0.67,1,3,1,0,0
0,1,0,0,1,1,1,5.33,1.5,12.0,0.0,4,0.67,0.67,1,3,1,0,0
0,1,0,0,1,1,1,5.33,1.5,12.0,0.0,4,0.67,0.67,1,3,1,0,0
0,1,0,0,1,1,1,5.33,1.5,12.0,0.0,4,0.67,0.67,1,3,1,0,0
0,1,0,0,1,1,1,5.33,1.5,12.0,0.0,4,0.67,0.67,1,3,1,0,0
0,1,0,0,1,1,1,9.51,3.0,85.59,0.01,9,0.33,4.75,3,6,3,0,0
0,1,0,0,1,1,1,5.33,1.5,12.0,0.0,4,0.67,0.67,1,3,1,0,0
0,1,0,0,1,1,1,5.33,1.5,12.0,0.0,4,0.67,0.67,1,3,1,0,0
0,1,0,0,1,1,1,5.33,1.5,12.0,0.0,4,0.67,0.67,1,3,1,0,0
2,1,0,0,1,1,1,7.74,1.5,17.41,0.0,5,0.67,0.97,2,3,2,2,0
0,1,0,0,1,1,1,5.33,1.5,12.0,0.0,4,0.67,0.67,1,3,1,0,0
0,1,0,0,1,1,1,5.33,1.5,12.0,0.0,4,0.67,0.67,1,3,1,0,0
0,1,0,0,1,1,1,5.33,1.5,12.0,0.0,4,0.67,0.67,1,3,1,0,0
17,8,0,0,7,1,1,31.08,5.38,901.23,0.06,37,0.19,50.07,14,23,13,17,0
17,8,0,0,7,1,1,31.08,5.38,901.23,0.06,37,0.19,50.07,14,23,13,17,0
4,1,0,0,1,1,1,10.24,7.0,501.89,0.02,20,0.14,27.88,7,13,4,4,0
4,3,0,0,2,2,1,21.5,7.15,1099.18,0.05,35,0.14,61.07,13,22,10,4,0
8,3,0,0,2,2,1,23.46,10.29,2485.24,0.08,52,0.1,138.07,19,33,12,8,0
54,13,1,8,7,6,6,25.11,40.0,40181.42,0.33,184,0.03,2232.3,80,104,22,55,0
0,1,0,0,1,1,1,8.3,6.67,369.01,0.02,16,0.15,20.5,5,11,3,0,0
23,5,0,1,3,2,1,19.78,20.04,7940.87,0.13,80,0.05,441.16,33,47,14,23,0
0,1,0,0,1,1,1,8.6,7.5,483.97,0.02,18,0.13,26.89,5,13,3,0,0
19,5,0,3,3,3,1,19.07,10.91,2270.01,0.07,46,0.09,126.11,20,26,11,19,0
12,3,0,2,2,2,1,14.73,8.94,1176.94,0.04,31,0.11,65.39,13,18,8,12,0
12,9,0,0,5,3,3,17.46,16.55,4779.2,0.1,63,0.06,265.51,28,35,11,12,0
4,1,0,0,1,1,1,9.47,2.67,67.38,0.01,9,0.38,3.74,4,5,3,4,0
13,5,0,0,3,3,1,16.4,7.07,820.29,0.04,29,0.14,45.57,11,18,7,13,0
13,5,0,0,3,3,1,17.24,7.5,969.51,0.04,31,0.13,53.86,12,19,8,13,0
4,3,0,0,2,2,1,11.99,6.67,533.03,0.03,21,0.15,29.61,10,11,6,4,0
0,1,0,0,1,1,1,6.55,3.0,58.95,0.01,7,0.33,3.28,1,6,1,0,0
0,3,0,0,2,2,1,6.69,7.5,376.42,0.02,14,0.13,20.91,5,9,3,0,0
0,1,0,0,1,1,1,7.86,2.5,49.13,0.01,7,0.4,2.73,2,5,2,0,0
0,3,0,0,2,2,1,9.32,5.0,233.02,0.02,13,0.2,12.95,5,8,4,0,0
6,1,0,0,1,1,1,17.51,5.0,437.85,0.03,23,0.2,24.32,10,13,7,6,0
0,3,0,0,2,2,1,7.75,2.0,31.02,0.01,6,0.5,1.72,2,4,2,0,0
0,3,0,0,2,2,1,7.86,2.5,49.13,0.01,7,0.4,2.73,2,5,2,0,0
11,7,0,0,4,2,3,12.35,16.0,3162.47,0.07,45,0.06,175.69,16,29,7,11,0
3,3,0,0,2,2,1,14.28,4.0,228.44,0.02,15,0.25,12.69,6,9,6,3,0
0,1,0,0,1,1,1,0.0,0.0,0.0,0.0,1,0.0,0.0,0,1,0,0,0
2,1,0,0,1,1,1,13.5,2.0,54.0,0.01,9,0.5,3.0,4,5,4,2,0
0,1,0,0,1,1,1,7.75,2.0,31.02,0.01,6,0.5,1.72,2,4,2,0,0
0,1,0,0,1,1,1,7.75,2.0,31.02,0.01,6,0.5,1.72,2,4,2,0,0
0,1,0,0,1,1,1,7.75,2.0,31.02,0.01,6,0.5,1.72,2,4,2,0,0
0,1,0,0,1,1,1,7.74,1.5,17.41,0.0,5,0.67,0.97,2,3,2,0,0
1,1,0,0,1,1,1,7.74,1.5,17.41,0.0,5,0.67,0.97,2,3,2,1,0
0,1,0,0,1,1,1,5.8,2.0,23.22,0.0,5,0.5,1.29,1,4,1,0,0
2,1,0,0,1,1,1,7.75,2.0,31.02,0.01,6,0.5,1.72,2,4,2,2,0
1,1,0,1,1,1,1,0.0,0.0,0.0,0.0,1,0.0,0.0,0,1,0,1,0
2,1,0,0,1,1,1,7.75,2.0,31.02,0.01,6,0.5,1.72,2,4,2,2,0
0,1,0,0,1,1,1,9.31,2.5,58.16,0.01,9,0.4,3.23,1,8,1,0,0
0,1,0,0,1,1,1,7.75,2.0,31.02,0.01,6,0.5,1.72,2,4,2,0,0
0,1,0,0,1,1,1,10.68,4.67,232.53,0.02,15,0.21,12.92,4,11,3,0,0
7,5,0,0,3,2,1,11.89,13.13,2048.55,0.05,35,0.08,113.81,15,20,8,7,0
5,3,0,0,2,2,1,17.22,4.08,287.09,0.02,19,0.24,15.95,7,12,6,5,0
4,3,0,0,2,2,1,11.18,5.63,353.85,0.02,17,0.18,19.66,5,12,4,4,0
0,1,0,0,1,1,1,0.0,0.0,0.0,0.0,0,0.0,0.0,0,0,0,0,0
0,1,0,0,1,1,1,6.2,2.5,38.77,0.01,6,0.4,2.15,1,5,1,0,0
0,1,0,0,1,1,1,0.0,0.0,0.0,0.0,3,0.0,0.0,0,3,0,0,0
0,1,0,0,1,1,1,0.0,0.0,0.0,0.0,2,0.0,0.0,0,2,0,0,0
0,1,0,0,1,1,1,5.33,1.5,12.0,0.0,4,0.67,0.67,1,3,1,0,0
0,1,0,0,1,1,1,5.33,1.5,12.0,0.0,4,0.67,0.67,1,3,1,0,0
0,1,0,0,1,1,1,11.86,3.5,145.3,0.01,12,0.29,8.07,4,8,4,0,0
0,1,0,0,1,1,1,0.0,0.0,0.0,0.0,0,0.0,0.0,0,0,0,0,0
0,1,0,0,1,1,1,0.0,0.0,0.0,0.0,0,0.0,0.0,0,0,0,0,0
0,1,0,0,1,1,1,0.0,0.0,0.0,0.0,0,0.0,0.0,0,0,0,0,0
0,1,0,0,1,1,1,0.0,0.0,0.0,0.0,1,0.0,0.0,0,1,0,0,0
0,1,0,0,1,1,1,7.33,4.5,148.5,0.01,11,0.22,8.25,3,8,2,0,0
8,3,0,0,2,1,1,15.07,9.75,1432.72,0.05,34,0.1,79.6,13,21,8,8,0
100,35,0,0,1,1,1,63.56,53.54,182196.49,1.13,559,0.02,10122.03,257,302,48,100,0
7,1,0,0,1,1,1,23.06,3.75,324.32,0.03,25,0.27,18.02,9,16,6,7,0
0,1,0,0,1,1,1,7.74,1.5,17.41,0.0,5,0.67,0.97,2,3,2,0,0
0,1,0,0,1,1,1,9.6,2.5,60.0,0.01,8,0.4,3.33,3,5,3,0,0
0,1,0,0,1,1,1,7.75,2.0,31.02,0.01,6,0.5,1.72,2,4,2,0,0
0,1,0,0,1,1,1,6.86,3.5,84.0,0.01,8,0.29,4.67,1,7,1,0,0
0,1,0,0,1,1,1,7.74,1.5,17.41,0.0,5,0.67,0.97,2,3,2,0,0
0,1,0,0,1,1,1,7.75,2.0,31.02,0.01,6,0.5,1.72,2,4,2,0,0
0,1,0,0,1,1,1,8.3,6.0,298.97,0.02,15,0.17,16.61,3,12,2,0,0
0,1,0,0,1,1,1,8.3,6.0,298.97,0.02,15,0.17,16.61,3,12,2,0,0
0,1,0,0,1,1,1,8.3,6.0,298.97,0.02,15,0.17,16.61,3,12,2,0,0
0,1,0,0,1,1,1,5.33,1.5,12.0,0.0,4,0.67,0.67,1,3,1,0,0
0,1,0,0,1,1,1,5.33,1.5,12.0,0.0,4,0.67,0.67,1,3,1,0,0
0,1,0,0,1,1,1,5.33,1.5,12.0,0.0,4,0.67,0.67,1,3,1,0,0
0,1,0,0,1,1,1,5.33,1.5,12.0,0.0,4,0.67,0.67,1,3,1,0,0
0,1,0,0,1,1,1,5.33,1.5,12.0,0.0,4,0.67,0.67,1,3,1,0,0
0,1,0,0,1,1,1,5.33,1.5,12.0,0.0,4,0.67,0.67,1,3,1,0,0
0,1,0,0,1,1,1,5.33,1.5,12.0,0.0,4,0.67,0.67,1,3,1,0,0
0,1,0,0,1,1,1,5.33,1.5,12.0,0.0,4,0.67,0.67,1,3,1,0,0
0,1,0,0,1,1,1,5.33,1.5,12.0,0.0,4,0.67,0.67,1,3,1,0,0
0,1,0,0,1,1,1,5.33,1.5,12.0,0.0,4,0.67,0.67,1,3,1,0,0
0,1,0,0,1,1,1,5.33,1.5,12.0,0.0,4,0.67,0.67,1,3,1,0,0
0,1,0,0,1,1,1,7.75,2.0,31.02,0.01,6,0.5,1.72,2,4,2,0,0
0,1,0,0,1,1,1,7.75,2.0,31.02,0.01,6,0.5,1.72,2,4,2,0,0
0,1,0,0,1,1,1,7.75,2.0,31.02,0.01,6,0.5,1.72,2,4,2,0,0
0,1,0,0,1,1,1,7.75,2.0,31.02,0.01,6,0.5,1.72,2,4,2,0,0
0,1,0,0,1,1,1,7.74,1.5,17.41,0.0,5,0.67,0.97,2,3,2,0,0
0,1,0,0,1,1,1,5.33,1.5,12.0,0.0,4,0.67,0.67,1,3,1,0,0
0,3,0,0,2,1,1,7.75,2.0,31.02,0.01,6,0.5,1.72,2,4,2,0,0
0,1,0,0,1,1,1,5.8,2.0,23.22,0.0,5,0.5,1.29,1,4,1,0,0
0,3,0,0,2,1,1,7.75,2.0,31.02,0.01,6,0.5,1.72,2,4,2,0,0
0,1,0,0,1,1,1,12.18,3.0,109.62,0.01,11,0.33,6.09,4,7,4,0,0
0,1,0,0,1,1,1,7.75,2.0,31.02,0.01,6,0.5,1.72,2,4,2,0,0
0,1,0,0,1,1,1,7.75,2.0,31.02,0.01,6,0.5,1.72,2,4,2,0,0
0,1,0,0,1,1,1,7.75,2.0,31.02,0.01,6,0.5,1.72,2,4,2,0,0
0,1,0,0,1,1,1,5.8,2.0,23.22,0.0,5,0.5,1.29,1,4,1,0,0
0,1,0,0,1,1,1,7.75,2.0,31.02,0.01,6,0.5,1.72,2,4,2,0,0
2,1,0,0,1,1,1,8.98,2.5,56.15,0.01,8,0.4,3.12,2,6,2,2,0
2,1,0,0,1,1,1,5.33,1.5,12.0,0.0,4,0.67,0.67,1,3,1,2,0
0,1,0,0,1,1,1,5.33,1.5,12.0,0.0,4,0.67,0.67,1,3,1,0,0
2,1,0,0,1,1,1,5.33,1.5,12.0,0.0,4,0.67,0.67,1,3,1,2,0
2,1,0,0,1,1,1,5.33,1.5,12.0,0.0,4,0.67,0.67,1,3,1,2,0
3,1,0,0,1,1,1,12.0,2.5,75.0,0.01,10,0.4,4.17,3,7,3,3,0
0,1,0,0,1,1,1,7.86,2.5,49.13,0.01,7,0.4,2.73,2,5,2,0,0
0,1,0,0,1,1,1,6.55,3.0,58.95,0.01,7,0.33,3.28,1,6,1,0,0
0,1,0,0,1,1,1,6.55,3.0,58.95,0.01,7,0.33,3.28,1,6,1,0,0
2,1,0,0,1,1,1,8.98,2.5,56.15,0.01,8,0.4,3.12,2,6,2,2,0
2,1,0,0,1,1,1,5.33,1.5,12.0,0.0,4,0.67,0.67,1,3,1,2,0
0,1,0,0,1,1,1,5.33,1.5,12.0,0.0,4,0.67,0.67,1,3,1,0,0
2,1,0,0,1,1,1,5.33,1.5,12.0,0.0,4,0.67,0.67,1,3,1,2,0
2,1,0,0,1,1,1,5.33,1.5,12.0,0.0,4,0.67,0.67,1,3,1,2,0
0,1,0,0,1,1,1,5.33,1.5,12.0,0.0,4,0.67,0.67,1,3,1,0,0
0,1,0,0,1,1,1,5.33,1.5,12.0,0.0,4,0.67,0.67,1,3,1,0,0
0,1,0,0,1,1,1,7.86,2.5,49.13,0.01,7,0.4,2.73,2,5,2,0,0
0,1,0,0,1,1,1,0.0,0.0,0.0,0.0,3,0.0,0.0,0,3,0,0,0
0,1,0,0,1,1,1,7.75,2.0,31.02,0.01,6,0.5,1.72,2,4,2,0,0
106,73,0,1,1,1,1,53.67,94.94,483769.06,1.7,843,0.01,26876.06,355,488,43,106,0
3,1,0,0,1,1,1,9.51,3.0,85.59,0.01,9,0.33,4.75,3,6,3,3,0
5,3,0,0,2,2,1,15.36,3.5,188.21,0.02,15,0.29,10.46,5,10,5,5,0
4,3,0,0,2,2,1,10.88,5.6,341.29,0.02,17,0.18,18.96,8,9,5,4,0
0,1,0,0,1,1,1,7.74,1.5,17.41,0.0,5,0.67,0.97,2,3,2,0,0
2,1,0,0,1,1,1,7.35,8.0,470.48,0.02,17,0.13,26.14,6,11,3,2,0
0,1,0,0,1,1,1,12.68,2.5,79.25,0.01,10,0.4,4.4,4,6,4,0,0
0,1,0,0,1,1,1,7.74,1.5,17.41,0.0,5,0.67,0.97,2,3,2,0,0
0,1,0,0,1,1,1,7.75,2.0,31.02,0.01,6,0.5,1.72,2,4,2,0,0
0,1,0,0,1,1,1,7.75,2.0,31.02,0.01,6,0.5,1.72,2,4,2,0,0
0,1,0,0,1,1,1,7.75,2.0,31.02,0.01,6,0.5,1.72,2,4,2,0,0
0,1,0,0,1,1,1,7.75,2.0,31.02,0.01,6,0.5,1.72,2,4,2,0,0
2,1,0,0,1,1,1,7.81,9.0,632.78,0.02,19,0.11,35.15,8,11,4,2,0
0,1,0,0,1,1,1,9.0,3.0,81.0,0.01,9,0.33,4.5,2,7,2,0,0
0,1,0,0,1,1,1,8.3,6.0,298.97,0.02,15,0.17,16.61,3,12,2,0,0
0,1,0,0,1,1,1,7.74,1.5,17.41,0.0,5,0.67,0.97,2,3,2,0,0
0,1,0,0,1,1,1,7.74,1.5,17.41,0.0,5,0.67,0.97,2,3,2,0,0
0,1,0,0,1,1,1,7.74,1.5,17.41,0.0,5,0.67,0.97,2,3,2,0,0
0,1,0,0,1,1,1,7.74,1.5,17.41,0.0,5,0.67,0.97,2,3,2,0,0
0,1,0,0,1,1,1,7.74,1.5,17.41,0.0,5,0.67,0.97,2,3,2,0,0
0,1,0,0,1,1,1,7.74,1.5,17.41,0.0,5,0.67,0.97,2,3,2,0,0
0,1,0,0,1,1,1,7.74,1.5,17.41,0.0,5,0.67,0.97,2,3,2,0,0
0,1,0,0,1,1,1,9.51,3.0,85.59,0.01,9,0.33,4.75,3,6,3,0,0
0,1,0,0,1,1,1,9.51,3.0,85.59,0.01,9,0.33,4.75,3,6,3,0,0
0,1,0,0,1,1,1,9.51,3.0,85.59,0.01,9,0.33,4.75,3,6,3,0,0
0,1,0,0,1,1,1,9.51,3.0,85.59,0.01,9,0.33,4.75,3,6,3,0,0
4,3,0,0,2,2,1,13.67,6.0,492.27,0.03,21,0.17,27.35,6,15,5,4,0
0,1,0,0,1,1,1,7.74,1.5,17.41,0.0,5,0.67,0.97,2,3,2,0,0
0,1,0,0,1,1,1,5.33,1.5,12.0,0.0,4,0.67,0.67,1,3,1,0,0
0,1,0,0,1,1,1,6.2,2.5,38.77,0.01,6,0.4,2.15,1,5,1,0,0
4,1,0,0,1,1,1,10.24,7.0,501.89,0.02,20,0.14,27.88,7,13,4,4,0
4,3,0,0,2,2,1,21.5,7.15,1099.18,0.05,35,0.14,61.07,13,22,10,4,0
8,3,0,0,2,2,1,23.46,10.29,2485.24,0.08,52,0.1,138.07,19,33,12,8,0
54,13,1,8,7,6,6,25.11,40.0,40181.42,0.33,184,0.03,2232.3,80,104,22,55,0
0,1,0,0,1,1,1,8.3,6.67,369.01,0.02,16,0.15,20.5,5,11,3,0,0
23,5,0,1,3,2,1,19.78,20.04,7940.87,0.13,80,0.05,441.16,33,47,14,23,0
0,1,0,0,1,1,1,8.6,7.5,483.97,0.02,18,0.13,26.89,5,13,3,0,0
19,5,0,3,3,3,1,19.07,10.91,2270.01,0.07,46,0.09,126.11,20,26,11,19,0
12,3,0,2,2,2,1,14.73,8.94,1176.94,0.04,31,0.11,65.39,13,18,8,12,0
12,9,0,0,5,3,3,17.46,16.55,4779.2,0.1,63,0.06,265.51,28,35,11,12,0
4,1,0,0,1,1,1,9.47,2.67,67.38,0.01,9,0.38,3.74,4,5,3,4,0
13,5,0,0,3,3,1,16.4,7.07,820.29,0.04,29,0.14,45.57,11,18,7,13,0
13,5,0,0,3,3,1,17.24,7.5,969.51,0.04,31,0.13,53.86,12,19,8,13,0
4,3,0,0,2,2,1,11.99,6.67,533.03,0.03,21,0.15,29.61,10,11,6,4,0
0,1,0,0,1,1,1,6.55,3.0,58.95,0.01,7,0.33,3.28,1,6,1,0,0
0,3,0,0,2,2,1,6.69,7.5,376.42,0.02,14,0.13,20.91,5,9,3,0,0
0,1,0,0,1,1,1,7.86,2.5,49.13,0.01,7,0.4,2.73,2,5,2,0,0
0,3,0,0,2,2,1,9.32,5.0,233.02,0.02,13,0.2,12.95,5,8,4,0,0
6,1,0,0,1,1,1,17.51,5.0,437.85,0.03,23,0.2,24.32,10,13,7,6,0
0,1,0,0,1,1,1,3.0,1.0,3.0,0.0,3,1.0,0.17,2,1,1,0,0
0,1,0,0,1,1,1,3.0,1.0,3.0,0.0,3,1.0,0.17,2,1,1,0,0
0,1,0,0,1,1,1,0.0,0.0,0.0,0.0,2,0.0,0.0,2,0,2,0,0
0,1,0,0,1,1,1,5.33,1.5,12.0,0.0,4,0.67,0.67,1,3,1,0,0
0,3,0,0,2,2,1,7.75,2.0,31.02,0.01,6,0.5,1.72,2,4,2,0,0
0,3,0,0,2,2,1,7.86,2.5,49.13,0.01,7,0.4,2.73,2,5,2,0,0
0,1,0,0,1,1,1,7.86,2.5,49.13,0.01,7,0.4,2.73,2,5,2,0,0
11,7,0,0,4,2,3,12.35,16.0,3162.47,0.07,45,0.06,175.69,16,29,7,11,0
3,1,0,0,1,1,1,16.5,2.0,66.0,0.01,11,0.5,3.67,4,7,4,3,0
0,1,0,0,1,1,1,10.8,2.5,67.5,0.01,9,0.4,3.75,3,6,3,0,0
0,3,0,0,2,2,1,7.92,4.0,126.8,0.01,10,0.25,7.04,4,6,3,0,0
3,3,0,0,2,2,1,14.28,4.0,228.44,0.02,15,0.25,12.69,6,9,6,3,0
0,1,0,0,1,1,1,0.0,0.0,0.0,0.0,1,0.0,0.0,0,1,0,0,0
2,1,0,0,1,1,1,13.5,2.0,54.0,0.01,9,0.5,3.0,4,5,4,2,0
3,1,0,0,1,1,1,20.6,2.0,82.42,0.01,13,0.5,4.58,5,8,5,3,0
0,1,0,0,1,1,1,13.95,2.5,87.17,0.01,11,0.4,4.84,4,7,4,0,0
0,1,0,0,1,1,1,7.75,2.0,31.02,0.01,6,0.5,1.72,2,4,2,0,0
0,1,0,0,1,1,1,7.75,2.0,31.02,0.01,6,0.5,1.72,2,4,2,0,0
0,1,0,0,1,1,1,7.75,2.0,31.02,0.01,6,0.5,1.72,2,4,2,0,0
0,1,0,0,1,1,1,7.74,1.5,17.41,0.0,5,0.67,0.97,2,3,2,0,0
1,1,0,0,1,1,1,7.74,1.5,17.41,0.0,5,0.67,0.97,2,3,2,1,0
0,1,0,0,1,1,1,5.8,2.0,23.22,0.0,5,0.5,1.29,1,4,1,0,0
2,1,0,0,1,1,1,7.75,2.0,31.02,0.01,6,0.5,1.72,2,4,2,2,0
1,1,0,1,1,1,1,0.0,0.0,0.0,0.0,1,0.0,0.0,0,1,0,1,0
2,1,0,0,1,1,1,7.75,2.0,31.02,0.01,6,0.5,1.72,2,4,2,2,0
0,1,0,0,1,1,1,7.75,2.0,31.02,0.01,6,0.5,1.72,2,4,2,0,0
0,1,0,0,1,1,1,9.83,2.0,39.3,0.01,7,0.5,2.18,3,4,3,0,0
1,1,0,0,1,1,1,0.0,0.0,0.0,0.0,3,0.0,0.0,3,0,1,1,0
0,1,0,0,1,1,1,0.0,0.0,0.0,0.0,0,0.0,0.0,0,0,0,0,0
0,1,0,0,1,1,1,0.0,0.0,0.0,0.0,1,0.0,0.0,1,0,1,0,0
4,1,0,0,1,1,1,18.82,3.0,169.42,0.02,17,0.33,9.41,9,8,6,4,0
0,1,0,0,1,1,1,8.1,3.33,90.0,0.01,9,0.3,5.0,4,5,3,0,0
0,1,0,0,1,1,1,9.31,2.5,58.16,0.01,9,0.4,3.23,1,8,1,0,0
2,1,0,0,1,1,1,7.74,1.5,17.41,0.0,5,0.67,0.97,2,3,2,2,0
0,1,0,0,1,1,1,7.75,2.0,31.02,0.01,6,0.5,1.72,2,4,2,0,0
0,1,0,0,1,1,1,10.68,4.67,232.53,0.02,15,0.21,12.92,4,11,3,0,0
3,1,0,0,1,1,1,16.5,2.0,66.0,0.01,11,0.5,3.67,4,7,4,3,0
7,5,0,0,3,2,1,11.89,13.13,2048.55,0.05,35,0.08,113.81,15,20,8,7,0
0,1,0,0,1,1,1,9.83,2.0,39.3,0.01,7,0.5,2.18,3,4,3,0,0
5,3,0,0,2,2,1,17.22,4.08,287.09,0.02,19,0.24,15.95,7,12,6,5,0
4,3,0,0,2,2,1,11.18,5.63,353.85,0.02,17,0.18,19.66,5,12,4,4,0
0,1,0,0,1,1,1,8.15,3.5,99.85,0.01,9,0.29,5.55,2,7,2,0,0
0,1,0,0,1,1,1,8.15,3.5,99.85,0.01,9,0.29,5.55,2,7,2,0,0
0,1,0,0,1,1,1,0.0,0.0,0.0,0.0,0,0.0,0.0,0,0,0,0,0
0,1,0,0,1,1,1,6.2,2.5,38.77,0.01,6,0.4,2.15,1,5,1,0,0
0,1,0,0,1,1,1,11.86,3.5,145.3,0.01,12,0.29,8.07,4,8,4,0,0
0,1,0,0,1,1,1,0.0,0.0,0.0,0.0,0,0.0,0.0,0,0,0,0,0
0,1,0,0,1,1,1,0.0,0.0,0.0,0.0,0,0.0,0.0,0,0,0,0,0
0,1,0,0,1,1,1,0.0,0.0,0.0,0.0,0,0.0,0.0,0,0,0,0,0
0,1,0,0,1,1,1,7.33,4.5,148.5,0.01,11,0.22,8.25,3,8,2,0,0
8,3,0,0,2,1,1,15.07,9.75,1432.72,0.05,34,0.1,79.6,13,21,8,8,0
0,1,0,0,1,1,1,9.6,2.5,60.0,0.01,8,0.4,3.33,3,5,3,0,0
0,1,0,0,1,1,1,7.75,2.0,31.02,0.01,6,0.5,1.72,2,4,2,0,0
0,1,0,0,1,1,1,6.86,3.5,84.0,0.01,8,0.29,4.67,1,7,1,0,0
0,1,0,0,1,1,1,7.75,2.0,31.02,0.01,6,0.5,1.72,2,4,2,0,0
6,3,0,0,2,2,1,12.59,9.0,1019.7,0.04,29,0.11,56.65,12,17,6,6,0
5,1,0,0,1,1,1,15.95,6.86,750.12,0.04,28,0.15,41.67,12,16,7,5,0
0,1,0,0,1,1,1,8.3,6.0,298.97,0.02,15,0.17,16.61,3,12,2,0,0
0,1,0,0,1,1,1,8.3,6.0,298.97,0.02,15,0.17,16.61,3,12,2,0,0
0,1,0,0,1,1,1,8.3,6.0,298.97,0.02,15,0.17,16.61,3,12,2,0,0
0,1,0,0,1,1,1,6.2,2.5,38.77,0.01,6,0.4,2.15,1,5,1,0,0
0,1,0,0,1,1,1,6.2,2.5,38.77,0.01,6,0.4,2.15,1,5,1,0,0
0,1,0,0,1,1,1,0.0,0.0,0.0,0.0,0,0.0,0.0,0,0,0,0,0
0,1,0,0,1,1,1,5.8,2.0,23.22,0.0,5,0.5,1.29,1,4,1,0,0
0,1,0,0,1,1,1,0.0,0.0,0.0,0.0,0,0.0,0.0,0,0,0,0,0
0,1,0,0,1,1,1,7.75,2.0,31.02,0.01,6,0.5,1.72,2,4,2,0,0
0,1,0,0,1,1,1,7.75,2.0,31.02,0.01,6,0.5,1.72,2,4,2,0,0
9,5,0,0,3,3,3,17.18,8.56,1257.2,0.05,34,0.12,69.84,14,20,9,9,0
3,1,0,0,1,1,1,20.6,2.0,82.42,0.01,13,0.5,4.58,5,8,5,3,0
9,5,0,0,3,3,3,17.65,9.6,1626.8,0.06,38,0.1,90.38,16,22,10,9,0
0,1,0,0,1,1,1,13.5,2.0,54.0,0.01,9,0.5,3.0,4,5,4,0,0
0,1,0,0,1,1,1,7.75,2.0,31.02,0.01,6,0.5,1.72,2,4,2,0,0
0,1,0,0,1,1,1,7.75,2.0,31.02,0.01,6,0.5,1.72,2,4,2,0,0
0,3,0,0,2,1,1,7.75,2.0,31.02,0.01,6,0.5,1.72,2,4,2,0,0
0,1,0,0,1,1,1,5.8,2.0,23.22,0.0,5,0.5,1.29,1,4,1,0,0
0,3,0,0,2,1,1,7.75,2.0,31.02,0.01,6,0.5,1.72,2,4,2,0,0
0,1,0,0,1,1,1,12.18,3.0,109.62,0.01,11,0.33,6.09,4,7,4,0,0
0,1,0,0,1,1,1,7.75,2.0,31.02,0.01,6,0.5,1.72,2,4,2,0,0
0,1,0,0,1,1,1,7.75,2.0,31.02,0.01,6,0.5,1.72,2,4,2,0,0
0,1,0,0,1,1,1,7.75,2.0,31.02,0.01,6,0.5,1.72,2,4,2,0,0
0,1,0,0,1,1,1,5.8,2.0,23.22,0.0,5,0.5,1.29,1,4,1,0,0
0,1,0,0,1,1,1,7.75,2.0,31.02,0.01,6,0.5,1.72,2,4,2,0,0
2,1,0,0,1,1,1,8.98,2.5,56.15,0.01,8,0.4,3.12,2,6,2,2,0
2,1,0,0,1,1,1,5.33,1.5,12.0,0.0,4,0.67,0.67,1,3,1,2,0
0,1,0,0,1,1,1,5.33,1.5,12.0,0.0,4,0.67,0.67,1,3,1,0,0
2,1,0,0,1,1,1,5.33,1.5,12.0,0.0,4,0.67,0.67,1,3,1,2,0
2,1,0,0,1,1,1,5.33,1.5,12.0,0.0,4,0.67,0.67,1,3,1,2,0
2,1,0,0,1,1,1,8.82,6.67,392.07,0.02,17,0.15,21.78,5,12,3,2,0
3,1,0,0,1,1,1,12.0,2.5,75.0,0.01,10,0.4,4.17,3,7,3,3,0
0,1,0,0,1,1,1,7.86,2.5,49.13,0.01,7,0.4,2.73,2,5,2,0,0
0,1,0,0,1,1,1,7.75,2.0,31.02,0.01,6,0.5,1.72,2,4,2,0,0
0,1,0,0,1,1,1,7.75,2.0,31.02,0.01,6,0.5,1.72,2,4,2,0,0
0,1,0,0,1,1,1,6.55,3.0,58.95,0.01,7,0.33,3.28,1,6,1,0,0
0,1,0,0,1,1,1,6.55,3.0,58.95,0.01,7,0.33,3.28,1,6,1,0,0
2,1,0,0,1,1,1,8.98,2.5,56.15,0.01,8,0.4,3.12,2,6,2,2,0
2,1,0,0,1,1,1,5.33,1.5,12.0,0.0,4,0.67,0.67,1,3,1,2,0
0,1,0,0,1,1,1,5.33,1.5,12.0,0.0,4,0.67,0.67,1,3,1,0,0
2,1,0,0,1,1,1,5.33,1.5,12.0,0.0,4,0.67,0.67,1,3,1,2,0
2,1,0,0,1,1,1,5.33,1.5,12.0,0.0,4,0.67,0.67,1,3,1,2,0
0,1,0,0,1,1,1,5.33,1.5,12.0,0.0,4,0.67,0.67,1,3,1,0,0
0,1,0,0,1,1,1,5.33,1.5,12.0,0.0,4,0.67,0.67,1,3,1,0,0
0,1,0,0,1,1,1,7.75,2.0,31.02,0.01,6,0.5,1.72,2,4,2,0,0
3,1,0,0,1,1,1,6.89,3.0,62.04,0.01,8,0.33,3.45,3,5,2,3,0
7,3,0,0,2,2,1,15.51,5.25,427.4,0.03,22,0.19,23.74,9,13,6,7,0
10,3,0,0,2,2,1,22.09,9.0,1789.28,0.07,46,0.11,99.4,22,24,11,10,0
0,1,0,0,1,1,1,9.0,3.0,81.0,0.01,9,0.33,4.5,2,7,2,0,0
0,1,0,0,1,1,1,11.23,2.0,44.92,0.01,8,0.5,2.5,3,5,3,0,0
5,3,0,0,2,2,1,17.4,6.29,687.61,0.04,28,0.16,38.2,11,17,7,5,0
0,1,0,0,1,1,1,8.3,6.0,298.97,0.02,15,0.17,16.61,3,12,2,0,0
3,1,0,0,1,1,1,17.92,3.0,161.32,0.02,15,0.33,8.96,6,9,6,3,0
3,1,0,0,1,1,1,9.51,3.0,85.59,0.01,9,0.33,4.75,3,6,3,3,0
5,3,0,0,2,2,1,15.36,3.5,188.21,0.02,15,0.29,10.46,5,10,5,5,0
4,3,0,0,2,2,1,10.88,5.6,341.29,0.02,17,0.18,18.96,8,9,5,4,0
0,1,0,0,1,1,1,7.74,1.5,17.41,0.0,5,0.67,0.97,2,3,2,0,0
0,1,0,0,1,1,1,12.68,2.5,79.25,0.01,10,0.4,4.4,4,6,4,0,0
0,1,0,0,1,1,1,7.74,1.5,17.41,0.0,5,0.67,0.97,2,3,2,0,0
0,1,0,0,1,1,1,7.75,2.0,31.02,0.01,6,0.5,1.72,2,4,2,0,0
0,1,0,0,1,1,1,7.75,2.0,31.02,0.01,6,0.5,1.72,2,4,2,0,0
0,1,0,0,1,1,1,7.75,2.0,31.02,0.01,6,0.5,1.72,2,4,2,0,0
0,1,0,0,1,1,1,7.75,2.0,31.02,0.01,6,0.5,1.72,2,4,2,0,0
7,3,0,0,2,2,1,15.65,7.31,836.91,0.04,28,0.14,46.49,13,15,8,7,0
0,1,0,0,1,1,1,9.51,3.0,85.59,0.01,9,0.33,4.75,3,6,3,0,0
0,1,0,0,1,1,1,9.51,3.0,85.59,0.01,9,0.33,4.75,3,6,3,0,0
0,1,0,0,1,1,1,9.51,3.0,85.59,0.01,9,0.33,4.75,3,6,3,0,0
0,1,0,0,1,1,1,9.51,3.0,85.59,0.01,9,0.33,4.75,3,6,3,0,0
4,3,0,0,2,2,1,13.67,6.0,492.27,0.03,21,0.17,27.35,6,15,5,4,0
4,1,0,0,1,1,1,10.34,2.5,64.62,0.01,10,0.4,3.59,5,5,3,4,0
4,1,0,0,1,1,1,16.23,4.5,328.87,0.02,22,0.22,18.27,9,13,5,4,0
2,1,0,0,1,1,1,9.83,2.0,39.3,0.01,7,0.5,2.18,3,4,3,2,0
57,27,0,16,18,15,1,48.02,43.19,89587.64,0.69,333,0.02,4977.09,145,188,47,57,0
47,10,5,2,7,4,1,52.23,27.86,40527.15,0.48,239,0.04,2251.51,109,130,45,52,0
86,27,2,18,20,17,1,66.26,43.5,125383.65,0.96,444,0.02,6965.76,183,261,61,88,0
3,1,0,1,1,1,1,16.84,1.5,37.9,0.01,9,0.67,2.11,4,5,4,3,0
36,7,14,4,4,1,1,46.59,32.14,48138.72,0.5,276,0.03,2674.37,120,156,28,50,0
36,7,14,4,4,1,1,46.59,32.14,48138.72,0.5,276,0.03,2674.37,120,156,28,50,0
10,3,0,0,2,1,1,17.13,4.67,373.12,0.03,21,0.21,20.73,7,14,6,10,0
16,9,0,0,5,3,3,36.26,10.42,3937.39,0.13,77,0.1,218.74,36,41,19,16,0
17,9,4,15,5,1,1,47.97,8.57,3524.56,0.14,83,0.12,195.81,36,47,21,21,0
13,5,0,0,3,2,1,14.97,9.29,1290.47,0.05,34,0.11,71.69,13,21,7,13,0
12,5,0,0,3,1,3,21.83,7.2,1131.65,0.05,37,0.14,62.87,16,21,10,12,0
25,11,4,15,6,2,1,42.51,11.73,5846.88,0.17,98,0.09,324.83,43,55,22,29,0
10,3,0,0,2,1,1,20.19,5.06,517.32,0.03,25,0.2,28.74,9,16,8,10,0
11,3,1,3,2,1,1,19.29,6.72,871.59,0.04,30,0.15,48.42,11,19,9,12,0
28,9,4,6,5,3,1,25.37,14.93,5658.58,0.13,78,0.07,314.37,32,46,15,32,0
20,7,3,6,4,3,1,22.94,12.5,3584.09,0.1,61,0.08,199.12,25,36,13,23,0
10,3,0,0,2,1,1,17.28,5.79,578.57,0.03,25,0.17,32.14,9,16,7,10,0
91,39,0,20,20,16,8,57.61,32.93,62473.17,0.63,315,0.03,3470.73,138,177,44,91,0
54,17,1,11,9,8,6,44.93,20.91,19641.56,0.31,164,0.05,1091.2,69,95,33,55,0
111,45,0,20,23,17,9,65.25,36.24,85678.82,0.79,382,0.03,4759.93,168,214,51,111,0
10,3,0,0,2,1,1,20.19,5.06,517.32,0.03,25,0.2,28.74,9,16,8,10,0
11,3,1,3,2,1,1,19.29,6.72,871.59,0.04,30,0.15,48.42,11,19,9,12,0
33,13,4,6,7,6,1,44.15,16.14,11519.93,0.24,134,0.06,640.0,60,74,26,37,0
20,7,3,6,4,3,1,24.65,12.54,3874.38,0.1,65,0.08,215.24,27,38,14,23,0
11,3,1,2,2,2,1,51.44,5.06,1314.73,0.09,56,0.2,73.04,26,30,18,12,0
10,3,0,0,2,1,1,17.28,5.79,578.57,0.03,25,0.17,32.14,9,16,7,10,0
0,3,0,0,2,2,1,8.1,3.33,90.0,0.01,9,0.3,5.0,4,5,3,0,0
0,3,0,0,2,1,1,12.18,3.0,109.62,0.01,11,0.33,6.09,4,7,4,0,0
0,1,0,0,1,1,1,8.0,1.0,8.0,0.0,4,1.0,0.44,2,2,2,0,0
7,3,6,3,1,1,1,24.67,10.08,2508.69,0.08,55,0.1,139.37,22,33,12,13,0
7,3,6,3,1,1,1,24.67,10.08,2508.69,0.08,55,0.1,139.37,22,33,12,13,0
7,3,1,0,2,1,1,5.6,7.5,315.0,0.01,14,0.13,17.5,5,9,2,8,0
7,3,1,0,2,1,1,5.6,7.5,315.0,0.01,14,0.13,17.5,5,9,2,8,0
15,11,10,0,6,1,1,36.12,7.54,2052.58,0.09,63,0.13,114.03,28,35,13,25,0
4,1,0,0,1,1,1,10.24,7.0,501.89,0.02,20,0.14,27.88,7,13,4,4,0
4,3,0,0,2,2,1,21.5,7.15,1099.18,0.05,35,0.14,61.07,13,22,10,4,0
8,3,0,0,2,2,1,23.46,10.29,2485.24,0.08,52,0.1,138.07,19,33,12,8,0
54,13,1,8,7,6,6,25.11,40.0,40181.42,0.33,184,0.03,2232.3,80,104,22,55,0
0,1,0,0,1,1,1,8.3,6.67,369.01,0.02,16,0.15,20.5,5,11,3,0,0
23,5,0,1,3,2,1,19.78,20.04,7940.87,0.13,80,0.05,441.16,33,47,14,23,0
0,1,0,0,1,1,1,8.6,7.5,483.97,0.02,18,0.13,26.89,5,13,3,0,0
19,5,0,3,3,3,1,19.07,10.91,2270.01,0.07,46,0.09,126.11,20,26,11,19,0
12,3,0,2,2,2,1,14.73,8.94,1176.94,0.04,31,0.11,65.39,13,18,8,12,0
12,9,0,0,5,3,3,17.46,16.55,4779.2,0.1,63,0.06,265.51,28,35,11,12,0
4,1,0,0,1,1,1,9.47,2.67,67.38,0.01,9,0.38,3.74,4,5,3,4,0
13,5,0,0,3,3,1,16.4,7.07,820.29,0.04,29,0.14,45.57,11,18,7,13,0
13,5,0,0,3,3,1,17.24,7.5,969.51,0.04,31,0.13,53.86,12,19,8,13,0
4,3,0,0,2,2,1,11.99,6.67,533.03,0.03,21,0.15,29.61,10,11,6,4,0
0,1,0,0,1,1,1,6.55,3.0,58.95,0.01,7,0.33,3.28,1,6,1,0,0
0,3,0,0,2,2,1,6.69,7.5,376.42,0.02,14,0.13,20.91,5,9,3,0,0
0,1,0,0,1,1,1,7.86,2.5,49.13,0.01,7,0.4,2.73,2,5,2,0,0
0,3,0,0,2,2,1,9.32,5.0,233.02,0.02,13,0.2,12.95,5,8,4,0,0
6,1,0,0,1,1,1,17.51,5.0,437.85,0.03,23,0.2,24.32,10,13,7,6,0
0,3,0,0,2,2,1,7.75,2.0,31.02,0.01,6,0.5,1.72,2,4,2,0,0
0,3,0,0,2,2,1,7.86,2.5,49.13,0.01,7,0.4,2.73,2,5,2,0,0
11,7,0,0,4,2,3,12.35,16.0,3162.47,0.07,45,0.06,175.69,16,29,7,11,0
3,3,0,0,2,2,1,14.28,4.0,228.44,0.02,15,0.25,12.69,6,9,6,3,0
0,1,0,0,1,1,1,0.0,0.0,0.0,0.0,1,0.0,0.0,0,1,0,0,0
2,1,0,0,1,1,1,13.5,2.0,54.0,0.01,9,0.5,3.0,4,5,4,2,0
0,1,0,0,1,1,1,7.75,2.0,31.02,0.01,6,0.5,1.72,2,4,2,0,0
0,1,0,0,1,1,1,7.75,2.0,31.02,0.01,6,0.5,1.72,2,4,2,0,0
0,1,0,0,1,1,1,7.75,2.0,31.02,0.01,6,0.5,1.72,2,4,2,0,0
0,1,0,0,1,1,1,7.74,1.5,17.41,0.0,5,0.67,0.97,2,3,2,0,0
1,1,0,0,1,1,1,7.74,1.5,17.41,0.0,5,0.67,0.97,2,3,2,1,0
0,1,0,0,1,1,1,5.8,2.0,23.22,0.0,5,0.5,1.29,1,4,1,0,0
2,1,0,0,1,1,1,7.75,2.0,31.02,0.01,6,0.5,1.72,2,4,2,2,0
1,1,0,1,1,1,1,0.0,0.0,0.0,0.0,1,0.0,0.0,0,1,0,1,0
2,1,0,0,1,1,1,7.75,2.0,31.02,0.01,6,0.5,1.72,2,4,2,2,0
0,1,0,0,1,1,1,9.31,2.5,58.16,0.01,9,0.4,3.23,1,8,1,0,0
0,1,0,0,1,1,1,7.75,2.0,31.02,0.01,6,0.5,1.72,2,4,2,0,0
0,1,0,0,1,1,1,10.68,4.67,232.53,0.02,15,0.21,12.92,4,11,3,0,0
7,5,0,0,3,2,1,11.89,13.13,2048.55,0.05,35,0.08,113.81,15,20,8,7,0
5,3,0,0,2,2,1,17.22,4.08,287.09,0.02,19,0.24,15.95,7,12,6,5,0
4,3,0,0,2,2,1,11.18,5.63,353.85,0.02,17,0.18,19.66,5,12,4,4,0
0,1,0,0,1,1,1,0.0,0.0,0.0,0.0,0,0.0,0.0,0,0,0,0,0
0,1,0,0,1,1,1,6.2,2.5,38.77,0.01,6,0.4,2.15,1,5,1,0,0
0,1,0,0,1,1,1,11.86,3.5,145.3,0.01,12,0.29,8.07,4,8,4,0,0
0,1,0,0,1,1,1,0.0,0.0,0.0,0.0,0,0.0,0.0,0,0,0,0,0
0,1,0,0,1,1,1,0.0,0.0,0.0,0.0,0,0.0,0.0,0,0,0,0,0
0,1,0,0,1,1,1,0.0,0.0,0.0,0.0,0,0.0,0.0,0,0,0,0,0
0,1,0,0,1,1,1,7.33,4.5,148.5,0.01,11,0.22,8.25,3,8,2,0,0
8,3,0,0,2,1,1,15.07,9.75,1432.72,0.05,34,0.1,79.6,13,21,8,8,0
0,1,0,0,1,1,1,9.6,2.5,60.0,0.01,8,0.4,3.33,3,5,3,0,0
0,1,0,0,1,1,1,7.75,2.0,31.02,0.01,6,0.5,1.72,2,4,2,0,0
0,1,0,0,1,1,1,6.86,3.5,84.0,0.01,8,0.29,4.67,1,7,1,0,0
0,1,0,0,1,1,1,7.75,2.0,31.02,0.01,6,0.5,1.72,2,4,2,0,0
0,1,0,0,1,1,1,8.3,6.0,298.97,0.02,15,0.17,16.61,3,12,2,0,0
0,1,0,0,1,1,1,8.3,6.0,298.97,0.02,15,0.17,16.61,3,12,2,0,0
0,1,0,0,1,1,1,8.3,6.0,298.97,0.02,15,0.17,16.61,3,12,2,0,0
6,3,0,1,2,1,1,10.67,11.14,1325.35,0.04,28,0.09,73.63,13,15,7,6,0
39,15,12,13,8,5,1,29.24,37.5,41111.89,0.37,206,0.03,2283.99,75,131,20,51,0
13,5,0,0,3,1,1,15.75,12.09,2302.09,0.06,41,0.08,127.89,19,22,11,13,0
19,7,3,2,4,2,1,19.23,20.0,7691.77,0.13,80,0.05,427.32,30,50,12,22,0
0,1,0,0,1,1,1,7.75,2.0,31.02,0.01,6,0.5,1.72,2,4,2,0,0
0,1,0,0,1,1,1,7.75,2.0,31.02,0.01,6,0.5,1.72,2,4,2,0,0
0,1,0,0,1,1,1,7.75,2.0,31.02,0.01,6,0.5,1.72,2,4,2,0,0
0,1,0,0,1,1,1,7.75,2.0,31.02,0.01,6,0.5,1.72,2,4,2,0,0
0,3,0,0,2,1,1,7.75,2.0,31.02,0.01,6,0.5,1.72,2,4,2,0,0
0,1,0,0,1,1,1,5.8,2.0,23.22,0.0,5,0.5,1.29,1,4,1,0,0
0,3,0,0,2,1,1,7.75,2.0,31.02,0.01,6,0.5,1.72,2,4,2,0,0
0,1,0,0,1,1,1,12.18,3.0,109.62,0.01,11,0.33,6.09,4,7,4,0,0
0,1,0,0,1,1,1,7.75,2.0,31.02,0.01,6,0.5,1.72,2,4,2,0,0
0,1,0,0,1,1,1,7.75,2.0,31.02,0.01,6,0.5,1.72,2,4,2,0,0
0,1,0,0,1,1,1,7.75,2.0,31.02,0.01,6,0.5,1.72,2,4,2,0,0
0,1,0,0,1,1,1,5.8,2.0,23.22,0.0,5,0.5,1.29,1,4,1,0,0
0,1,0,0,1,1,1,7.75,2.0,31.02,0.01,6,0.5,1.72,2,4,2,0,0
38,13,0,12,7,4,1,36.05,24.98,22501.21,0.3,158,0.04,1250.07,63,95,29,38,0
27,9,0,0,5,3,1,33.37,16.7,9311.31,0.19,107,0.06,517.28,49,58,22,27,0
2,1,0,0,1,1,1,8.98,2.5,56.15,0.01,8,0.4,3.12,2,6,2,2,0
2,1,0,0,1,1,1,5.33,1.5,12.0,0.0,4,0.67,0.67,1,3,1,2,0
0,1,0,0,1,1,1,5.33,1.5,12.0,0.0,4,0.67,0.67,1,3,1,0,0
2,1,0,0,1,1,1,5.33,1.5,12.0,0.0,4,0.67,0.67,1,3,1,2,0
2,1,0,0,1,1,1,5.33,1.5,12.0,0.0,4,0.67,0.67,1,3,1,2,0
3,1,0,0,1,1,1,12.0,2.5,75.0,0.01,10,0.4,4.17,3,7,3,3,0
0,1,0,0,1,1,1,7.86,2.5,49.13,0.01,7,0.4,2.73,2,5,2,0,0
0,1,0,0,1,1,1,6.55,3.0,58.95,0.01,7,0.33,3.28,1,6,1,0,0
0,1,0,0,1,1,1,6.55,3.0,58.95,0.01,7,0.33,3.28,1,6,1,0,0
2,1,0,0,1,1,1,8.98,2.5,56.15,0.01,8,0.4,3.12,2,6,2,2,0
2,1,0,0,1,1,1,5.33,1.5,12.0,0.0,4,0.67,0.67,1,3,1,2,0
0,1,0,0,1,1,1,5.33,1.5,12.0,0.0,4,0.67,0.67,1,3,1,0,0
2,1,0,0,1,1,1,5.33,1.5,12.0,0.0,4,0.67,0.67,1,3,1,2,0
2,1,0,0,1,1,1,5.33,1.5,12.0,0.0,4,0.67,0.67,1,3,1,2,0
0,1,0,0,1,1,1,5.33,1.5,12.0,0.0,4,0.67,0.67,1,3,1,0,0
0,1,0,0,1,1,1,5.33,1.5,12.0,0.0,4,0.67,0.67,1,3,1,0,0
0,1,0,0,1,1,1,7.75,2.0,31.02,0.01,6,0.5,1.72,2,4,2,0,0
2,1,0,0,1,1,1,12.75,4.0,204.0,0.02,17,0.25,11.33,8,9,4,2,0
0,1,0,0,1,1,1,9.0,3.0,81.0,0.01,9,0.33,4.5,2,7,2,0,0
0,1,0,0,1,1,1,8.3,6.0,298.97,0.02,15,0.17,16.61,3,12,2,0,0
5,1,0,0,1,1,1,30.58,3.82,445.8,0.04,28,0.26,24.77,12,16,11,5,0
7,1,0,0,1,1,1,14.96,8.64,1117.24,0.04,31,0.12,62.07,11,20,7,7,0
13,1,0,0,1,1,1,33.12,9.0,2682.5,0.1,62,0.11,149.03,24,38,16,13,0
7,5,2,0,3,1,1,29.74,7.0,1457.04,0.07,49,0.14,80.95,24,25,12,9,0
15,1,5,4,1,1,1,51.17,10.15,5275.38,0.17,99,0.1,293.08,44,55,26,20,0
6,1,0,0,1,1,1,26.06,6.14,981.27,0.05,37,0.16,54.52,15,22,11,6,0
27,3,0,0,2,2,1,69.11,13.17,11980.44,0.3,176,0.08,665.58,79,97,27,27,0
3,1,0,0,1,1,1,9.51,3.0,85.59,0.01,9,0.33,4.75,3,6,3,3,0
5,3,0,0,2,2,1,15.36,3.5,188.21,0.02,15,0.29,10.46,5,10,5,5,0
4,3,0,0,2,2,1,10.88,5.6,341.29,0.02,17,0.18,18.96,8,9,5,4,0
0,1,0,0,1,1,1,7.74,1.5,17.41,0.0,5,0.67,0.97,2,3,2,0,0
0,1,0,0,1,1,1,12.68,2.5,79.25,0.01,10,0.4,4.4,4,6,4,0,0
0,1,0,0,1,1,1,7.74,1.5,17.41,0.0,5,0.67,0.97,2,3,2,0,0
0,1,0,0,1,1,1,7.75,2.0,31.02,0.01,6,0.5,1.72,2,4,2,0,0
0,1,0,0,1,1,1,7.75,2.0,31.02,0.01,6,0.5,1.72,2,4,2,0,0
0,1,0,0,1,1,1,7.75,2.0,31.02,0.01,6,0.5,1.72,2,4,2,0,0
0,1,0,0,1,1,1,7.75,2.0,31.02,0.01,6,0.5,1.72,2,4,2,0,0
0,1,0,0,1,1,1,9.51,3.0,85.59,0.01,9,0.33,4.75,3,6,3,0,0
0,1,0,0,1,1,1,9.51,3.0,85.59,0.01,9,0.33,4.75,3,6,3,0,0
0,1,0,0,1,1,1,9.51,3.0,85.59,0.01,9,0.33,4.75,3,6,3,0,0
0,1,0,0,1,1,1,9.51,3.0,85.59,0.01,9,0.33,4.75,3,6,3,0,0
4,3,0,0,2,2,1,13.67,6.0,492.27,0.03,21,0.17,27.35,6,15,5,4,0
4,1,0,0,1,1,1,10.24,7.0,501.89,0.02,20,0.14,27.88,7,13,4,4,0
4,3,0,0,2,2,1,21.5,7.15,1099.18,0.05,35,0.14,61.07,13,22,10,4,0
8,3,0,0,2,2,1,23.46,10.29,2485.24,0.08,52,0.1,138.07,19,33,12,8,0
54,13,1,8,7,6,6,25.11,40.0,40181.42,0.33,184,0.03,2232.3,80,104,22,55,0
0,1,0,0,1,1,1,8.3,6.67,369.01,0.02,16,0.15,20.5,5,11,3,0,0
23,5,0,1,3,2,1,19.78,20.04,7940.87,0.13,80,0.05,441.16,33,47,14,23,0
0,1,0,0,1,1,1,8.6,7.5,483.97,0.02,18,0.13,26.89,5,13,3,0,0
19,5,0,3,3,3,1,19.07,10.91,2270.01,0.07,46,0.09,126.11,20,26,11,19,0
12,3,0,2,2,2,1,14.73,8.94,1176.94,0.04,31,0.11,65.39,13,18,8,12,0
12,9,0,0,5,3,3,17.46,16.55,4779.2,0.1,63,0.06,265.51,28,35,11,12,0
4,1,0,0,1,1,1,9.47,2.67,67.38,0.01,9,0.38,3.74,4,5,3,4,0
13,5,0,0,3,3,1,16.4,7.07,820.29,0.04,29,0.14,45.57,11,18,7,13,0
13,5,0,0,3,3,1,17.24,7.5,969.51,0.04,31,0.13,53.86,12,19,8,13,0
4,3,0,0,2,2,1,11.99,6.67,533.03,0.03,21,0.15,29.61,10,11,6,4,0
0,1,0,0,1,1,1,6.55,3.0,58.95,0.01,7,0.33,3.28,1,6,1,0,0
0,3,0,0,2,2,1,6.69,7.5,376.42,0.02,14,0.13,20.91,5,9,3,0,0
0,1,0,0,1,1,1,7.86,2.5,49.13,0.01,7,0.4,2.73,2,5,2,0,0
0,3,0,0,2,2,1,9.32,5.0,233.02,0.02,13,0.2,12.95,5,8,4,0,0
6,1,0,0,1,1,1,17.51,5.0,437.85,0.03,23,0.2,24.32,10,13,7,6,0
0,3,0,0,2,2,1,7.75,2.0,31.02,0.01,6,0.5,1.72,2,4,2,0,0
0,3,0,0,2,2,1,7.86,2.5,49.13,0.01,7,0.4,2.73,2,5,2,0,0
11,7,0,0,4,2,3,12.35,16.0,3162.47,0.07,45,0.06,175.69,16,29,7,11,0
3,3,0,0,2,2,1,14.28,4.0,228.44,0.02,15,0.25,12.69,6,9,6,3,0
0,1,0,0,1,1,1,0.0,0.0,0.0,0.0,1,0.0,0.0,0,1,0,0,0
2,1,0,0,1,1,1,13.5,2.0,54.0,0.01,9,0.5,3.0,4,5,4,2,0
0,1,0,0,1,1,1,7.75,2.0,31.02,0.01,6,0.5,1.72,2,4,2,0,0
0,1,0,0,1,1,1,7.75,2.0,31.02,0.01,6,0.5,1.72,2,4,2,0,0
0,1,0,0,1,1,1,7.75,2.0,31.02,0.01,6,0.5,1.72,2,4,2,0,0
0,1,0,0,1,1,1,7.74,1.5,17.41,0.0,5,0.67,0.97,2,3,2,0,0
1,1,0,0,1,1,1,7.74,1.5,17.41,0.0,5,0.67,0.97,2,3,2,1,0
0,1,0,0,1,1,1,5.8,2.0,23.22,0.0,5,0.5,1.29,1,4,1,0,0
2,1,0,0,1,1,1,7.75,2.0,31.02,0.01,6,0.5,1.72,2,4,2,2,0
1,1,0,1,1,1,1,0.0,0.0,0.0,0.0,1,0.0,0.0,0,1,0,1,0
2,1,0,0,1,1,1,7.75,2.0,31.02,0.01,6,0.5,1.72,2,4,2,2,0
0,1,0,0,1,1,1,9.31,2.5,58.16,0.01,9,0.4,3.23,1,8,1,0,0
2,1,0,0,1,1,1,7.74,1.5,17.41,0.0,5,0.67,0.97,2,3,2,2,0
0,1,0,0,1,1,1,7.75,2.0,31.02,0.01,6,0.5,1.72,2,4,2,0,0
0,1,0,0,1,1,1,10.68,4.67,232.53,0.02,15,0.21,12.92,4,11,3,0,0
7,5,0,0,3,2,1,11.89,13.13,2048.55,0.05,35,0.08,113.81,15,20,8,7,0
5,3,0,0,2,2,1,17.22,4.08,287.09,0.02,19,0.24,15.95,7,12,6,5,0
4,3,0,0,2,2,1,11.18,5.63,353.85,0.02,17,0.18,19.66,5,12,4,4,0
0,1,0,0,1,1,1,0.0,0.0,0.0,0.0,0,0.0,0.0,0,0,0,0,0
0,1,0,0,1,1,1,6.2,2.5,38.77,0.01,6,0.4,2.15,1,5,1,0,0
0,1,0,0,1,1,1,11.86,3.5,145.3,0.01,12,0.29,8.07,4,8,4,0,0
0,1,0,0,1,1,1,0.0,0.0,0.0,0.0,0,0.0,0.0,0,0,0,0,0
0,1,0,0,1,1,1,0.0,0.0,0.0,0.0,0,0.0,0.0,0,0,0,0,0
0,1,0,0,1,1,1,0.0,0.0,0.0,0.0,0,0.0,0.0,0,0,0,0,0
0,1,0,0,1,1,1,7.33,4.5,148.5,0.01,11,0.22,8.25,3,8,2,0,0
8,3,0,0,2,1,1,15.07,9.75,1432.72,0.05,34,0.1,79.6,13,21,8,8,0
0,1,0,0,1,1,1,9.6,2.5,60.0,0.01,8,0.4,3.33,3,5,3,0,0
0,1,0,0,1,1,1,7.75,2.0,31.02,0.01,6,0.5,1.72,2,4,2,0,0
0,1,0,0,1,1,1,6.86,3.5,84.0,0.01,8,0.29,4.67,1,7,1,0,0
0,1,0,0,1,1,1,7.75,2.0,31.02,0.01,6,0.5,1.72,2,4,2,0,0
0,1,0,0,1,1,1,8.3,6.0,298.97,0.02,15,0.17,16.61,3,12,2,0,0
0,1,0,0,1,1,1,8.3,6.0,298.97,0.02,15,0.17,16.61,3,12,2,0,0
0,1,0,0,1,1,1,8.3,6.0,298.97,0.02,15,0.17,16.61,3,12,2,0,0
0,1,0,0,1,1,1,7.75,2.0,31.02,0.01,6,0.5,1.72,2,4,2,0,0
0,1,0,0,1,1,1,7.75,2.0,31.02,0.01,6,0.5,1.72,2,4,2,0,0
0,1,0,0,1,1,1,7.75,2.0,31.02,0.01,6,0.5,1.72,2,4,2,0,0
0,1,0,0,1,1,1,7.75,2.0,31.02,0.01,6,0.5,1.72,2,4,2,0,0
0,3,0,0,2,1,1,7.75,2.0,31.02,0.01,6,0.5,1.72,2,4,2,0,0
0,1,0,0,1,1,1,5.8,2.0,23.22,0.0,5,0.5,1.29,1,4,1,0,0
0,3,0,0,2,1,1,7.75,2.0,31.02,0.01,6,0.5,1.72,2,4,2,0,0
0,1,0,0,1,1,1,12.18,3.0,109.62,0.01,11,0.33,6.09,4,7,4,0,0
0,1,0,0,1,1,1,7.75,2.0,31.02,0.01,6,0.5,1.72,2,4,2,0,0
0,1,0,0,1,1,1,7.75,2.0,31.02,0.01,6,0.5,1.72,2,4,2,0,0
0,1,0,0,1,1,1,7.75,2.0,31.02,0.01,6,0.5,1.72,2,4,2,0,0
0,1,0,0,1,1,1,5.8,2.0,23.22,0.0,5,0.5,1.29,1,4,1,0,0
0,1,0,0,1,1,1,7.75,2.0,31.02,0.01,6,0.5,1.72,2,4,2,0,0
2,1,0,0,1,1,1,8.98,2.5,56.15,0.01,8,0.4,3.12,2,6,2,2,0
2,1,0,0,1,1,1,5.33,1.5,12.0,0.0,4,0.67,0.67,1,3,1,2,0
0,1,0,0,1,1,1,5.33,1.5,12.0,0.0,4,0.67,0.67,1,3,1,0,0
2,1,0,0,1,1,1,5.33,1.5,12.0,0.0,4,0.67,0.67,1,3,1,2,0
2,1,0,0,1,1,1,5.33,1.5,12.0,0.0,4,0.67,0.67,1,3,1,2,0
3,1,0,0,1,1,1,12.0,2.5,75.0,0.01,10,0.4,4.17,3,7,3,3,0
0,1,0,0,1,1,1,7.86,2.5,49.13,0.01,7,0.4,2.73,2,5,2,0,0
0,1,0,0,1,1,1,6.55,3.0,58.95,0.01,7,0.33,3.28,1,6,1,0,0
0,1,0,0,1,1,1,6.55,3.0,58.95,0.01,7,0.33,3.28,1,6,1,0,0
2,1,0,0,1,1,1,8.98,2.5,56.15,0.01,8,0.4,3.12,2,6,2,2,0
2,1,0,0,1,1,1,5.33,1.5,12.0,0.0,4,0.67,0.67,1,3,1,2,0
0,1,0,0,1,1,1,5.33,1.5,12.0,0.0,4,0.67,0.67,1,3,1,0,0
2,1,0,0,1,1,1,5.33,1.5,12.0,0.0,4,0.67,0.67,1,3,1,2,0
2,1,0,0,1,1,1,5.33,1.5,12.0,0.0,4,0.67,0.67,1,3,1,2,0
0,1,0,0,1,1,1,5.33,1.5,12.0,0.0,4,0.67,0.67,1,3,1,0,0
0,1,0,0,1,1,1,5.33,1.5,12.0,0.0,4,0.67,0.67,1,3,1,0,0
0,1,0,0,1,1,1,7.75,2.0,31.02,0.01,6,0.5,1.72,2,4,2,0,0
0,1,0,0,1,1,1,9.0,3.0,81.0,0.01,9,0.33,4.5,2,7,2,0,0
0,1,0,0,1,1,1,8.3,6.0,298.97,0.02,15,0.17,16.61,3,12,2,0,0
3,1,0,0,1,1,1,16.0,1.5,36.0,0.01,8,0.67,2.0,5,3,5,3,0
3,1,0,0,1,1,1,9.51,3.0,85.59,0.01,9,0.33,4.75,3,6,3,3,0
5,3,0,0,2,2,1,15.36,3.5,188.21,0.02,15,0.29,10.46,5,10,5,5,0
4,3,0,0,2,2,1,10.88,5.6,341.29,0.02,17,0.18,18.96,8,9,5,4,0
0,1,0,0,1,1,1,7.74,1.5,17.41,0.0,5,0.67,0.97,2,3,2,0,0
0,1,0,0,1,1,1,12.68,2.5,79.25,0.01,10,0.4,4.4,4,6,4,0,0
0,1,0,0,1,1,1,7.74,1.5,17.41,0.0,5,0.67,0.97,2,3,2,0,0
0,1,0,0,1,1,1,7.75,2.0,31.02,0.01,6,0.5,1.72,2,4,2,0,0
0,1,0,0,1,1,1,7.75,2.0,31.02,0.01,6,0.5,1.72,2,4,2,0,0
0,1,0,0,1,1,1,7.75,2.0,31.02,0.01,6,0.5,1.72,2,4,2,0,0
0,1,0,0,1,1,1,7.75,2.0,31.02,0.01,6,0.5,1.72,2,4,2,0,0
7,3,0,0,2,2,1,15.65,7.31,836.91,0.04,28,0.14,46.49,13,15,8,7,0
0,1,0,0,1,1,1,9.51,3.0,85.59,0.01,9,0.33,4.75,3,6,3,0,0
0,1,0,0,1,1,1,9.51,3.0,85.59,0.01,9,0.33,4.75,3,6,3,0,0
0,1,0,0,1,1,1,9.51,3.0,85.59,0.01,9,0.33,4.75,3,6,3,0,0
0,1,0,0,1,1,1,9.51,3.0,85.59,0.01,9,0.33,4.75,3,6,3,0,0
4,3,0,0,2,2,1,13.67,6.0,492.27,0.03,21,0.17,27.35,6,15,5,4,0
9,1,0,10,1,1,1,86.0,1.6,220.17,0.05,33,0.63,12.23,16,17,15,9,0
9,1,0,10,1,1,1,86.0,1.6,220.17,0.05,33,0.63,12.23,16,17,15,9,0
9,1,0,10,1,1,1,86.0,1.6,220.17,0.05,33,0.63,12.23,16,17,15,9,0
9,1,0,10,1,1,1,86.0,1.6,220.17,0.05,33,0.63,12.23,16,17,15,9,0
9,1,0,10,1,1,1,86.0,1.6,220.17,0.05,33,0.63,12.23,16,17,15,9,0
9,1,0,10,1,1,1,86.0,1.6,220.17,0.05,33,0.63,12.23,16,17,15,9,0
9,1,0,10,1,1,1,86.0,1.6,220.17,0.05,33,0.63,12.23,16,17,15,9,0
9,1,0,10,1,1,1,86.0,1.6,220.17,0.05,33,0.63,12.23,16,17,15,9,0
9,1,0,10,1,1,1,86.0,1.6,220.17,0.05,33,0.63,12.23,16,17,15,9,0
9,1,0,10,1,1,1,86.0,1.6,220.17,0.05,33,0.63,12.23,16,17,15,9,0
7,1,0,7,1,1,1,51.39,1.8,166.52,0.03,25,0.56,9.25,12,13,10,7,0
7,1,0,7,1,1,1,51.39,1.8,166.52,0.03,25,0.56,9.25,12,13,10,7,0
9,1,0,10,1,1,1,86.0,1.6,220.17,0.05,33,0.63,12.23,16,17,15,9,0
9,1,0,10,1,1,1,86.0,1.6,220.17,0.05,33,0.63,12.23,16,17,15,9,0
9,1,0,10,1,1,1,86.0,1.6,220.17,0.05,33,0.63,12.23,16,17,15,9,0
9,1,0,10,1,1,1,86.0,1.6,220.17,0.05,33,0.63,12.23,16,17,15,9,0
9,1,0,10,1,1,1,86.0,1.6,220.17,0.05,33,0.63,12.23,16,17,15,9,0
9,1,0,10,1,1,1,86.0,1.6,220.17,0.05,33,0.63,12.23,16,17,15,9,0
9,1,0,10,1,1,1,86.0,1.6,220.17,0.05,33,0.63,12.23,16,17,15,9,0
9,1,0,10,1,1,1,86.0,1.6,220.17,0.05,33,0.63,12.23,16,17,15,9,0
9,1,0,10,1,1,1,86.0,1.6,220.17,0.05,33,0.63,12.23,16,17,15,9,0
9,1,0,10,1,1,1,86.0,1.6,220.17,0.05,33,0.63,12.23,16,17,15,9,0
2,1,0,0,1,1,1,5.33,1.5,12.0,0.0,4,0.67,0.67,1,3,1,2,0
2,1,0,0,1,1,1,5.33,1.5,12.0,0.0,4,0.67,0.67,1,3,1,2,0
17,1,0,47,1,1,1,117.18,2.67,833.27,0.1,65,0.38,46.29,32,33,24,17,0
19,1,0,30,1,1,1,123.14,2.88,1021.34,0.12,73,0.35,56.74,36,37,25,19,0
19,1,0,30,1,1,1,123.14,2.88,1021.34,0.12,73,0.35,56.74,36,37,25,19,0
17,1,0,29,1,1,1,117.18,2.67,833.27,0.1,65,0.38,46.29,32,33,24,17,0
17,1,0,29,1,1,1,117.18,2.67,833.27,0.1,65,0.38,46.29,32,33,24,17,0
19,1,0,52,1,1,1,116.98,3.0,1052.81,0.12,73,0.33,58.49,36,37,24,19,0
17,1,0,47,1,1,1,117.18,2.67,833.27,0.1,65,0.38,46.29,32,33,24,17,0
19,1,0,52,1,1,1,116.98,3.0,1052.81,0.12,73,0.33,58.49,36,37,24,19,0
11,1,4,9,1,1,1,41.79,8.86,3278.32,0.12,83,0.11,182.13,31,52,14,15,0
11,1,4,9,1,1,1,41.79,8.86,3278.32,0.12,83,0.11,182.13,31,52,14,15,0
9,3,0,4,2,1,1,11.63,6.0,418.56,0.02,21,0.17,23.25,8,13,4,9,0
9,3,0,4,2,1,1,11.63,6.0,418.56,0.02,21,0.17,23.25,8,13,4,9,0
0,1,0,0,1,1,1,5.33,1.5,12.0,0.0,4,0.67,0.67,1,3,1,0,0
0,1,0,0,1,1,1,5.33,1.5,12.0,0.0,4,0.67,0.67,1,3,1,0,0
0,1,0,0,1,1,1,7.74,1.5,17.41,0.0,5,0.67,0.97,2,3,2,0,0
0,1,0,0,1,1,1,7.74,1.5,17.41,0.0,5,0.67,0.97,2,3,2,0,0
87,27,5,19,14,10,9,55.77,42.89,102612.33,0.8,389,0.02,5700.68,168,221,47,92,0
87,27,5,19,14,10,9,55.77,42.89,102612.33,0.8,389,0.02,5700.68,168,221,47,92,0
7,3,0,7,2,1,1,16.0,6.5,676.0,0.03,26,0.15,37.56,13,13,8,7,0
7,3,0,7,2,1,1,16.0,6.5,676.0,0.03,26,0.15,37.56,13,13,8,7,0
87,25,5,12,13,10,9,69.2,35.36,86504.3,0.82,387,0.03,4805.79,165,222,56,92,0
87,25,5,12,13,10,9,69.2,35.36,86504.3,0.82,387,0.03,4805.79,165,222,56,92,0
0,1,0,0,1,1,1,5.33,1.5,12.0,0.0,4,0.67,0.67,1,3,1,0,0
0,1,0,0,1,1,1,7.74,1.5,17.41,0.0,5,0.67,0.97,2,3,2,0,0
0,1,0,0,1,1,1,5.33,1.5,12.0,0.0,4,0.67,0.67,1,3,1,0,0
0,1,0,0,1,1,1,7.74,1.5,17.41,0.0,5,0.67,0.97,2,3,2,0,0
0,1,0,0,1,1,1,5.33,1.5,12.0,0.0,4,0.67,0.67,1,3,1,0,0
0,1,0,0,1,1,1,7.74,1.5,17.41,0.0,5,0.67,0.97,2,3,2,0,0
0,1,0,0,1,1,1,5.33,1.5,12.0,0.0,4,0.67,0.67,1,3,1,0,0
0,1,0,0,1,1,1,7.74,1.5,17.41,0.0,5,0.67,0.97,2,3,2,0,0
0,1,0,0,1,1,1,0.0,0.0,0.0,0.0,1,0.0,0.0,0,1,0,0,0
0,1,0,0,1,1,1,0.0,0.0,0.0,0.0,0,0.0,0.0,0,0,0,0,0
0,1,0,0,1,1,1,5.33,1.5,12.0,0.0,4,0.67,0.67,1,3,1,0,0
0,1,0,0,1,1,1,5.33,1.5,12.0,0.0,4,0.67,0.67,1,3,1,0,0
0,1,0,0,1,1,1,5.33,1.5,12.0,0.0,4,0.67,0.67,1,3,1,0,0
0,1,0,0,1,1,1,5.33,1.5,12.0,0.0,4,0.67,0.67,1,3,1,0,0
0,1,0,0,1,1,1,5.33,1.5,12.0,0.0,4,0.67,0.67,1,3,1,0,0
0,1,0,0,1,1,1,9.51,3.0,85.59,0.01,9,0.33,4.75,3,6,3,0,0
0,1,0,0,1,1,1,5.33,1.5,12.0,0.0,4,0.67,0.67,1,3,1,0,0
0,1,0,0,1,1,1,5.33,1.5,12.0,0.0,4,0.67,0.67,1,3,1,0,0
0,1,0,0,1,1,1,5.33,1.5,12.0,0.0,4,0.67,0.67,1,3,1,0,0
9,1,0,2,1,1,1,46.84,5.97,1669.87,0.09,61,0.17,92.77,29,32,17,9,0
0,1,0,0,1,1,1,5.33,1.5,12.0,0.0,4,0.67,0.67,1,3,1,0,0
0,1,0,0,1,1,1,5.33,1.5,12.0,0.0,4,0.67,0.67,1,3,1,0,0
0,1,0,0,1,1,1,5.33,1.5,12.0,0.0,4,0.67,0.67,1,3,1,0,0
11,1,0,4,1,1,1,53.35,6.08,1971.59,0.11,69,0.16,109.53,33,36,19,11,0
23,5,2,14,3,3,1,37.12,13.33,6599.19,0.16,93,0.08,366.62,40,53,24,25,0
133,37,10,26,19,17,8,92.83,40.06,148951.03,1.24,566,0.02,8275.05,237,329,71,143,0
103,27,7,12,14,11,9,93.87,24.92,58286.1,0.78,370,0.04,3238.12,160,210,61,110,0
4,1,0,0,1,1,1,17.97,1.88,63.17,0.01,12,0.53,3.51,5,7,4,4,0
2,1,0,0,1,1,1,7.74,1.5,17.41,0.0,5,0.67,0.97,2,3,2,2,0
7,3,0,0,2,2,1,14.78,8.57,1086.1,0.04,31,0.12,60.34,12,19,7,7,0
39,27,0,10,14,14,1,30.28,31.32,29698.21,0.32,188,0.03,1649.9,85,103,19,39,0
16,3,0,6,2,2,1,23.0,9.5,2075.87,0.07,49,0.11,115.33,19,30,11,16,0
15,3,0,4,2,2,1,17.93,10.0,1793.07,0.06,43,0.1,99.61,16,27,8,15,0
7,3,0,0,2,1,1,9.87,8.1,647.63,0.03,21,0.12,35.98,9,12,5,7,0
24,1,0,0,1,1,1,26.32,22.33,13127.14,0.2,136,0.04,729.29,67,69,12,24,0
11,1,0,0,1,1,1,17.95,12.78,2931.07,0.08,54,0.08,162.84,23,31,9,11,0
11,1,0,0,1,1,1,17.95,12.78,2931.07,0.08,54,0.08,162.84,23,31,9,11,0
12,1,0,1,1,1,1,28.22,7.27,1491.17,0.07,46,0.14,82.84,21,25,13,12,0
12,1,0,1,1,1,1,28.22,7.27,1491.17,0.07,46,0.14,82.84,21,25,13,12,0
4,1,0,0,1,1,1,10.24,7.0,501.89,0.02,20,0.14,27.88,7,13,4,4,0
4,3,0,0,2,2,1,21.5,7.15,1099.18,0.05,35,0.14,61.07,13,22,10,4,0
8,3,0,0,2,2,1,23.46,10.29,2485.24,0.08,52,0.1,138.07,19,33,12,8,0
54,13,1,8,7,6,6,25.11,40.0,40181.42,0.33,184,0.03,2232.3,80,104,22,55,0
0,1,0,0,1,1,1,8.3,6.67,369.01,0.02,16,0.15,20.5,5,11,3,0,0
23,5,0,1,3,2,1,19.78,20.04,7940.87,0.13,80,0.05,441.16,33,47,14,23,0
0,1,0,0,1,1,1,8.6,7.5,483.97,0.02,18,0.13,26.89,5,13,3,0,0
19,5,0,3,3,3,1,19.07,10.91,2270.01,0.07,46,0.09,126.11,20,26,11,19,0
12,3,0,2,2,2,1,14.73,8.94,1176.94,0.04,31,0.11,65.39,13,18,8,12,0
12,9,0,0,5,3,3,17.46,16.55,4779.2,0.1,63,0.06,265.51,28,35,11,12,0
4,1,0,0,1,1,1,9.47,2.67,67.38,0.01,9,0.38,3.74,4,5,3,4,0
13,5,0,0,3,3,1,16.4,7.07,820.29,0.04,29,0.14,45.57,11,18,7,13,0
13,5,0,0,3,3,1,17.24,7.5,969.51,0.04,31,0.13,53.86,12,19,8,13,0
4,3,0,0,2,2,1,11.99,6.67,533.03,0.03,21,0.15,29.61,10,11,6,4,0
0,1,0,0,1,1,1,6.55,3.0,58.95,0.01,7,0.33,3.28,1,6,1,0,0
0,3,0,0,2,2,1,6.69,7.5,376.42,0.02,14,0.13,20.91,5,9,3,0,0
0,1,0,0,1,1,1,7.86,2.5,49.13,0.01,7,0.4,2.73,2,5,2,0,0
0,3,0,0,2,2,1,9.32,5.0,233.02,0.02,13,0.2,12.95,5,8,4,0,0
6,1,0,0,1,1,1,17.51,5.0,437.85,0.03,23,0.2,24.32,10,13,7,6,0
0,3,0,0,2,2,1,7.75,2.0,31.02,0.01,6,0.5,1.72,2,4,2,0,0
0,3,0,0,2,2,1,7.86,2.5,49.13,0.01,7,0.4,2.73,2,5,2,0,0
11,7,0,0,4,2,3,12.35,16.0,3162.47,0.07,45,0.06,175.69,16,29,7,11,0
3,3,0,0,2,2,1,14.28,4.0,228.44,0.02,15,0.25,12.69,6,9,6,3,0
0,1,0,0,1,1,1,0.0,0.0,0.0,0.0,1,0.0,0.0,0,1,0,0,0
2,1,0,0,1,1,1,13.5,2.0,54.0,0.01,9,0.5,3.0,4,5,4,2,0
0,1,0,0,1,1,1,7.75,2.0,31.02,0.01,6,0.5,1.72,2,4,2,0,0
0,1,0,0,1,1,1,7.75,2.0,31.02,0.01,6,0.5,1.72,2,4,2,0,0
0,1,0,0,1,1,1,7.75,2.0,31.02,0.01,6,0.5,1.72,2,4,2,0,0
0,1,0,0,1,1,1,7.74,1.5,17.41,0.0,5,0.67,0.97,2,3,2,0,0
1,1,0,0,1,1,1,7.74,1.5,17.41,0.0,5,0.67,0.97,2,3,2,1,0
0,1,0,0,1,1,1,5.8,2.0,23.22,0.0,5,0.5,1.29,1,4,1,0,0
2,1,0,0,1,1,1,7.75,2.0,31.02,0.01,6,0.5,1.72,2,4,2,2,0
1,1,0,1,1,1,1,0.0,0.0,0.0,0.0,1,0.0,0.0,0,1,0,1,0
2,1,0,0,1,1,1,7.75,2.0,31.02,0.01,6,0.5,1.72,2,4,2,2,0
0,1,0,0,1,1,1,9.31,2.5,58.16,0.01,9,0.4,3.23,1,8,1,0,0
0,1,0,0,1,1,1,7.75,2.0,31.02,0.01,6,0.5,1.72,2,4,2,0,0
0,1,0,0,1,1,1,10.68,4.67,232.53,0.02,15,0.21,12.92,4,11,3,0,0
7,5,0,0,3,2,1,11.89,13.13,2048.55,0.05,35,0.08,113.81,15,20,8,7,0
5,3,0,0,2,2,1,17.22,4.08,287.09,0.02,19,0.24,15.95,7,12,6,5,0
4,3,0,0,2,2,1,11.18,5.63,353.85,0.02,17,0.18,19.66,5,12,4,4,0
0,1,0,0,1,1,1,0.0,0.0,0.0,0.0,0,0.0,0.0,0,0,0,0,0
0,1,0,0,1,1,1,6.2,2.5,38.77,0.01,6,0.4,2.15,1,5,1,0,0
0,1,0,0,1,1,1,11.86,3.5,145.3,0.01,12,0.29,8.07,4,8,4,0,0
0,1,0,0,1,1,1,0.0,0.0,0.0,0.0,0,0.0,0.0,0,0,0,0,0
0,1,0,0,1,1,1,0.0,0.0,0.0,0.0,0,0.0,0.0,0,0,0,0,0
0,1,0,0,1,1,1,0.0,0.0,0.0,0.0,0,0.0,0.0,0,0,0,0,0
0,1,0,0,1,1,1,7.33,4.5,148.5,0.01,11,0.22,8.25,3,8,2,0,0
8,3,0,0,2,1,1,15.07,9.75,1432.72,0.05,34,0.1,79.6,13,21,8,8,0
0,1,0,0,1,1,1,9.6,2.5,60.0,0.01,8,0.4,3.33,3,5,3,0,0
0,1,0,0,1,1,1,7.75,2.0,31.02,0.01,6,0.5,1.72,2,4,2,0,0
0,1,0,0,1,1,1,6.86,3.5,84.0,0.01,8,0.29,4.67,1,7,1,0,0
0,1,0,0,1,1,1,7.75,2.0,31.02,0.01,6,0.5,1.72,2,4,2,0,0
0,1,0,0,1,1,1,8.3,6.0,298.97,0.02,15,0.17,16.61,3,12,2,0,0
0,1,0,0,1,1,1,8.3,6.0,298.97,0.02,15,0.17,16.61,3,12,2,0,0
0,1,0,0,1,1,1,8.3,6.0,298.97,0.02,15,0.17,16.61,3,12,2,0,0
0,1,0,0,1,1,1,7.75,2.0,31.02,0.01,6,0.5,1.72,2,4,2,0,0
0,1,0,0,1,1,1,7.75,2.0,31.02,0.01,6,0.5,1.72,2,4,2,0,0
0,1,0,0,1,1,1,7.75,2.0,31.02,0.01,6,0.5,1.72,2,4,2,0,0
0,1,0,0,1,1,1,7.75,2.0,31.02,0.01,6,0.5,1.72,2,4,2,0,0
0,3,0,0,2,1,1,7.75,2.0,31.02,0.01,6,0.5,1.72,2,4,2,0,0
0,1,0,0,1,1,1,5.8,2.0,23.22,0.0,5,0.5,1.29,1,4,1,0,0
0,3,0,0,2,1,1,7.75,2.0,31.02,0.01,6,0.5,1.72,2,4,2,0,0
0,1,0,0,1,1,1,12.18,3.0,109.62,0.01,11,0.33,6.09,4,7,4,0,0
0,1,0,0,1,1,1,7.75,2.0,31.02,0.01,6,0.5,1.72,2,4,2,0,0
0,1,0,0,1,1,1,7.75,2.0,31.02,0.01,6,0.5,1.72,2,4,2,0,0
0,1,0,0,1,1,1,7.75,2.0,31.02,0.01,6,0.5,1.72,2,4,2,0,0
0,1,0,0,1,1,1,5.8,2.0,23.22,0.0,5,0.5,1.29,1,4,1,0,0
0,1,0,0,1,1,1,7.75,2.0,31.02,0.01,6,0.5,1.72,2,4,2,0,0
2,1,0,0,1,1,1,8.98,2.5,56.15,0.01,8,0.4,3.12,2,6,2,2,0
2,1,0,0,1,1,1,5.33,1.5,12.0,0.0,4,0.67,0.67,1,3,1,2,0
0,1,0,0,1,1,1,5.33,1.5,12.0,0.0,4,0.67,0.67,1,3,1,0,0
2,1,0,0,1,1,1,5.33,1.5,12.0,0.0,4,0.67,0.67,1,3,1,2,0
2,1,0,0,1,1,1,5.33,1.5,12.0,0.0,4,0.67,0.67,1,3,1,2,0
3,1,0,0,1,1,1,12.0,2.5,75.0,0.01,10,0.4,4.17,3,7,3,3,0
0,1,0,0,1,1,1,7.86,2.5,49.13,0.01,7,0.4,2.73,2,5,2,0,0
0,1,0,0,1,1,1,6.55,3.0,58.95,0.01,7,0.33,3.28,1,6,1,0,0
0,1,0,0,1,1,1,6.55,3.0,58.95,0.01,7,0.33,3.28,1,6,1,0,0
2,1,0,0,1,1,1,8.98,2.5,56.15,0.01,8,0.4,3.12,2,6,2,2,0
2,1,0,0,1,1,1,5.33,1.5,12.0,0.0,4,0.67,0.67,1,3,1,2,0
0,1,0,0,1,1,1,5.33,1.5,12.0,0.0,4,0.67,0.67,1,3,1,0,0
2,1,0,0,1,1,1,5.33,1.5,12.0,0.0,4,0.67,0.67,1,3,1,2,0
2,1,0,0,1,1,1,5.33,1.5,12.0,0.0,4,0.67,0.67,1,3,1,2,0
0,1,0,0,1,1,1,5.33,1.5,12.0,0.0,4,0.67,0.67,1,3,1,0,0
0,1,0,0,1,1,1,5.33,1.5,12.0,0.0,4,0.67,0.67,1,3,1,0,0
0,1,0,0,1,1,1,7.75,2.0,31.02,0.01,6,0.5,1.72,2,4,2,0,0
0,1,0,0,1,1,1,9.0,3.0,81.0,0.01,9,0.33,4.5,2,7,2,0,0
0,1,0,0,1,1,1,8.3,6.0,298.97,0.02,15,0.17,16.61,3,12,2,0,0
0,1,0,0,1,1,1,9.51,3.0,85.59,0.01,9,0.33,4.75,3,6,3,0,0
0,1,0,0,1,1,1,9.51,3.0,85.59,0.01,9,0.33,4.75,3,6,3,0,0
0,1,0,0,1,1,1,9.51,3.0,85.59,0.01,9,0.33,4.75,3,6,3,0,0
0,1,0,0,1,1,1,9.51,3.0,85.59,0.01,9,0.33,4.75,3,6,3,0,0
4,3,0,0,2,2,1,13.67,6.0,492.27,0.03,21,0.17,27.35,6,15,5,4,0
3,1,0,0,1,1,1,9.51,3.0,85.59,0.01,9,0.33,4.75,3,6,3,3,0
5,3,0,0,2,2,1,15.36,3.5,188.21,0.02,15,0.29,10.46,5,10,5,5,0
4,3,0,0,2,2,1,10.88,5.6,341.29,0.02,17,0.18,18.96,8,9,5,4,0
0,1,0,0,1,1,1,7.74,1.5,17.41,0.0,5,0.67,0.97,2,3,2,0,0
0,1,0,0,1,1,1,12.68,2.5,79.25,0.01,10,0.4,4.4,4,6,4,0,0
0,1,0,0,1,1,1,7.74,1.5,17.41,0.0,5,0.67,0.97,2,3,2,0,0
0,1,0,0,1,1,1,7.75,2.0,31.02,0.01,6,0.5,1.72,2,4,2,0,0
0,1,0,0,1,1,1,7.75,2.0,31.02,0.01,6,0.5,1.72,2,4,2,0,0
0,1,0,0,1,1,1,7.75,2.0,31.02,0.01,6,0.5,1.72,2,4,2,0,0
0,1,0,0,1,1,1,7.75,2.0,31.02,0.01,6,0.5,1.72,2,4,2,0,0
0,1,0,0,1,1,1,5.33,1.5,12.0,0.0,4,0.67,0.67,1,3,1,0,0
0,1,0,0,1,1,1,5.33,1.5,12.0,0.0,4,0.67,0.67,1,3,1,0,0
16,11,0,0,6,3,4,24.08,20.42,10035.66,0.16,93,0.05,557.54,35,58,18,16,0
16,11,0,0,6,3,4,24.96,18.42,8470.55,0.15,87,0.05,470.59,35,52,19,16,0
3,3,0,0,2,2,1,15.56,5.14,411.43,0.03,20,0.19,22.86,8,12,7,3,0
3,3,0,0,2,2,1,15.56,5.14,411.43,0.03,20,0.19,22.86,8,12,7,3,0
6,3,0,0,2,2,1,32.09,5.71,1047.99,0.06,40,0.18,58.22,16,24,14,6,0
6,3,0,0,2,2,1,32.09,5.71,1047.99,0.06,40,0.18,58.22,16,24,14,6,0
10,7,0,0,4,3,1,18.14,12.95,3044.6,0.08,50,0.08,169.14,19,31,11,10,0
10,7,0,0,4,3,1,19.27,13.82,3679.42,0.09,56,0.07,204.41,19,37,11,10,0
19,17,0,0,9,7,3,29.84,17.41,9046.68,0.17,103,0.06,502.59,37,66,17,19,0
19,17,0,0,9,7,3,33.91,15.58,8230.61,0.18,103,0.06,457.26,37,66,19,19,0
58,37,0,0,19,8,15,45.28,39.26,69777.4,0.59,290,0.03,3876.52,111,179,41,58,0
58,37,0,0,19,8,15,45.72,37.0,62592.24,0.56,276,0.03,3477.35,111,165,42,58,0
11,5,1,11,3,1,1,13.3,41.33,22726.68,0.18,109,0.02,1262.59,31,78,9,12,0
11,5,1,11,3,1,1,13.3,41.33,22726.68,0.18,109,0.02,1262.59,31,78,9,12,0
9,9,0,0,5,2,4,20.61,10.96,2476.71,0.08,47,0.09,137.6,19,28,13,9,0
9,9,0,0,5,2,4,21.19,11.69,2896.85,0.08,51,0.09,160.94,19,32,13,9,0
10,7,0,0,4,3,1,17.55,13.82,3350.9,0.08,51,0.07,186.16,19,32,11,10,0
10,7,0,0,4,3,1,18.66,14.68,4023.1,0.09,57,0.07,223.51,19,38,11,10,0
9,9,0,0,5,2,4,21.19,11.69,2896.85,0.08,51,0.09,160.94,19,32,13,9,0
9,9,0,0,5,2,4,20.61,10.96,2476.71,0.08,47,0.09,137.6,19,28,13,9,0
21,11,0,0,6,3,1,34.68,21.58,16147.85,0.25,134,0.05,897.1,51,83,26,21,0
21,11,0,0,6,3,1,36.04,19.83,14178.36,0.24,128,0.05,787.69,51,77,27,21,0
5,3,0,0,2,2,1,23.23,6.05,850.35,0.05,32,0.17,47.24,11,21,10,5,0
5,3,0,0,2,2,1,23.23,6.05,850.35,0.05,32,0.17,47.24,11,21,10,5,0
11,3,0,0,2,2,1,31.35,9.97,3114.36,0.1,65,0.1,173.02,23,42,15,11,0
11,3,0,0,2,2,1,31.35,9.97,3114.36,0.1,65,0.1,173.02,23,42,15,11,0
5,1,0,3,1,1,1,17.9,9.1,1481.92,0.05,36,0.11,82.33,14,22,10,5,0
5,1,0,3,1,1,1,17.9,9.1,1481.92,0.05,36,0.11,82.33,14,22,10,5,0
4,1,0,0,1,1,1,22.31,4.95,546.71,0.04,26,0.2,30.37,11,15,10,4,0
4,1,0,0,1,1,1,22.31,4.95,546.71,0.04,26,0.2,30.37,11,15,10,4,0
5,1,0,0,1,1,1,27.63,2.81,218.56,0.03,21,0.36,12.14,9,12,8,5,0
5,1,0,0,1,1,1,27.63,2.81,218.56,0.03,21,0.36,12.14,9,12,8,5,0
3,1,0,0,1,1,1,6.89,3.0,62.04,0.01,8,0.33,3.45,3,5,2,3,0
3,1,0,0,1,1,1,6.89,3.0,62.04,0.01,8,0.33,3.45,3,5,2,3,0
2,1,0,0,1,1,1,5.33,1.5,12.0,0.0,4,0.67,0.67,1,3,1,2,0
2,1,0,0,1,1,1,5.33,1.5,12.0,0.0,4,0.67,0.67,1,3,1,2,0
8,1,0,5,1,1,1,42.46,4.07,703.86,0.06,40,0.25,39.1,19,21,14,8,0
8,1,0,5,1,1,1,42.46,4.07,703.86,0.06,40,0.25,39.1,19,21,14,8,0
3,1,0,0,1,1,1,15.02,5.71,490.5,0.03,21,0.18,27.25,8,13,7,3,0
3,1,0,0,1,1,1,15.02,5.71,490.5,0.03,21,0.18,27.25,8,13,7,3,0
2,1,0,0,1,1,1,15.23,4.0,243.67,0.02,16,0.25,13.54,6,10,6,2,0
2,1,0,0,1,1,1,15.23,4.0,243.67,0.02,16,0.25,13.54,6,10,6,2,0
40,27,0,0,14,8,1,43.33,25.77,28780.5,0.37,216,0.04,1598.92,81,135,22,40,0
40,27,0,0,14,8,1,45.28,27.61,34524.47,0.42,240,0.04,1918.03,81,159,22,40,0
13,5,0,0,3,2,1,21.0,22.4,10536.98,0.16,89,0.04,585.39,28,61,15,13,0
13,5,0,0,3,2,1,16.61,29.17,14130.64,0.16,93,0.03,785.04,28,65,12,13,0
6,5,4,1,3,2,1,20.54,4.38,393.13,0.03,23,0.23,21.84,10,13,8,10,0
6,5,4,1,3,2,1,20.54,4.38,393.13,0.03,23,0.23,21.84,10,13,8,10,0
6,5,4,1,3,2,1,20.54,4.38,393.13,0.03,23,0.23,21.84,10,13,8,10,0
6,5,4,1,3,2,1,20.54,4.38,393.13,0.03,23,0.23,21.84,10,13,8,10,0
6,5,4,1,3,2,1,20.54,4.38,393.13,0.03,23,0.23,21.84,10,13,8,10,0
6,5,4,1,3,2,1,20.54,4.38,393.13,0.03,23,0.23,21.84,10,13,8,10,0
6,5,4,1,3,2,1,20.54,4.38,393.13,0.03,23,0.23,21.84,10,13,8,10,0
6,5,4,1,3,2,1,20.54,4.38,393.13,0.03,23,0.23,21.84,10,13,8,10,0
6,5,4,1,3,2,1,20.54,4.38,393.13,0.03,23,0.23,21.84,10,13,8,10,0
6,5,4,1,3,2,1,20.54,4.38,393.13,0.03,23,0.23,21.84,10,13,8,10,0
6,5,4,1,3,2,1,20.54,4.38,393.13,0.03,23,0.23,21.84,10,13,8,10,0
6,5,4,1,3,2,1,20.54,4.38,393.13,0.03,23,0.23,21.84,10,13,8,10,0
6,5,4,1,3,2,1,20.54,4.38,393.13,0.03,23,0.23,21.84,10,13,8,10,0
6,5,4,1,3,2,1,20.54,4.38,393.13,0.03,23,0.23,21.84,10,13,8,10,0
6,5,4,1,3,2,1,20.54,4.38,393.13,0.03,23,0.23,21.84,10,13,8,10,0
6,5,4,1,3,2,1,20.54,4.38,393.13,0.03,23,0.23,21.84,10,13,8,10,0
6,5,4,1,3,2,1,20.54,4.38,393.13,0.03,23,0.23,21.84,10,13,8,10,0
6,5,4,1,3,2,1,20.54,4.38,393.13,0.03,23,0.23,21.84,10,13,8,10,0
6,5,4,1,3,2,1,20.54,4.38,393.13,0.03,23,0.23,21.84,10,13,8,10,0
6,5,4,1,3,2,1,20.54,4.38,393.13,0.03,23,0.23,21.84,10,13,8,10,0
3,1,2,0,1,1,1,14.4,2.5,90.0,0.01,12,0.4,5.0,5,7,4,5,0
7,1,0,9,1,1,1,38.4,2.5,240.0,0.03,24,0.4,13.33,11,13,11,7,0
4,1,0,7,1,1,1,17.17,2.4,98.9,0.01,13,0.42,5.49,6,7,5,4,0
7,1,0,9,1,1,1,44.77,2.18,213.1,0.03,25,0.46,11.84,12,13,11,7,0
7,1,0,9,1,1,1,38.4,2.5,240.0,0.03,24,0.4,13.33,11,13,11,7,0
7,1,0,9,1,1,1,44.77,2.18,213.1,0.03,25,0.46,11.84,12,13,11,7,0
7,1,0,9,1,1,1,38.4,2.5,240.0,0.03,24,0.4,13.33,11,13,11,7,0
7,1,0,9,1,1,1,44.77,2.18,213.1,0.03,25,0.46,11.84,12,13,11,7,0
7,1,0,9,1,1,1,38.4,2.5,240.0,0.03,24,0.4,13.33,11,13,11,7,0
7,1,0,9,1,1,1,44.77,2.18,213.1,0.03,25,0.46,11.84,12,13,11,7,0
7,1,0,9,1,1,1,38.4,2.5,240.0,0.03,24,0.4,13.33,11,13,11,7,0
8,1,14,1,1,1,1,110.63,3.8,1594.44,0.14,84,0.26,88.58,41,43,27,22,0
8,1,14,1,1,1,1,110.63,3.8,1594.44,0.14,84,0.26,88.58,41,43,27,22,0
4,1,0,7,1,1,1,17.17,2.4,98.9,0.01,13,0.42,5.49,6,7,5,4,0
7,1,0,9,1,1,1,44.77,2.18,213.1,0.03,25,0.46,11.84,12,13,11,7,0
7,1,0,9,1,1,1,44.77,2.18,213.1,0.03,25,0.46,11.84,12,13,11,7,0
7,1,0,9,1,1,1,38.4,2.5,240.0,0.03,24,0.4,13.33,11,13,11,7,0
7,1,0,9,1,1,1,44.77,2.18,213.1,0.03,25,0.46,11.84,12,13,11,7,0
7,1,0,9,1,1,1,38.4,2.5,240.0,0.03,24,0.4,13.33,11,13,11,7,0
7,1,0,9,1,1,1,44.77,2.18,213.1,0.03,25,0.46,11.84,12,13,11,7,0
7,1,0,9,1,1,1,38.4,2.5,240.0,0.03,24,0.4,13.33,11,13,11,7,0
7,1,0,9,1,1,1,44.77,2.18,213.1,0.03,25,0.46,11.84,12,13,11,7,0
7,1,0,9,1,1,1,38.4,2.5,240.0,0.03,24,0.4,13.33,11,13,11,7,0
7,1,0,9,1,1,1,44.77,2.18,213.1,0.03,25,0.46,11.84,12,13,11,7,0
7,1,0,9,1,1,1,38.4,2.5,240.0,0.03,24,0.4,13.33,11,13,11,7,0
8,1,1,1,1,1,1,40.45,3.09,386.43,0.04,32,0.32,21.47,17,15,11,9,0
8,1,1,1,1,1,1,40.45,3.09,386.43,0.04,32,0.32,21.47,17,15,11,9,0
2,1,2,0,1,1,1,21.67,1.8,70.2,0.01,13,0.56,3.9,6,7,5,4,0
2,1,2,0,1,1,1,21.67,1.8,70.2,0.01,13,0.56,3.9,6,7,5,4,0
2,1,2,0,1,1,1,21.67,1.8,70.2,0.01,13,0.56,3.9,6,7,5,4,0
2,1,2,0,1,1,1,21.67,1.8,70.2,0.01,13,0.56,3.9,6,7,5,4,0
2,1,2,0,1,1,1,21.67,1.8,70.2,0.01,13,0.56,3.9,6,7,5,4,0
2,1,2,0,1,1,1,21.67,1.8,70.2,0.01,13,0.56,3.9,6,7,5,4,0
2,1,2,0,1,1,1,21.67,1.8,70.2,0.01,13,0.56,3.9,6,7,5,4,0
2,1,2,0,1,1,1,21.67,1.8,70.2,0.01,13,0.56,3.9,6,7,5,4,0
2,1,2,0,1,1,1,21.67,1.8,70.2,0.01,13,0.56,3.9,6,7,5,4,0
2,1,2,0,1,1,1,21.67,1.8,70.2,0.01,13,0.56,3.9,6,7,5,4,0
2,1,2,0,1,1,1,21.67,1.8,70.2,0.01,13,0.56,3.9,6,7,5,4,0
8,3,2,0,2,1,1,13.33,8.0,852.85,0.04,28,0.13,47.38,12,16,6,10,0
5,1,0,3,1,1,1,37.57,5.85,1283.91,0.07,50,0.17,71.33,19,31,13,5,0
7,1,0,0,1,1,1,19.72,7.88,1223.17,0.05,38,0.13,67.95,14,24,8,7,0
10,3,2,0,2,1,1,10.97,11.67,1493.33,0.04,32,0.09,82.96,14,18,6,12,0
7,1,0,4,1,1,1,22.64,7.0,1109.2,0.05,38,0.14,61.62,14,24,9,7,0
1,1,0,0,1,1,1,0.0,0.0,0.0,0.0,1,0.0,0.0,0,1,0,1,0
1,1,0,0,1,1,1,0.0,0.0,0.0,0.0,1,0.0,0.0,0,1,0,1,0
0,1,0,0,1,1,1,5.33,1.5,12.0,0.0,4,0.67,0.67,1,3,1,0,0
5,1,0,0,1,1,1,21.25,2.4,122.4,0.02,17,0.42,6.8,8,9,5,5,0
5,1,0,0,1,1,1,21.25,2.4,122.4,0.02,17,0.42,6.8,8,9,5,5,0
4,1,0,0,1,1,1,10.24,7.0,501.89,0.02,20,0.14,27.88,7,13,4,4,0
4,1,0,0,1,1,1,10.24,7.0,501.89,0.02,20,0.14,27.88,7,13,4,4,0
4,3,0,0,2,2,1,21.5,7.15,1099.18,0.05,35,0.14,61.07,13,22,10,4,0
4,3,0,0,2,2,1,21.5,7.15,1099.18,0.05,35,0.14,61.07,13,22,10,4,0
8,3,0,0,2,2,1,23.46,10.29,2485.24,0.08,52,0.1,138.07,19,33,12,8,0
8,3,0,0,2,2,1,23.46,10.29,2485.24,0.08,52,0.1,138.07,19,33,12,8,0
54,13,1,8,7,6,6,25.11,40.0,40181.42,0.33,184,0.03,2232.3,80,104,22,55,0
54,13,1,8,7,6,6,25.11,40.0,40181.42,0.33,184,0.03,2232.3,80,104,22,55,0
0,1,0,0,1,1,1,8.3,6.67,369.01,0.02,16,0.15,20.5,5,11,3,0,0
0,1,0,0,1,1,1,8.3,6.67,369.01,0.02,16,0.15,20.5,5,11,3,0,0
23,5,0,1,3,2,1,19.78,20.04,7940.87,0.13,80,0.05,441.16,33,47,14,23,0
23,5,0,1,3,2,1,19.78,20.04,7940.87,0.13,80,0.05,441.16,33,47,14,23,0
0,1,0,0,1,1,1,8.6,7.5,483.97,0.02,18,0.13,26.89,5,13,3,0,0
0,1,0,0,1,1,1,8.6,7.5,483.97,0.02,18,0.13,26.89,5,13,3,0,0
19,5,0,3,3,3,1,20.96,10.5,2310.82,0.07,48,0.1,128.38,21,27,12,19,0
19,5,0,3,3,3,1,19.07,10.91,2270.01,0.07,46,0.09,126.11,20,26,11,19,0
12,3,0,2,2,2,1,14.73,8.94,1176.94,0.04,31,0.11,65.39,13,18,8,12,0
12,3,0,2,2,2,1,16.67,8.56,1220.22,0.05,33,0.12,67.79,14,19,9,12,0
12,9,0,0,5,3,3,17.46,16.55,4779.2,0.1,63,0.06,265.51,28,35,11,12,0
12,9,0,0,5,3,3,17.46,16.55,4779.2,0.1,63,0.06,265.51,28,35,11,12,0
4,1,0,0,1,1,1,9.47,2.67,67.38,0.01,9,0.38,3.74,4,5,3,4,0
4,1,0,0,1,1,1,9.47,2.67,67.38,0.01,9,0.38,3.74,4,5,3,4,0
13,5,0,0,3,3,1,16.4,7.07,820.29,0.04,29,0.14,45.57,11,18,7,13,0
13,5,0,0,3,3,1,16.4,7.07,820.29,0.04,29,0.14,45.57,11,18,7,13,0
13,5,0,0,3,3,1,17.24,7.5,969.51,0.04,31,0.13,53.86,12,19,8,13,0
13,5,0,0,3,3,1,17.24,7.5,969.51,0.04,31,0.13,53.86,12,19,8,13,0
4,3,0,0,2,2,1,11.99,6.67,533.03,0.03,21,0.15,29.61,10,11,6,4,0
4,3,0,0,2,2,1,11.99,6.67,533.03,0.03,21,0.15,29.61,10,11,6,4,0
0,1,0,0,1,1,1,6.55,3.0,58.95,0.01,7,0.33,3.28,1,6,1,0,0
0,3,0,0,2,2,1,6.69,7.5,376.42,0.02,14,0.13,20.91,5,9,3,0,0
0,1,0,0,1,1,1,7.86,2.5,49.13,0.01,7,0.4,2.73,2,5,2,0,0
0,3,0,0,2,2,1,9.32,5.0,233.02,0.02,13,0.2,12.95,5,8,4,0,0
0,1,0,0,1,1,1,6.55,3.0,58.95,0.01,7,0.33,3.28,1,6,1,0,0
0,3,0,0,2,2,1,6.69,7.5,376.42,0.02,14,0.13,20.91,5,9,3,0,0
0,1,0,0,1,1,1,7.86,2.5,49.13,0.01,7,0.4,2.73,2,5,2,0,0
0,3,0,0,2,2,1,9.32,5.0,233.02,0.02,13,0.2,12.95,5,8,4,0,0
6,1,0,0,1,1,1,17.51,5.0,437.85,0.03,23,0.2,24.32,10,13,7,6,0
6,1,0,0,1,1,1,17.51,5.0,437.85,0.03,23,0.2,24.32,10,13,7,6,0
0,3,0,0,2,2,1,7.75,2.0,31.02,0.01,6,0.5,1.72,2,4,2,0,0
0,3,0,0,2,2,1,7.75,2.0,31.02,0.01,6,0.5,1.72,2,4,2,0,0
0,3,0,0,2,2,1,7.86,2.5,49.13,0.01,7,0.4,2.73,2,5,2,0,0
0,3,0,0,2,2,1,7.86,2.5,49.13,0.01,7,0.4,2.73,2,5,2,0,0
11,7,0,0,4,2,3,12.35,16.0,3162.47,0.07,45,0.06,175.69,16,29,7,11,0
11,7,0,0,4,2,3,12.35,16.0,3162.47,0.07,45,0.06,175.69,16,29,7,11,0
3,3,0,0,2,2,1,14.28,4.0,228.44,0.02,15,0.25,12.69,6,9,6,3,0
3,3,0,0,2,2,1,14.28,4.0,228.44,0.02,15,0.25,12.69,6,9,6,3,0
0,1,0,0,1,1,1,0.0,0.0,0.0,0.0,1,0.0,0.0,0,1,0,0,0
0,1,0,0,1,1,1,0.0,0.0,0.0,0.0,1,0.0,0.0,0,1,0,0,0
2,1,0,0,1,1,1,13.5,2.0,54.0,0.01,9,0.5,3.0,4,5,4,2,0
2,1,0,0,1,1,1,13.5,2.0,54.0,0.01,9,0.5,3.0,4,5,4,2,0
0,1,0,0,1,1,1,7.75,2.0,31.02,0.01,6,0.5,1.72,2,4,2,0,0
0,1,0,0,1,1,1,7.75,2.0,31.02,0.01,6,0.5,1.72,2,4,2,0,0
0,1,0,0,1,1,1,7.75,2.0,31.02,0.01,6,0.5,1.72,2,4,2,0,0
0,1,0,0,1,1,1,7.75,2.0,31.02,0.01,6,0.5,1.72,2,4,2,0,0
0,1,0,0,1,1,1,7.75,2.0,31.02,0.01,6,0.5,1.72,2,4,2,0,0
0,1,0,0,1,1,1,7.75,2.0,31.02,0.01,6,0.5,1.72,2,4,2,0,0
0,1,0,0,1,1,1,7.74,1.5,17.41,0.0,5,0.67,0.97,2,3,2,0,0
0,1,0,0,1,1,1,7.74,1.5,17.41,0.0,5,0.67,0.97,2,3,2,0,0
1,1,0,0,1,1,1,7.74,1.5,17.41,0.0,5,0.67,0.97,2,3,2,1,0
1,1,0,0,1,1,1,7.74,1.5,17.41,0.0,5,0.67,0.97,2,3,2,1,0
0,1,0,0,1,1,1,5.8,2.0,23.22,0.0,5,0.5,1.29,1,4,1,0,0
0,1,0,0,1,1,1,5.8,2.0,23.22,0.0,5,0.5,1.29,1,4,1,0,0
2,1,0,0,1,1,1,7.75,2.0,31.02,0.01,6,0.5,1.72,2,4,2,2,0
2,1,0,0,1,1,1,7.75,2.0,31.02,0.01,6,0.5,1.72,2,4,2,2,0
1,1,0,1,1,1,1,0.0,0.0,0.0,0.0,1,0.0,0.0,0,1,0,1,0
1,1,0,1,1,1,1,0.0,0.0,0.0,0.0,1,0.0,0.0,0,1,0,1,0
2,1,0,0,1,1,1,7.75,2.0,31.02,0.01,6,0.5,1.72,2,4,2,2,0
2,1,0,0,1,1,1,7.75,2.0,31.02,0.01,6,0.5,1.72,2,4,2,2,0
0,1,0,0,1,1,1,9.31,2.5,58.16,0.01,9,0.4,3.23,1,8,1,0,0
0,1,0,0,1,1,1,9.31,2.5,58.16,0.01,9,0.4,3.23,1,8,1,0,0
0,1,0,0,1,1,1,7.75,2.0,31.02,0.01,6,0.5,1.72,2,4,2,0,0
0,1,0,0,1,1,1,7.75,2.0,31.02,0.01,6,0.5,1.72,2,4,2,0,0
0,1,0,0,1,1,1,10.68,4.67,232.53,0.02,15,0.21,12.92,4,11,3,0,0
0,1,0,0,1,1,1,10.68,4.67,232.53,0.02,15,0.21,12.92,4,11,3,0,0
7,5,0,0,3,2,1,11.89,13.13,2048.55,0.05,35,0.08,113.81,15,20,8,7,0
7,5,0,0,3,2,1,11.89,13.13,2048.55,0.05,35,0.08,113.81,15,20,8,7,0
5,3,0,0,2,2,1,17.22,4.08,287.09,0.02,19,0.24,15.95,7,12,6,5,0
5,3,0,0,2,2,1,17.22,4.08,287.09,0.02,19,0.24,15.95,7,12,6,5,0
4,3,0,0,2,2,1,11.18,5.63,353.85,0.02,17,0.18,19.66,5,12,4,4,0
4,3,0,0,2,2,1,11.18,5.63,353.85,0.02,17,0.18,19.66,5,12,4,4,0
0,1,0,0,1,1,1,0.0,0.0,0.0,0.0,0,0.0,0.0,0,0,0,0,0
0,1,0,0,1,1,1,0.0,0.0,0.0,0.0,0,0.0,0.0,0,0,0,0,0
0,1,0,0,1,1,1,6.2,2.5,38.77,0.01,6,0.4,2.15,1,5,1,0,0
0,1,0,0,1,1,1,6.2,2.5,38.77,0.01,6,0.4,2.15,1,5,1,0,0
0,1,0,0,1,1,1,0.0,0.0,0.0,0.0,3,0.0,0.0,0,3,0,0,0
0,1,0,0,1,1,1,0.0,0.0,0.0,0.0,3,0.0,0.0,0,3,0,0,0
0,1,0,0,1,1,1,0.0,0.0,0.0,0.0,2,0.0,0.0,0,2,0,0,0
0,1,0,0,1,1,1,0.0,0.0,0.0,0.0,2,0.0,0.0,0,2,0,0,0
0,1,0,0,1,1,1,5.33,1.5,12.0,0.0,4,0.67,0.67,1,3,1,0,0
0,1,0,0,1,1,1,5.33,1.5,12.0,0.0,4,0.67,0.67,1,3,1,0,0
0,1,0,0,1,1,1,5.33,1.5,12.0,0.0,4,0.67,0.67,1,3,1,0,0
0,1,0,0,1,1,1,5.33,1.5,12.0,0.0,4,0.67,0.67,1,3,1,0,0
0,1,0,0,1,1,1,11.86,3.5,145.3,0.01,12,0.29,8.07,4,8,4,0,0
0,1,0,0,1,1,1,11.86,3.5,145.3,0.01,12,0.29,8.07,4,8,4,0,0
0,1,0,0,1,1,1,0.0,0.0,0.0,0.0,0,0.0,0.0,0,0,0,0,0
0,1,0,0,1,1,1,0.0,0.0,0.0,0.0,0,0.0,0.0,0,0,0,0,0
0,1,0,0,1,1,1,0.0,0.0,0.0,0.0,0,0.0,0.0,0,0,0,0,0
0,1,0,0,1,1,1,0.0,0.0,0.0,0.0,0,0.0,0.0,0,0,0,0,0
0,1,0,0,1,1,1,0.0,0.0,0.0,0.0,0,0.0,0.0,0,0,0,0,0
0,1,0,0,1,1,1,0.0,0.0,0.0,0.0,0,0.0,0.0,0,0,0,0,0
0,1,0,0,1,1,1,0.0,0.0,0.0,0.0,1,0.0,0.0,0,1,0,0,0
0,1,0,0,1,1,1,0.0,0.0,0.0,0.0,1,0.0,0.0,0,1,0,0,0
0,1,0,0,1,1,1,7.33,4.5,148.5,0.01,11,0.22,8.25,3,8,2,0,0
0,1,0,0,1,1,1,7.33,4.5,148.5,0.01,11,0.22,8.25,3,8,2,0,0
8,3,0,0,2,1,1,15.07,9.75,1432.72,0.05,34,0.1,79.6,13,21,8,8,0
8,3,0,0,2,1,1,15.07,9.75,1432.72,0.05,34,0.1,79.6,13,21,8,8,0
0,1,0,0,1,1,1,7.74,1.5,17.41,0.0,5,0.67,0.97,2,3,2,0,0
0,1,0,0,1,1,1,7.74,1.5,17.41,0.0,5,0.67,0.97,2,3,2,0,0
0,1,0,0,1,1,1,9.6,2.5,60.0,0.01,8,0.4,3.33,3,5,3,0,0
0,1,0,0,1,1,1,9.6,2.5,60.0,0.01,8,0.4,3.33,3,5,3,0,0
0,1,0,0,1,1,1,7.75,2.0,31.02,0.01,6,0.5,1.72,2,4,2,0,0
0,1,0,0,1,1,1,7.75,2.0,31.02,0.01,6,0.5,1.72,2,4,2,0,0
0,1,0,0,1,1,1,6.86,3.5,84.0,0.01,8,0.29,4.67,1,7,1,0,0
0,1,0,0,1,1,1,6.86,3.5,84.0,0.01,8,0.29,4.67,1,7,1,0,0
0,1,0,0,1,1,1,7.74,1.5,17.41,0.0,5,0.67,0.97,2,3,2,0,0
0,1,0,0,1,1,1,7.74,1.5,17.41,0.0,5,0.67,0.97,2,3,2,0,0
0,1,0,0,1,1,1,7.75,2.0,31.02,0.01,6,0.5,1.72,2,4,2,0,0
0,1,0,0,1,1,1,7.75,2.0,31.02,0.01,6,0.5,1.72,2,4,2,0,0
0,1,0,0,1,1,1,8.3,6.0,298.97,0.02,15,0.17,16.61,3,12,2,0,0
0,1,0,0,1,1,1,8.3,6.0,298.97,0.02,15,0.17,16.61,3,12,2,0,0
0,1,0,0,1,1,1,8.3,6.0,298.97,0.02,15,0.17,16.61,3,12,2,0,0
0,1,0,0,1,1,1,8.3,6.0,298.97,0.02,15,0.17,16.61,3,12,2,0,0
0,1,0,0,1,1,1,8.3,6.0,298.97,0.02,15,0.17,16.61,3,12,2,0,0
0,1,0,0,1,1,1,8.3,6.0,298.97,0.02,15,0.17,16.61,3,12,2,0,0
0,1,0,0,1,1,1,5.33,1.5,12.0,0.0,4,0.67,0.67,1,3,1,0,0
0,1,0,0,1,1,1,5.33,1.5,12.0,0.0,4,0.67,0.67,1,3,1,0,0
0,1,0,0,1,1,1,5.33,1.5,12.0,0.0,4,0.67,0.67,1,3,1,0,0
0,1,0,0,1,1,1,5.33,1.5,12.0,0.0,4,0.67,0.67,1,3,1,0,0
0,1,0,0,1,1,1,5.33,1.5,12.0,0.0,4,0.67,0.67,1,3,1,0,0
0,1,0,0,1,1,1,5.33,1.5,12.0,0.0,4,0.67,0.67,1,3,1,0,0
0,1,0,0,1,1,1,5.33,1.5,12.0,0.0,4,0.67,0.67,1,3,1,0,0
0,1,0,0,1,1,1,5.33,1.5,12.0,0.0,4,0.67,0.67,1,3,1,0,0
0,1,0,0,1,1,1,5.33,1.5,12.0,0.0,4,0.67,0.67,1,3,1,0,0
0,1,0,0,1,1,1,5.33,1.5,12.0,0.0,4,0.67,0.67,1,3,1,0,0
0,1,0,0,1,1,1,5.33,1.5,12.0,0.0,4,0.67,0.67,1,3,1,0,0
0,1,0,0,1,1,1,5.33,1.5,12.0,0.0,4,0.67,0.67,1,3,1,0,0
0,1,0,0,1,1,1,5.33,1.5,12.0,0.0,4,0.67,0.67,1,3,1,0,0
0,1,0,0,1,1,1,5.33,1.5,12.0,0.0,4,0.67,0.67,1,3,1,0,0
0,1,0,0,1,1,1,5.33,1.5,12.0,0.0,4,0.67,0.67,1,3,1,0,0
0,1,0,0,1,1,1,5.33,1.5,12.0,0.0,4,0.67,0.67,1,3,1,0,0
0,1,0,0,1,1,1,5.33,1.5,12.0,0.0,4,0.67,0.67,1,3,1,0,0
0,1,0,0,1,1,1,5.33,1.5,12.0,0.0,4,0.67,0.67,1,3,1,0,0
0,1,0,0,1,1,1,5.33,1.5,12.0,0.0,4,0.67,0.67,1,3,1,0,0
0,1,0,0,1,1,1,5.33,1.5,12.0,0.0,4,0.67,0.67,1,3,1,0,0
0,1,0,0,1,1,1,5.33,1.5,12.0,0.0,4,0.67,0.67,1,3,1,0,0
0,1,0,0,1,1,1,5.33,1.5,12.0,0.0,4,0.67,0.67,1,3,1,0,0
0,1,0,0,1,1,1,5.33,1.5,12.0,0.0,4,0.67,0.67,1,3,1,0,0
0,1,0,0,1,1,1,7.75,2.0,31.02,0.01,6,0.5,1.72,2,4,2,0,0
0,1,0,0,1,1,1,7.75,2.0,31.02,0.01,6,0.5,1.72,2,4,2,0,0
0,1,0,0,1,1,1,7.75,2.0,31.02,0.01,6,0.5,1.72,2,4,2,0,0
0,1,0,0,1,1,1,7.75,2.0,31.02,0.01,6,0.5,1.72,2,4,2,0,0
0,1,0,0,1,1,1,7.75,2.0,31.02,0.01,6,0.5,1.72,2,4,2,0,0
0,1,0,0,1,1,1,7.75,2.0,31.02,0.01,6,0.5,1.72,2,4,2,0,0
0,1,0,0,1,1,1,7.75,2.0,31.02,0.01,6,0.5,1.72,2,4,2,0,0
0,1,0,0,1,1,1,7.75,2.0,31.02,0.01,6,0.5,1.72,2,4,2,0,0
0,1,0,0,1,1,1,7.74,1.5,17.41,0.0,5,0.67,0.97,2,3,2,0,0
0,1,0,0,1,1,1,7.74,1.5,17.41,0.0,5,0.67,0.97,2,3,2,0,0
0,1,0,0,1,1,1,5.33,1.5,12.0,0.0,4,0.67,0.67,1,3,1,0,0
0,1,0,0,1,1,1,5.33,1.5,12.0,0.0,4,0.67,0.67,1,3,1,0,0
0,3,0,0,2,1,1,7.75,2.0,31.02,0.01,6,0.5,1.72,2,4,2,0,0
0,3,0,0,2,1,1,7.75,2.0,31.02,0.01,6,0.5,1.72,2,4,2,0,0
0,1,0,0,1,1,1,5.8,2.0,23.22,0.0,5,0.5,1.29,1,4,1,0,0
0,1,0,0,1,1,1,5.8,2.0,23.22,0.0,5,0.5,1.29,1,4,1,0,0
0,3,0,0,2,1,1,7.75,2.0,31.02,0.01,6,0.5,1.72,2,4,2,0,0
0,3,0,0,2,1,1,7.75,2.0,31.02,0.01,6,0.5,1.72,2,4,2,0,0
0,1,0,0,1,1,1,12.18,3.0,109.62,0.01,11,0.33,6.09,4,7,4,0,0
0,1,0,0,1,1,1,12.18,3.0,109.62,0.01,11,0.33,6.09,4,7,4,0,0
0,1,0,0,1,1,1,7.75,2.0,31.02,0.01,6,0.5,1.72,2,4,2,0,0
0,1,0,0,1,1,1,7.75,2.0,31.02,0.01,6,0.5,1.72,2,4,2,0,0
0,1,0,0,1,1,1,7.75,2.0,31.02,0.01,6,0.5,1.72,2,4,2,0,0
0,1,0,0,1,1,1,7.75,2.0,31.02,0.01,6,0.5,1.72,2,4,2,0,0
0,1,0,0,1,1,1,7.75,2.0,31.02,0.01,6,0.5,1.72,2,4,2,0,0
0,1,0,0,1,1,1,7.75,2.0,31.02,0.01,6,0.5,1.72,2,4,2,0,0
0,1,0,0,1,1,1,5.8,2.0,23.22,0.0,5,0.5,1.29,1,4,1,0,0
0,1,0,0,1,1,1,5.8,2.0,23.22,0.0,5,0.5,1.29,1,4,1,0,0
0,1,0,0,1,1,1,7.75,2.0,31.02,0.01,6,0.5,1.72,2,4,2,0,0
0,1,0,0,1,1,1,7.75,2.0,31.02,0.01,6,0.5,1.72,2,4,2,0,0
2,1,0,0,1,1,1,8.98,2.5,56.15,0.01,8,0.4,3.12,2,6,2,2,0
2,1,0,0,1,1,1,8.98,2.5,56.15,0.01,8,0.4,3.12,2,6,2,2,0
2,1,0,0,1,1,1,5.33,1.5,12.0,0.0,4,0.67,0.67,1,3,1,2,0
2,1,0,0,1,1,1,5.33,1.5,12.0,0.0,4,0.67,0.67,1,3,1,2,0
0,1,0,0,1,1,1,5.33,1.5,12.0,0.0,4,0.67,0.67,1,3,1,0,0
0,1,0,0,1,1,1,5.33,1.5,12.0,0.0,4,0.67,0.67,1,3,1,0,0
2,1,0,0,1,1,1,5.33,1.5,12.0,0.0,4,0.67,0.67,1,3,1,2,0
2,1,0,0,1,1,1,5.33,1.5,12.0,0.0,4,0.67,0.67,1,3,1,2,0
2,1,0,0,1,1,1,5.33,1.5,12.0,0.0,4,0.67,0.67,1,3,1,2,0
2,1,0,0,1,1,1,5.33,1.5,12.0,0.0,4,0.67,0.67,1,3,1,2,0
3,1,0,0,1,1,1,12.0,2.5,75.0,0.01,10,0.4,4.17,3,7,3,3,0
3,1,0,0,1,1,1,12.0,2.5,75.0,0.01,10,0.4,4.17,3,7,3,3,0
0,1,0,0,1,1,1,7.86,2.5,49.13,0.01,7,0.4,2.73,2,5,2,0,0
0,1,0,0,1,1,1,7.86,2.5,49.13,0.01,7,0.4,2.73,2,5,2,0,0
0,1,0,0,1,1,1,6.55,3.0,58.95,0.01,7,0.33,3.28,1,6,1,0,0
0,1,0,0,1,1,1,6.55,3.0,58.95,0.01,7,0.33,3.28,1,6,1,0,0
0,1,0,0,1,1,1,6.55,3.0,58.95,0.01,7,0.33,3.28,1,6,1,0,0
0,1,0,0,1,1,1,6.55,3.0,58.95,0.01,7,0.33,3.28,1,6,1,0,0
2,1,0,0,1,1,1,8.98,2.5,56.15,0.01,8,0.4,3.12,2,6,2,2,0
2,1,0,0,1,1,1,8.98,2.5,56.15,0.01,8,0.4,3.12,2,6,2,2,0
2,1,0,0,1,1,1,5.33,1.5,12.0,0.0,4,0.67,0.67,1,3,1,2,0
2,1,0,0,1,1,1,5.33,1.5,12.0,0.0,4,0.67,0.67,1,3,1,2,0
0,1,0,0,1,1,1,5.33,1.5,12.0,0.0,4,0.67,0.67,1,3,1,0,0
0,1,0,0,1,1,1,5.33,1.5,12.0,0.0,4,0.67,0.67,1,3,1,0,0
2,1,0,0,1,1,1,5.33,1.5,12.0,0.0,4,0.67,0.67,1,3,1,2,0
2,1,0,0,1,1,1,5.33,1.5,12.0,0.0,4,0.67,0.67,1,3,1,2,0
2,1,0,0,1,1,1,5.33,1.5,12.0,0.0,4,0.67,0.67,1,3,1,2,0
2,1,0,0,1,1,1,5.33,1.5,12.0,0.0,4,0.67,0.67,1,3,1,2,0
0,1,0,0,1,1,1,5.33,1.5,12.0,0.0,4,0.67,0.67,1,3,1,0,0
0,1,0,0,1,1,1,5.33,1.5,12.0,0.0,4,0.67,0.67,1,3,1,0,0
0,1,0,0,1,1,1,5.33,1.5,12.0,0.0,4,0.67,0.67,1,3,1,0,0
0,1,0,0,1,1,1,5.33,1.5,12.0,0.0,4,0.67,0.67,1,3,1,0,0
0,1,0,0,1,1,1,7.86,2.5,49.13,0.01,7,0.4,2.73,2,5,2,0,0
0,1,0,0,1,1,1,7.86,2.5,49.13,0.01,7,0.4,2.73,2,5,2,0,0
0,1,0,0,1,1,1,0.0,0.0,0.0,0.0,3,0.0,0.0,0,3,0,0,0
0,1,0,0,1,1,1,0.0,0.0,0.0,0.0,3,0.0,0.0,0,3,0,0,0
0,1,0,0,1,1,1,7.75,2.0,31.02,0.01,6,0.5,1.72,2,4,2,0,0
0,1,0,0,1,1,1,7.75,2.0,31.02,0.01,6,0.5,1.72,2,4,2,0,0
0,1,0,0,1,1,1,9.0,3.0,81.0,0.01,9,0.33,4.5,2,7,2,0,0
0,1,0,0,1,1,1,9.0,3.0,81.0,0.01,9,0.33,4.5,2,7,2,0,0
0,1,0,0,1,1,1,8.3,6.0,298.97,0.02,15,0.17,16.61,3,12,2,0,0
0,1,0,0,1,1,1,8.3,6.0,298.97,0.02,15,0.17,16.61,3,12,2,0,0
0,1,0,0,1,1,1,7.74,1.5,17.41,0.0,5,0.67,0.97,2,3,2,0,0
0,1,0,0,1,1,1,7.74,1.5,17.41,0.0,5,0.67,0.97,2,3,2,0,0
0,1,0,0,1,1,1,7.74,1.5,17.41,0.0,5,0.67,0.97,2,3,2,0,0
0,1,0,0,1,1,1,7.74,1.5,17.41,0.0,5,0.67,0.97,2,3,2,0,0
0,1,0,0,1,1,1,7.74,1.5,17.41,0.0,5,0.67,0.97,2,3,2,0,0
0,1,0,0,1,1,1,7.74,1.5,17.41,0.0,5,0.67,0.97,2,3,2,0,0
0,1,0,0,1,1,1,7.74,1.5,17.41,0.0,5,0.67,0.97,2,3,2,0,0
0,1,0,0,1,1,1,7.74,1.5,17.41,0.0,5,0.67,0.97,2,3,2,0,0
0,1,0,0,1,1,1,7.74,1.5,17.41,0.0,5,0.67,0.97,2,3,2,0,0
0,1,0,0,1,1,1,7.74,1.5,17.41,0.0,5,0.67,0.97,2,3,2,0,0
0,1,0,0,1,1,1,7.74,1.5,17.41,0.0,5,0.67,0.97,2,3,2,0,0
0,1,0,0,1,1,1,7.74,1.5,17.41,0.0,5,0.67,0.97,2,3,2,0,0
0,1,0,0,1,1,1,7.74,1.5,17.41,0.0,5,0.67,0.97,2,3,2,0,0
0,1,0,0,1,1,1,7.74,1.5,17.41,0.0,5,0.67,0.97,2,3,2,0,0
0,1,0,0,1,1,1,9.51,3.0,85.59,0.01,9,0.33,4.75,3,6,3,0,0
0,1,0,0,1,1,1,9.51,3.0,85.59,0.01,9,0.33,4.75,3,6,3,0,0
0,1,0,0,1,1,1,9.51,3.0,85.59,0.01,9,0.33,4.75,3,6,3,0,0
0,1,0,0,1,1,1,9.51,3.0,85.59,0.01,9,0.33,4.75,3,6,3,0,0
0,1,0,0,1,1,1,9.51,3.0,85.59,0.01,9,0.33,4.75,3,6,3,0,0
0,1,0,0,1,1,1,9.51,3.0,85.59,0.01,9,0.33,4.75,3,6,3,0,0
0,1,0,0,1,1,1,9.51,3.0,85.59,0.01,9,0.33,4.75,3,6,3,0,0
0,1,0,0,1,1,1,9.51,3.0,85.59,0.01,9,0.33,4.75,3,6,3,0,0
4,3,0,0,2,2,1,13.67,6.0,492.27,0.03,21,0.17,27.35,6,15,5,4,0
4,3,0,0,2,2,1,13.67,6.0,492.27,0.03,21,0.17,27.35,6,15,5,4,0
0,1,0,0,1,1,1,7.74,1.5,17.41,0.0,5,0.67,0.97,2,3,2,0,0
0,1,0,0,1,1,1,7.74,1.5,17.41,0.0,5,0.67,0.97,2,3,2,0,0
0,1,0,0,1,1,1,5.33,1.5,12.0,0.0,4,0.67,0.67,1,3,1,0,0
0,1,0,0,1,1,1,5.33,1.5,12.0,0.0,4,0.67,0.67,1,3,1,0,0
136,55,0,6,28,15,8,84.51,60.03,304502.05,1.69,751,0.02,16916.78,343,408,80,136,0
136,55,0,6,28,15,8,84.51,60.03,304502.05,1.69,751,0.02,16916.78,343,408,80,136,0
3,1,0,0,1,1,1,9.51,3.0,85.59,0.01,9,0.33,4.75,3,6,3,3,0
3,1,0,0,1,1,1,9.51,3.0,85.59,0.01,9,0.33,4.75,3,6,3,3,0
5,3,0,0,2,2,1,15.36,3.5,188.21,0.02,15,0.29,10.46,5,10,5,5,0
5,3,0,0,2,2,1,15.36,3.5,188.21,0.02,15,0.29,10.46,5,10,5,5,0
4,3,0,0,2,2,1,10.88,5.6,341.29,0.02,17,0.18,18.96,8,9,5,4,0
4,3,0,0,2,2,1,10.88,5.6,341.29,0.02,17,0.18,18.96,8,9,5,4,0
0,1,0,0,1,1,1,7.74,1.5,17.41,0.0,5,0.67,0.97,2,3,2,0,0
0,1,0,0,1,1,1,7.74,1.5,17.41,0.0,5,0.67,0.97,2,3,2,0,0
2,1,0,0,1,1,1,7.35,8.0,470.48,0.02,17,0.13,26.14,6,11,3,2,0
0,1,0,0,1,1,1,12.68,2.5,79.25,0.01,10,0.4,4.4,4,6,4,0,0
0,1,0,0,1,1,1,12.68,2.5,79.25,0.01,10,0.4,4.4,4,6,4,0,0
0,1,0,0,1,1,1,7.74,1.5,17.41,0.0,5,0.67,0.97,2,3,2,0,0
0,1,0,0,1,1,1,7.74,1.5,17.41,0.0,5,0.67,0.97,2,3,2,0,0
0,1,0,0,1,1,1,7.75,2.0,31.02,0.01,6,0.5,1.72,2,4,2,0,0
0,1,0,0,1,1,1,7.75,2.0,31.02,0.01,6,0.5,1.72,2,4,2,0,0
0,1,0,0,1,1,1,7.75,2.0,31.02,0.01,6,0.5,1.72,2,4,2,0,0
0,1,0,0,1,1,1,7.75,2.0,31.02,0.01,6,0.5,1.72,2,4,2,0,0
0,1,0,0,1,1,1,7.75,2.0,31.02,0.01,6,0.5,1.72,2,4,2,0,0
0,1,0,0,1,1,1,7.75,2.0,31.02,0.01,6,0.5,1.72,2,4,2,0,0
0,1,0,0,1,1,1,7.75,2.0,31.02,0.01,6,0.5,1.72,2,4,2,0,0
0,1,0,0,1,1,1,7.75,2.0,31.02,0.01,6,0.5,1.72,2,4,2,0,0
2,1,0,0,1,1,1,7.81,9.0,632.78,0.02,19,0.11,35.15,8,11,4,2,0
1,1,0,0,1,1,1,0.0,0.0,0.0,0.0,1,0.0,0.0,0,1,0,1,0
1,1,0,0,1,1,1,0.0,0.0,0.0,0.0,1,0.0,0.0,0,1,0,1,0
0,1,0,0,1,1,1,0.0,0.0,0.0,0.0,3,0.0,0.0,0,3,0,0,0
0,1,0,0,1,1,1,0.0,0.0,0.0,0.0,2,0.0,0.0,0,2,0,0,0
0,1,0,0,1,1,1,5.33,1.5,12.0,0.0,4,0.67,0.67,1,3,1,0,0
0,1,0,0,1,1,1,5.33,1.5,12.0,0.0,4,0.67,0.67,1,3,1,0,0
0,1,0,0,1,1,1,0.0,0.0,0.0,0.0,1,0.0,0.0,0,1,0,0,0
1,1,0,0,1,1,1,0.0,0.0,0.0,0.0,1,0.0,0.0,0,1,0,1,0
1,1,0,0,1,1,1,0.0,0.0,0.0,0.0,1,0.0,0.0,0,1,0,1,0
0,1,0,0,1,1,1,7.74,1.5,17.41,0.0,5,0.67,0.97,2,3,2,0,0
10,1,0,1,1,1,1,47.04,4.15,811.68,0.07,46,0.24,45.09,18,28,13,10,0
10,1,0,1,1,1,1,47.04,4.15,811.68,0.07,46,0.24,45.09,18,28,13,10,0
0,1,0,0,1,1,1,7.74,1.5,17.41,0.0,5,0.67,0.97,2,3,2,0,0
0,1,0,0,1,1,1,5.33,1.5,12.0,0.0,4,0.67,0.67,1,3,1,0,0
0,1,0,0,1,1,1,5.33,1.5,12.0,0.0,4,0.67,0.67,1,3,1,0,0
0,1,0,0,1,1,1,5.33,1.5,12.0,0.0,4,0.67,0.67,1,3,1,0,0
0,1,0,0,1,1,1,5.33,1.5,12.0,0.0,4,0.67,0.67,1,3,1,0,0
0,1,0,0,1,1,1,5.33,1.5,12.0,0.0,4,0.67,0.67,1,3,1,0,0
0,1,0,0,1,1,1,5.33,1.5,12.0,0.0,4,0.67,0.67,1,3,1,0,0
0,1,0,0,1,1,1,5.33,1.5,12.0,0.0,4,0.67,0.67,1,3,1,0,0
0,1,0,0,1,1,1,5.33,1.5,12.0,0.0,4,0.67,0.67,1,3,1,0,0
0,1,0,0,1,1,1,5.33,1.5,12.0,0.0,4,0.67,0.67,1,3,1,0,0
0,1,0,0,1,1,1,5.33,1.5,12.0,0.0,4,0.67,0.67,1,3,1,0,0
0,1,0,0,1,1,1,5.33,1.5,12.0,0.0,4,0.67,0.67,1,3,1,0,0
0,1,0,0,1,1,1,5.33,1.5,12.0,0.0,4,0.67,0.67,1,3,1,0,0
0,1,0,0,1,1,1,7.74,1.5,17.41,0.0,5,0.67,0.97,2,3,2,0,0
0,1,0,0,1,1,1,5.33,1.5,12.0,0.0,4,0.67,0.67,1,3,1,0,0
0,1,0,0,1,1,1,7.86,2.5,49.13,0.01,7,0.4,2.73,2,5,2,0,0
0,1,0,0,1,1,1,0.0,0.0,0.0,0.0,3,0.0,0.0,0,3,0,0,0
0,1,0,0,1,1,1,7.74,1.5,17.41,0.0,5,0.67,0.97,2,3,2,0,0
0,1,0,0,1,1,1,7.74,1.5,17.41,0.0,5,0.67,0.97,2,3,2,0,0
0,1,0,0,1,1,1,7.74,1.5,17.41,0.0,5,0.67,0.97,2,3,2,0,0
0,1,0,0,1,1,1,7.74,1.5,17.41,0.0,5,0.67,0.97,2,3,2,0,0
0,1,0,0,1,1,1,7.74,1.5,17.41,0.0,5,0.67,0.97,2,3,2,0,0
0,1,0,0,1,1,1,7.74,1.5,17.41,0.0,5,0.67,0.97,2,3,2,0,0
0,1,0,0,1,1,1,7.74,1.5,17.41,0.0,5,0.67,0.97,2,3,2,0,0
0,1,0,0,1,1,1,5.33,1.5,12.0,0.0,4,0.67,0.67,1,3,1,0,0
2,1,0,0,1,1,1,7.35,8.0,470.48,0.02,17,0.13,26.14,6,11,3,2,0
2,1,0,0,1,1,1,7.81,9.0,632.78,0.02,19,0.11,35.15,8,11,4,2,0
4,1,0,0,1,1,1,10.24,7.0,501.89,0.02,20,0.14,27.88,7,13,4,4,0
4,3,0,0,2,2,1,21.5,7.15,1099.18,0.05,35,0.14,61.07,13,22,10,4,0
8,3,0,0,2,2,1,23.46,10.29,2485.24,0.08,52,0.1,138.07,19,33,12,8,0
54,13,1,8,7,6,6,25.11,40.0,40181.42,0.33,184,0.03,2232.3,80,104,22,55,0
0,1,0,0,1,1,1,8.3,6.67,369.01,0.02,16,0.15,20.5,5,11,3,0,0
23,5,0,1,3,2,1,19.78,20.04,7940.87,0.13,80,0.05,441.16,33,47,14,23,0
0,1,0,0,1,1,1,8.6,7.5,483.97,0.02,18,0.13,26.89,5,13,3,0,0
19,5,0,3,3,3,1,19.07,10.91,2270.01,0.07,46,0.09,126.11,20,26,11,19,0
19,5,0,3,3,3,1,20.96,10.5,2310.82,0.07,48,0.1,128.38,21,27,12,19,0
12,3,0,2,2,2,1,14.73,8.94,1176.94,0.04,31,0.11,65.39,13,18,8,12,0
12,9,0,0,5,3,3,17.46,16.55,4779.2,0.1,63,0.06,265.51,28,35,11,12,0
4,1,0,0,1,1,1,9.47,2.67,67.38,0.01,9,0.38,3.74,4,5,3,4,0
13,5,0,0,3,3,1,16.4,7.07,820.29,0.04,29,0.14,45.57,11,18,7,13,0
13,5,0,0,3,3,1,17.24,7.5,969.51,0.04,31,0.13,53.86,12,19,8,13,0
4,3,0,0,2,2,1,11.99,6.67,533.03,0.03,21,0.15,29.61,10,11,6,4,0
0,1,0,0,1,1,1,6.55,3.0,58.95,0.01,7,0.33,3.28,1,6,1,0,0
0,3,0,0,2,2,1,6.69,7.5,376.42,0.02,14,0.13,20.91,5,9,3,0,0
0,1,0,0,1,1,1,7.86,2.5,49.13,0.01,7,0.4,2.73,2,5,2,0,0
0,3,0,0,2,2,1,9.32,5.0,233.02,0.02,13,0.2,12.95,5,8,4,0,0
0,1,0,0,1,1,1,6.55,3.0,58.95,0.01,7,0.33,3.28,1,6,1,0,0
0,3,0,0,2,2,1,6.69,7.5,376.42,0.02,14,0.13,20.91,5,9,3,0,0
0,1,0,0,1,1,1,7.86,2.5,49.13,0.01,7,0.4,2.73,2,5,2,0,0
0,3,0,0,2,2,1,9.32,5.0,233.02,0.02,13,0.2,12.95,5,8,4,0,0
6,1,0,0,1,1,1,17.51,5.0,437.85,0.03,23,0.2,24.32,10,13,7,6,0
0,3,0,0,2,2,1,7.75,2.0,31.02,0.01,6,0.5,1.72,2,4,2,0,0
0,3,0,0,2,2,1,7.86,2.5,49.13,0.01,7,0.4,2.73,2,5,2,0,0
11,7,0,0,4,2,3,12.35,16.0,3162.47,0.07,45,0.06,175.69,16,29,7,11,0
3,3,0,0,2,2,1,14.28,4.0,228.44,0.02,15,0.25,12.69,6,9,6,3,0
0,1,0,0,1,1,1,0.0,0.0,0.0,0.0,1,0.0,0.0,0,1,0,0,0
2,1,0,0,1,1,1,13.5,2.0,54.0,0.01,9,0.5,3.0,4,5,4,2,0
0,1,0,0,1,1,1,7.75,2.0,31.02,0.01,6,0.5,1.72,2,4,2,0,0
0,1,0,0,1,1,1,7.75,2.0,31.02,0.01,6,0.5,1.72,2,4,2,0,0
0,1,0,0,1,1,1,7.75,2.0,31.02,0.01,6,0.5,1.72,2,4,2,0,0
0,1,0,0,1,1,1,7.74,1.5,17.41,0.0,5,0.67,0.97,2,3,2,0,0
1,1,0,0,1,1,1,7.74,1.5,17.41,0.0,5,0.67,0.97,2,3,2,1,0
0,1,0,0,1,1,1,5.8,2.0,23.22,0.0,5,0.5,1.29,1,4,1,0,0
2,1,0,0,1,1,1,7.75,2.0,31.02,0.01,6,0.5,1.72,2,4,2,2,0
1,1,0,1,1,1,1,0.0,0.0,0.0,0.0,1,0.0,0.0,0,1,0,1,0
2,1,0,0,1,1,1,7.75,2.0,31.02,0.01,6,0.5,1.72,2,4,2,2,0
0,1,0,0,1,1,1,9.31,2.5,58.16,0.01,9,0.4,3.23,1,8,1,0,0
0,1,0,0,1,1,1,7.75,2.0,31.02,0.01,6,0.5,1.72,2,4,2,0,0
0,1,0,0,1,1,1,10.68,4.67,232.53,0.02,15,0.21,12.92,4,11,3,0,0
7,5,0,0,3,2,1,11.89,13.13,2048.55,0.05,35,0.08,113.81,15,20,8,7,0
7,5,0,0,3,2,1,11.89,13.13,2048.55,0.05,35,0.08,113.81,15,20,8,7,0
5,3,0,0,2,2,1,17.22,4.08,287.09,0.02,19,0.24,15.95,7,12,6,5,0
4,3,0,0,2,2,1,11.18,5.63,353.85,0.02,17,0.18,19.66,5,12,4,4,0
0,1,0,0,1,1,1,0.0,0.0,0.0,0.0,0,0.0,0.0,0,0,0,0,0
0,1,0,0,1,1,1,6.2,2.5,38.77,0.01,6,0.4,2.15,1,5,1,0,0
0,1,0,0,1,1,1,0.0,0.0,0.0,0.0,3,0.0,0.0,0,3,0,0,0
0,1,0,0,1,1,1,0.0,0.0,0.0,0.0,2,0.0,0.0,0,2,0,0,0
0,1,0,0,1,1,1,5.33,1.5,12.0,0.0,4,0.67,0.67,1,3,1,0,0
0,1,0,0,1,1,1,5.33,1.5,12.0,0.0,4,0.67,0.67,1,3,1,0,0
0,1,0,0,1,1,1,11.86,3.5,145.3,0.01,12,0.29,8.07,4,8,4,0,0
0,1,0,0,1,1,1,0.0,0.0,0.0,0.0,0,0.0,0.0,0,0,0,0,0
0,1,0,0,1,1,1,0.0,0.0,0.0,0.0,0,0.0,0.0,0,0,0,0,0
0,1,0,0,1,1,1,0.0,0.0,0.0,0.0,0,0.0,0.0,0,0,0,0,0
0,1,0,0,1,1,1,0.0,0.0,0.0,0.0,1,0.0,0.0,0,1,0,0,0
0,1,0,0,1,1,1,7.33,4.5,148.5,0.01,11,0.22,8.25,3,8,2,0,0
8,3,0,0,2,1,1,15.07,9.75,1432.72,0.05,34,0.1,79.6,13,21,8,8,0
8,3,0,0,2,1,1,15.07,9.75,1432.72,0.05,34,0.1,79.6,13,21,8,8,0
0,1,0,0,1,1,1,7.74,1.5,17.41,0.0,5,0.67,0.97,2,3,2,0,0
0,1,0,0,1,1,1,9.6,2.5,60.0,0.01,8,0.4,3.33,3,5,3,0,0
0,1,0,0,1,1,1,7.75,2.0,31.02,0.01,6,0.5,1.72,2,4,2,0,0
0,1,0,0,1,1,1,7.75,2.0,31.02,0.01,6,0.5,1.72,2,4,2,0,0
0,1,0,0,1,1,1,6.86,3.5,84.0,0.01,8,0.29,4.67,1,7,1,0,0
0,1,0,0,1,1,1,7.74,1.5,17.41,0.0,5,0.67,0.97,2,3,2,0,0
0,1,0,0,1,1,1,7.75,2.0,31.02,0.01,6,0.5,1.72,2,4,2,0,0
0,1,0,0,1,1,1,7.75,2.0,31.02,0.01,6,0.5,1.72,2,4,2,0,0
0,1,0,0,1,1,1,8.3,6.0,298.97,0.02,15,0.17,16.61,3,12,2,0,0
0,1,0,0,1,1,1,8.3,6.0,298.97,0.02,15,0.17,16.61,3,12,2,0,0
0,1,0,0,1,1,1,8.3,6.0,298.97,0.02,15,0.17,16.61,3,12,2,0,0
0,1,0,0,1,1,1,5.33,1.5,12.0,0.0,4,0.67,0.67,1,3,1,0,0
0,1,0,0,1,1,1,5.33,1.5,12.0,0.0,4,0.67,0.67,1,3,1,0,0
0,1,0,0,1,1,1,5.33,1.5,12.0,0.0,4,0.67,0.67,1,3,1,0,0
0,1,0,0,1,1,1,5.33,1.5,12.0,0.0,4,0.67,0.67,1,3,1,0,0
0,1,0,0,1,1,1,5.33,1.5,12.0,0.0,4,0.67,0.67,1,3,1,0,0
0,1,0,0,1,1,1,5.33,1.5,12.0,0.0,4,0.67,0.67,1,3,1,0,0
0,1,0,0,1,1,1,5.33,1.5,12.0,0.0,4,0.67,0.67,1,3,1,0,0
0,1,0,0,1,1,1,5.33,1.5,12.0,0.0,4,0.67,0.67,1,3,1,0,0
0,1,0,0,1,1,1,5.33,1.5,12.0,0.0,4,0.67,0.67,1,3,1,0,0
0,1,0,0,1,1,1,5.33,1.5,12.0,0.0,4,0.67,0.67,1,3,1,0,0
0,1,0,0,1,1,1,5.33,1.5,12.0,0.0,4,0.67,0.67,1,3,1,0,0
0,1,0,0,1,1,1,5.33,1.5,12.0,0.0,4,0.67,0.67,1,3,1,0,0
0,1,0,0,1,1,1,7.75,2.0,31.02,0.01,6,0.5,1.72,2,4,2,0,0
0,1,0,0,1,1,1,7.75,2.0,31.02,0.01,6,0.5,1.72,2,4,2,0,0
0,1,0,0,1,1,1,7.75,2.0,31.02,0.01,6,0.5,1.72,2,4,2,0,0
0,1,0,0,1,1,1,7.75,2.0,31.02,0.01,6,0.5,1.72,2,4,2,0,0
0,1,0,0,1,1,1,7.75,2.0,31.02,0.01,6,0.5,1.72,2,4,2,0,0
0,1,0,0,1,1,1,7.75,2.0,31.02,0.01,6,0.5,1.72,2,4,2,0,0
0,1,0,0,1,1,1,7.75,2.0,31.02,0.01,6,0.5,1.72,2,4,2,0,0
0,1,0,0,1,1,1,7.75,2.0,31.02,0.01,6,0.5,1.72,2,4,2,0,0
0,1,0,0,1,1,1,7.74,1.5,17.41,0.0,5,0.67,0.97,2,3,2,0,0
0,1,0,0,1,1,1,5.33,1.5,12.0,0.0,4,0.67,0.67,1,3,1,0,0
0,3,0,0,2,1,1,7.75,2.0,31.02,0.01,6,0.5,1.72,2,4,2,0,0
0,3,0,0,2,1,1,7.75,2.0,31.02,0.01,6,0.5,1.72,2,4,2,0,0
0,1,0,0,1,1,1,5.8,2.0,23.22,0.0,5,0.5,1.29,1,4,1,0,0
0,1,0,0,1,1,1,5.8,2.0,23.22,0.0,5,0.5,1.29,1,4,1,0,0
0,3,0,0,2,1,1,7.75,2.0,31.02,0.01,6,0.5,1.72,2,4,2,0,0
0,3,0,0,2,1,1,7.75,2.0,31.02,0.01,6,0.5,1.72,2,4,2,0,0
0,1,0,0,1,1,1,12.18,3.0,109.62,0.01,11,0.33,6.09,4,7,4,0,0
0,1,0,0,1,1,1,7.75,2.0,31.02,0.01,6,0.5,1.72,2,4,2,0,0
0,1,0,0,1,1,1,7.75,2.0,31.02,0.01,6,0.5,1.72,2,4,2,0,0
0,1,0,0,1,1,1,7.75,2.0,31.02,0.01,6,0.5,1.72,2,4,2,0,0
0,1,0,0,1,1,1,7.75,2.0,31.02,0.01,6,0.5,1.72,2,4,2,0,0
0,1,0,0,1,1,1,7.75,2.0,31.02,0.01,6,0.5,1.72,2,4,2,0,0
0,1,0,0,1,1,1,7.75,2.0,31.02,0.01,6,0.5,1.72,2,4,2,0,0
0,1,0,0,1,1,1,5.8,2.0,23.22,0.0,5,0.5,1.29,1,4,1,0,0
0,1,0,0,1,1,1,5.8,2.0,23.22,0.0,5,0.5,1.29,1,4,1,0,0
0,1,0,0,1,1,1,7.75,2.0,31.02,0.01,6,0.5,1.72,2,4,2,0,0
0,1,0,0,1,1,1,7.75,2.0,31.02,0.01,6,0.5,1.72,2,4,2,0,0
2,1,0,0,1,1,1,8.98,2.5,56.15,0.01,8,0.4,3.12,2,6,2,2,0
2,1,0,0,1,1,1,8.98,2.5,56.15,0.01,8,0.4,3.12,2,6,2,2,0
2,1,0,0,1,1,1,5.33,1.5,12.0,0.0,4,0.67,0.67,1,3,1,2,0
0,1,0,0,1,1,1,5.33,1.5,12.0,0.0,4,0.67,0.67,1,3,1,0,0
2,1,0,0,1,1,1,5.33,1.5,12.0,0.0,4,0.67,0.67,1,3,1,2,0
2,1,0,0,1,1,1,5.33,1.5,12.0,0.0,4,0.67,0.67,1,3,1,2,0
2,1,0,0,1,1,1,5.33,1.5,12.0,0.0,4,0.67,0.67,1,3,1,2,0
3,1,0,0,1,1,1,12.0,2.5,75.0,0.01,10,0.4,4.17,3,7,3,3,0
0,1,0,0,1,1,1,7.86,2.5,49.13,0.01,7,0.4,2.73,2,5,2,0,0
0,1,0,0,1,1,1,6.55,3.0,58.95,0.01,7,0.33,3.28,1,6,1,0,0
0,1,0,0,1,1,1,6.55,3.0,58.95,0.01,7,0.33,3.28,1,6,1,0,0
2,1,0,0,1,1,1,8.98,2.5,56.15,0.01,8,0.4,3.12,2,6,2,2,0
2,1,0,0,1,1,1,8.98,2.5,56.15,0.01,8,0.4,3.12,2,6,2,2,0
2,1,0,0,1,1,1,5.33,1.5,12.0,0.0,4,0.67,0.67,1,3,1,2,0
0,1,0,0,1,1,1,5.33,1.5,12.0,0.0,4,0.67,0.67,1,3,1,0,0
2,1,0,0,1,1,1,5.33,1.5,12.0,0.0,4,0.67,0.67,1,3,1,2,0
2,1,0,0,1,1,1,5.33,1.5,12.0,0.0,4,0.67,0.67,1,3,1,2,0
2,1,0,0,1,1,1,5.33,1.5,12.0,0.0,4,0.67,0.67,1,3,1,2,0
0,1,0,0,1,1,1,5.33,1.5,12.0,0.0,4,0.67,0.67,1,3,1,0,0
0,1,0,0,1,1,1,5.33,1.5,12.0,0.0,4,0.67,0.67,1,3,1,0,0
0,1,0,0,1,1,1,7.86,2.5,49.13,0.01,7,0.4,2.73,2,5,2,0,0
0,1,0,0,1,1,1,0.0,0.0,0.0,0.0,3,0.0,0.0,0,3,0,0,0
0,1,0,0,1,1,1,7.75,2.0,31.02,0.01,6,0.5,1.72,2,4,2,0,0
0,1,0,0,1,1,1,7.75,2.0,31.02,0.01,6,0.5,1.72,2,4,2,0,0
0,1,0,0,1,1,1,9.0,3.0,81.0,0.01,9,0.33,4.5,2,7,2,0,0
0,1,0,0,1,1,1,8.3,6.0,298.97,0.02,15,0.17,16.61,3,12,2,0,0
0,1,0,0,1,1,1,7.74,1.5,17.41,0.0,5,0.67,0.97,2,3,2,0,0
0,1,0,0,1,1,1,7.74,1.5,17.41,0.0,5,0.67,0.97,2,3,2,0,0
0,1,0,0,1,1,1,7.74,1.5,17.41,0.0,5,0.67,0.97,2,3,2,0,0
0,1,0,0,1,1,1,7.74,1.5,17.41,0.0,5,0.67,0.97,2,3,2,0,0
0,1,0,0,1,1,1,7.74,1.5,17.41,0.0,5,0.67,0.97,2,3,2,0,0
0,1,0,0,1,1,1,7.74,1.5,17.41,0.0,5,0.67,0.97,2,3,2,0,0
0,1,0,0,1,1,1,7.74,1.5,17.41,0.0,5,0.67,0.97,2,3,2,0,0
0,1,0,0,1,1,1,9.51,3.0,85.59,0.01,9,0.33,4.75,3,6,3,0,0
0,1,0,0,1,1,1,9.51,3.0,85.59,0.01,9,0.33,4.75,3,6,3,0,0
0,1,0,0,1,1,1,9.51,3.0,85.59,0.01,9,0.33,4.75,3,6,3,0,0
0,1,0,0,1,1,1,9.51,3.0,85.59,0.01,9,0.33,4.75,3,6,3,0,0
4,3,0,0,2,2,1,13.67,6.0,492.27,0.03,21,0.17,27.35,6,15,5,4,0
0,1,0,0,1,1,1,7.74,1.5,17.41,0.0,5,0.67,0.97,2,3,2,0,0
0,1,0,0,1,1,1,5.33,1.5,12.0,0.0,4,0.67,0.67,1,3,1,0,0
44,3,0,1,1,1,1,68.1,16.55,18643.53,0.38,204,0.06,1035.75,84,120,33,44,0
44,3,0,1,1,1,1,68.1,16.55,18643.53,0.38,204,0.06,1035.75,84,120,33,44,0
3,1,0,0,1,1,1,9.51,3.0,85.59,0.01,9,0.33,4.75,3,6,3,3,0
3,1,0,0,1,1,1,9.51,3.0,85.59,0.01,9,0.33,4.75,3,6,3,3,0
5,3,0,0,2,2,1,15.36,3.5,188.21,0.02,15,0.29,10.46,5,10,5,5,0
5,3,0,0,2,2,1,15.36,3.5,188.21,0.02,15,0.29,10.46,5,10,5,5,0
4,3,0,0,2,2,1,10.88,5.6,341.29,0.02,17,0.18,18.96,8,9,5,4,0
4,3,0,0,2,2,1,10.88,5.6,341.29,0.02,17,0.18,18.96,8,9,5,4,0
0,1,0,0,1,1,1,7.74,1.5,17.41,0.0,5,0.67,0.97,2,3,2,0,0
0,1,0,0,1,1,1,7.74,1.5,17.41,0.0,5,0.67,0.97,2,3,2,0,0
2,1,0,0,1,1,1,7.35,8.0,470.48,0.02,17,0.13,26.14,6,11,3,2,0
0,1,0,0,1,1,1,12.68,2.5,79.25,0.01,10,0.4,4.4,4,6,4,0,0
0,1,0,0,1,1,1,12.68,2.5,79.25,0.01,10,0.4,4.4,4,6,4,0,0
0,1,0,0,1,1,1,7.74,1.5,17.41,0.0,5,0.67,0.97,2,3,2,0,0
0,1,0,0,1,1,1,7.74,1.5,17.41,0.0,5,0.67,0.97,2,3,2,0,0
0,1,0,0,1,1,1,7.75,2.0,31.02,0.01,6,0.5,1.72,2,4,2,0,0
0,1,0,0,1,1,1,7.75,2.0,31.02,0.01,6,0.5,1.72,2,4,2,0,0
0,1,0,0,1,1,1,7.75,2.0,31.02,0.01,6,0.5,1.72,2,4,2,0,0
0,1,0,0,1,1,1,7.75,2.0,31.02,0.01,6,0.5,1.72,2,4,2,0,0
0,1,0,0,1,1,1,7.75,2.0,31.02,0.01,6,0.5,1.72,2,4,2,0,0
0,1,0,0,1,1,1,7.75,2.0,31.02,0.01,6,0.5,1.72,2,4,2,0,0
0,1,0,0,1,1,1,7.75,2.0,31.02,0.01,6,0.5,1.72,2,4,2,0,0
0,1,0,0,1,1,1,7.75,2.0,31.02,0.01,6,0.5,1.72,2,4,2,0,0
2,1,0,0,1,1,1,7.81,9.0,632.78,0.02,19,0.11,35.15,8,11,4,2,0
0,1,0,0,1,1,1,5.33,1.5,12.0,0.0,4,0.67,0.67,1,3,1,0,0
16,3,0,5,2,2,1,25.41,12.54,3993.6,0.11,67,0.08,221.87,27,40,14,16,0
16,3,0,5,2,2,1,25.41,12.54,3993.6,0.11,67,0.08,221.87,27,40,14,16,0
13,1,0,0,1,1,1,35.16,5.0,879.05,0.06,45,0.2,48.84,20,25,10,13,0
13,1,0,0,1,1,1,35.16,5.0,879.05,0.06,45,0.2,48.84,20,25,10,13,0
47,29,13,12,15,9,12,38.94,24.24,22880.44,0.31,169,0.04,1271.14,74,95,29,60,0
47,29,13,12,1,1,1,45.0,22.17,22112.96,0.33,175,0.05,1228.5,77,98,33,60,0
26,9,0,1,5,2,1,35.11,17.93,11294.45,0.21,120,0.06,627.47,55,65,23,26,0
26,9,0,1,5,2,1,35.11,17.93,11294.45,0.21,120,0.06,627.47,55,65,23,26,0
4,1,0,4,1,1,1,21.67,1.8,70.2,0.01,13,0.56,3.9,6,7,5,4,0
4,1,0,4,1,1,1,21.67,1.8,70.2,0.01,13,0.56,3.9,6,7,5,4,0
4,1,0,4,1,1,1,21.67,1.8,70.2,0.01,13,0.56,3.9,6,7,5,4,0
4,1,0,4,1,1,1,21.67,1.8,70.2,0.01,13,0.56,3.9,6,7,5,4,0
4,1,0,4,1,1,1,21.67,1.8,70.2,0.01,13,0.56,3.9,6,7,5,4,0
4,1,0,4,1,1,1,21.67,1.8,70.2,0.01,13,0.56,3.9,6,7,5,4,0
4,1,0,4,1,1,1,21.67,1.8,70.2,0.01,13,0.56,3.9,6,7,5,4,0
4,1,0,4,1,1,1,21.67,1.8,70.2,0.01,13,0.56,3.9,6,7,5,4,0
4,1,0,4,1,1,1,21.67,1.8,70.2,0.01,13,0.56,3.9,6,7,5,4,0
4,1,0,4,1,1,1,21.67,1.8,70.2,0.01,13,0.56,3.9,6,7,5,4,0
4,1,0,4,1,1,1,21.67,1.8,70.2,0.01,13,0.56,3.9,6,7,5,4,0
4,1,0,4,1,1,1,21.67,1.8,70.2,0.01,13,0.56,3.9,6,7,5,4,0
4,1,0,4,1,1,1,21.67,1.8,70.2,0.01,13,0.56,3.9,6,7,5,4,0
4,1,0,4,1,1,1,21.67,1.8,70.2,0.01,13,0.56,3.9,6,7,5,4,0
4,1,0,4,1,1,1,21.67,1.8,70.2,0.01,13,0.56,3.9,6,7,5,4,0
4,1,0,4,1,1,1,21.67,1.8,70.2,0.01,13,0.56,3.9,6,7,5,4,0
4,1,0,4,1,1,1,21.67,1.8,70.2,0.01,13,0.56,3.9,6,7,5,4,0
4,1,0,4,1,1,1,21.67,1.8,70.2,0.01,13,0.56,3.9,6,7,5,4,0
3,1,5,5,1,1,1,24.91,5.33,708.45,0.04,34,0.19,39.36,16,18,9,8,0
3,1,5,5,1,1,1,24.91,5.33,708.45,0.04,34,0.19,39.36,16,18,9,8,0
4,1,0,4,1,1,1,21.67,1.8,70.2,0.01,13,0.56,3.9,6,7,5,4,0
4,1,0,4,1,1,1,21.67,1.8,70.2,0.01,13,0.56,3.9,6,7,5,4,0
4,1,0,4,1,1,1,21.67,1.8,70.2,0.01,13,0.56,3.9,6,7,5,4,0
4,1,0,4,1,1,1,21.67,1.8,70.2,0.01,13,0.56,3.9,6,7,5,4,0
4,1,0,4,1,1,1,21.67,1.8,70.2,0.01,13,0.56,3.9,6,7,5,4,0
4,1,0,4,1,1,1,21.67,1.8,70.2,0.01,13,0.56,3.9,6,7,5,4,0
4,1,0,4,1,1,1,21.67,1.8,70.2,0.01,13,0.56,3.9,6,7,5,4,0
4,1,0,4,1,1,1,21.67,1.8,70.2,0.01,13,0.56,3.9,6,7,5,4,0
4,1,0,4,1,1,1,21.67,1.8,70.2,0.01,13,0.56,3.9,6,7,5,4,0
4,1,0,4,1,1,1,21.67,1.8,70.2,0.01,13,0.56,3.9,6,7,5,4,0
4,1,0,4,1,1,1,21.67,1.8,70.2,0.01,13,0.56,3.9,6,7,5,4,0
4,1,0,4,1,1,1,21.67,1.8,70.2,0.01,13,0.56,3.9,6,7,5,4,0
4,1,0,4,1,1,1,21.67,1.8,70.2,0.01,13,0.56,3.9,6,7,5,4,0
4,1,0,4,1,1,1,21.67,1.8,70.2,0.01,13,0.56,3.9,6,7,5,4,0
4,1,0,4,1,1,1,21.67,1.8,70.2,0.01,13,0.56,3.9,6,7,5,4,0
4,1,0,4,1,1,1,21.67,1.8,70.2,0.01,13,0.56,3.9,6,7,5,4,0
4,1,0,4,1,1,1,21.67,1.8,70.2,0.01,13,0.56,3.9,6,7,5,4,0
4,1,0,4,1,1,1,21.67,1.8,70.2,0.01,13,0.56,3.9,6,7,5,4,0
4,1,0,4,1,1,1,21.67,1.8,70.2,0.01,13,0.56,3.9,6,7,5,4,0
4,1,0,4,1,1,1,21.67,1.8,70.2,0.01,13,0.56,3.9,6,7,5,4,0
4,1,0,4,1,1,1,21.67,1.8,70.2,0.01,13,0.56,3.9,6,7,5,4,0
4,1,0,4,1,1,1,21.67,1.8,70.2,0.01,13,0.56,3.9,6,7,5,4,0
2,1,2,1,1,1,1,21.67,1.8,70.2,0.01,13,0.56,3.9,6,7,5,4,0
2,1,2,1,1,1,1,21.67,1.8,70.2,0.01,13,0.56,3.9,6,7,5,4,0
